test,alpha,bot_pos,rat_pos,neighbor_sensings_1,ping_tries_1,moves_1,total_actions_1,neighbor_sensings_2,ping_tries_2,moves_2,total_actions_2
0,0.18,"(7, 22)","(1, 20)",4,16,19,39,8,101,93,202
1,0.16,"(25, 12)","(27, 20)",16,160,175,351,6,72,60,138
2,0.1,"(8, 25)","(9, 27)",5,21,25,51,9,32,24,65
3,0.1,"(16, 28)","(26, 17)",6,82,87,175,4,48,37,89
4,0.2,"(0, 22)","(26, 29)",11,113,123,247,45,402,404,851
5,0.1,"(3, 16)","(15, 4)",9,187,195,391,7,82,70,159
6,0.18,"(20, 1)","(18, 19)",9,23,31,63,11,78,73,162
7,0.1,"(16, 10)","(23, 0)",4,94,97,195,10,176,172,358
8,0.02,"(27, 29)","(21, 16)",5,82,86,173,6,160,141,307
9,0.14,"(28, 6)","(6, 21)",5,143,147,295,4,134,122,260
10,0.14,"(6, 16)","(3, 11)",12,136,147,295,5,50,40,95
11,0.16,"(5, 9)","(13, 12)",16,261,276,553,9,33,29,71
12,0.1,"(0, 12)","(24, 26)",10,86,95,191,12,229,215,456
13,0.14,"(22, 27)","(23, 25)",35,12,46,93,5,96,85,186
14,0.16,"(5, 7)","(23, 7)",10,22,31,63,8,136,114,258
15,0.04,"(6, 22)","(20, 18)",11,42,52,105,9,202,199,410
16,0.02,"(16, 15)","(24, 15)",4,205,208,417,4,296,257,557
17,0.02,"(20, 2)","(0, 1)",20,126,145,291,8,137,121,266
18,0.12,"(3, 15)","(2, 29)",10,125,134,269,4,69,59,132
19,0.08,"(16, 15)","(10, 22)",4,8,11,23,6,72,64,142
20,0.06,"(8, 14)","(11, 27)",13,48,60,121,5,136,127,268
21,0.18,"(23, 10)","(29, 2)",7,218,224,449,4,66,55,125
22,0.04,"(25, 14)","(19, 9)",6,27,32,65,14,128,128,270
23,0.08,"(9, 6)","(16, 16)",7,35,41,83,7,70,59,136
24,0.14,"(21, 18)","(3, 18)",9,114,122,245,7,52,47,106
25,0.1,"(26, 13)","(9, 28)",10,478,487,975,12,200,196,408
26,0.14,"(5, 16)","(9, 11)",4,98,101,203,5,102,85,192
27,0.04,"(11, 29)","(0, 11)",10,85,94,189,7,57,52,116
28,0.08,"(0, 13)","(22, 7)",5,60,64,129,37,148,172,357
29,0.16,"(15, 27)","(23, 29)",10,346,355,711,8,245,223,476
30,0.02,"(24, 22)","(20, 25)",7,184,190,381,7,31,25,63
31,0.04,"(17, 18)","(0, 26)",11,127,137,275,13,48,47,108
32,0.08,"(18, 5)","(1, 25)",4,115,118,237,10,94,77,181
33,0.06,"(14, 5)","(19, 19)",2,174,175,351,7,62,46,115
34,0.04,"(24, 20)","(20, 26)",12,191,202,405,8,117,104,229
35,0.2,"(14, 11)","(5, 11)",12,68,79,159,12,101,98,211
36,0.2,"(10, 4)","(3, 3)",10,104,113,227,9,36,32,77
37,0.12,"(29, 12)","(12, 12)",7,159,165,331,10,109,99,218
38,0.1,"(29, 25)","(15, 21)",7,40,46,93,7,146,137,290
39,0.1,"(19, 22)","(3, 22)",11,131,141,283,9,151,127,287
40,0.18,"(7, 16)","(17, 29)",7,47,53,107,21,41,51,113
41,0.16,"(27, 12)","(7, 12)",15,211,225,451,7,67,55,129
42,0.12,"(8, 26)","(29, 3)",9,156,164,329,6,97,89,192
43,0.1,"(28, 26)","(17, 16)",3,25,27,55,8,100,93,201
44,0.14,"(29, 17)","(6, 26)",19,212,230,461,4,121,99,224
45,0.2,"(0, 21)","(20, 6)",4,135,138,277,4,112,99,215
46,0.1,"(24, 23)","(11, 21)",6,86,91,183,3,108,78,189
47,0.16,"(20, 11)","(9, 25)",10,335,344,689,6,105,82,193
48,0.16,"(1, 26)","(19, 5)",8,67,74,149,4,48,39,91
49,0.2,"(0, 6)","(13, 10)",5,66,70,141,4,221,207,432
50,0.04,"(16, 20)","(2, 0)",6,76,81,163,4,58,49,111
51,0.18,"(12, 4)","(27, 0)",10,152,161,323,9,103,95,207
52,0.02,"(23, 11)","(11, 11)",4,176,179,359,7,163,147,317
53,0.04,"(23, 17)","(12, 20)",35,117,151,303,16,94,95,205
54,0.06,"(8, 16)","(2, 22)",6,153,158,317,6,287,257,550
55,0.04,"(26, 28)","(10, 9)",22,35,56,113,11,230,203,444
56,0.04,"(29, 5)","(23, 20)",10,134,143,287,12,140,131,283
57,0.1,"(0, 19)","(5, 11)",16,61,76,153,4,145,127,276
58,0.2,"(23, 25)","(15, 17)",10,121,130,261,7,192,173,372
59,0.08,"(1, 26)","(16, 6)",2,207,208,417,4,71,64,139
60,0.02,"(10, 26)","(29, 4)",5,67,71,143,12,190,174,376
61,0.04,"(10, 20)","(26, 9)",6,50,55,111,6,122,107,235
62,0.18,"(9, 13)","(9, 28)",8,88,95,191,4,104,78,186
63,0.12,"(18, 18)","(22, 29)",3,246,248,497,4,219,192,415
64,0.2,"(18, 9)","(18, 18)",5,8,12,25,5,132,112,249
65,0.14,"(19, 15)","(2, 20)",7,61,67,135,7,203,197,407
66,0.16,"(20, 29)","(29, 11)",13,43,55,111,8,47,40,95
67,0.1,"(24, 16)","(26, 2)",7,175,181,363,7,81,72,160
68,0.2,"(16, 7)","(12, 23)",6,120,125,251,4,237,223,464
69,0.16,"(15, 23)","(24, 25)",8,402,409,819,17,105,97,219
70,0.2,"(18, 29)","(9, 25)",10,152,161,323,4,36,26,66
71,0.18,"(12, 17)","(1, 12)",5,27,31,63,15,41,41,97
72,0.1,"(26, 11)","(24, 18)",9,18,26,53,6,72,63,141
73,0.16,"(13, 6)","(1, 21)",4,266,269,539,5,64,48,117
74,0.08,"(0, 7)","(0, 1)",3,80,82,165,4,41,33,78
75,0.02,"(21, 18)","(25, 12)",12,227,238,477,7,151,132,290
76,0.02,"(25, 7)","(11, 25)",8,407,414,829,13,37,38,88
77,0.1,"(15, 9)","(10, 0)",6,155,160,321,15,102,103,220
78,0.14,"(13, 2)","(12, 24)",17,41,57,115,6,49,41,96
79,0.04,"(18, 19)","(3, 11)",11,113,123,247,8,422,393,823
80,0.04,"(14, 18)","(3, 13)",8,165,172,345,8,65,53,126
81,0.1,"(18, 0)","(9, 5)",4,55,58,117,11,134,122,267
82,0.14,"(3, 20)","(1, 7)",3,72,74,149,15,44,43,102
83,0.12,"(13, 1)","(19, 28)",22,36,57,115,11,64,61,136
84,0.14,"(14, 24)","(13, 12)",10,112,121,243,13,82,81,176
85,0.1,"(10, 24)","(29, 13)",11,83,93,187,7,51,44,102
86,0.14,"(12, 1)","(22, 7)",4,13,16,33,4,103,85,192
87,0.1,"(17, 2)","(26, 28)",10,51,60,121,15,100,99,214
88,0.16,"(17, 12)","(0, 1)",3,190,192,385,3,427,413,843
89,0.1,"(28, 17)","(15, 0)",4,69,72,145,3,117,107,227
90,0.14,"(4, 7)","(15, 18)",4,114,117,235,6,69,61,136
91,0.04,"(23, 23)","(3, 19)",14,137,150,301,9,112,102,223
92,0.02,"(21, 21)","(10, 23)",8,90,97,195,6,170,144,320
93,0.06,"(0, 26)","(19, 10)",6,81,86,173,11,191,178,380
94,0.16,"(23, 13)","(13, 12)",16,256,271,543,15,161,156,332
95,0.1,"(21, 21)","(0, 22)",8,108,115,231,3,512,454,969
96,0.18,"(15, 21)","(27, 1)",5,142,146,293,6,92,85,183
97,0.2,"(26, 5)","(5, 29)",4,453,456,913,6,77,64,147
98,0.04,"(19, 28)","(8, 9)",8,84,91,183,4,142,126,272
99,0.04,"(20, 2)","(22, 10)",2,77,78,157,8,35,23,66
100,0.18,"(18, 29)","(19, 0)",10,71,80,161,8,116,97,221
101,0.2,"(13, 15)","(9, 27)",4,78,81,163,5,109,100,214
102,0.1,"(18, 10)","(0, 19)",3,77,79,159,5,86,78,169
103,0.04,"(26, 2)","(16, 27)",6,135,140,281,11,391,350,752
104,0.1,"(16, 29)","(24, 0)",6,43,48,97,8,61,58,127
105,0.02,"(24, 9)","(0, 2)",6,48,53,107,7,285,272,564
106,0.02,"(20, 5)","(25, 3)",6,45,50,101,31,107,126,264
107,0.04,"(2, 13)","(10, 2)",12,174,185,371,6,116,111,233
108,0.16,"(18, 5)","(17, 28)",8,157,164,329,6,87,75,168
109,0.12,"(21, 29)","(23, 21)",4,178,181,363,3,134,118,255
110,0.14,"(11, 8)","(14, 13)",3,143,145,291,4,61,44,109
111,0.2,"(20, 25)","(25, 22)",5,207,211,423,13,26,25,64
112,0.12,"(25, 21)","(15, 7)",9,264,272,545,7,114,101,222
113,0.14,"(28, 6)","(5, 29)",14,90,103,207,9,61,56,126
114,0.2,"(11, 10)","(23, 3)",7,15,21,43,12,130,124,266
115,0.16,"(18, 8)","(25, 5)",5,82,86,173,6,146,139,291
116,0.02,"(27, 12)","(17, 9)",5,148,152,305,3,49,34,86
117,0.04,"(24, 6)","(29, 23)",5,159,163,327,10,171,143,324
118,0.04,"(18, 3)","(26, 14)",5,263,267,535,5,270,229,504
119,0.04,"(13, 11)","(27, 25)",8,73,80,161,6,106,95,207
120,0.06,"(9, 8)","(5, 8)",6,172,177,355,4,46,35,85
121,0.04,"(19, 29)","(17, 18)",6,388,393,787,6,359,318,683
122,0.18,"(21, 7)","(1, 19)",11,165,175,351,15,84,77,176
123,0.18,"(16, 24)","(4, 12)",5,146,150,301,5,208,188,401
124,0.18,"(14, 6)","(29, 20)",14,112,125,251,11,69,59,139
125,0.14,"(20, 29)","(14, 26)",3,94,96,193,5,92,77,174
126,0.02,"(2, 17)","(5, 3)",5,419,423,847,5,122,107,234
127,0.1,"(25, 29)","(27, 16)",3,228,230,461,7,88,65,160
128,0.08,"(25, 5)","(17, 5)",12,168,179,359,7,29,22,58
129,0.18,"(13, 1)","(17, 19)",3,117,119,239,15,132,131,278
130,0.1,"(6, 16)","(27, 12)",11,76,86,173,4,107,92,203
131,0.02,"(9, 9)","(11, 27)",6,102,107,215,12,346,307,665
132,0.1,"(24, 9)","(7, 9)",10,64,73,147,8,188,164,360
133,0.06,"(23, 16)","(22, 27)",5,135,139,279,8,283,265,556
134,0.02,"(5, 21)","(8, 7)",8,623,630,1261,5,33,22,60
135,0.1,"(14, 5)","(16, 10)",3,97,99,199,4,38,23,65
136,0.04,"(23, 20)","(12, 24)",7,20,26,53,6,298,278,582
137,0.16,"(2, 20)","(16, 3)",14,73,86,173,4,81,73,158
138,0.14,"(16, 26)","(29, 7)",5,321,325,651,15,218,190,423
139,0.18,"(11, 20)","(8, 6)",6,151,156,313,6,176,166,348
140,0.12,"(10, 14)","(28, 5)",6,59,64,129,3,76,67,146
141,0.14,"(13, 15)","(9, 9)",9,196,204,409,12,206,190,408
142,0.2,"(3, 17)","(25, 27)",8,60,67,135,10,107,103,220
143,0.02,"(24, 8)","(10, 22)",7,201,207,415,5,109,86,200
144,0.1,"(0, 9)","(2, 25)",12,66,77,155,5,111,96,212
145,0.18,"(27, 13)","(16, 7)",6,322,327,655,6,109,95,210
146,0.14,"(0, 25)","(29, 21)",11,85,95,191,6,100,91,197
147,0.2,"(10, 17)","(10, 12)",8,73,80,161,20,249,238,507
148,0.16,"(15, 26)","(9, 3)",5,120,124,249,10,180,169,359
149,0.06,"(17, 27)","(7, 14)",4,60,63,127,7,83,71,161
150,0.02,"(12, 1)","(24, 22)",16,227,242,485,13,151,143,307
151,0.18,"(27, 25)","(8, 27)",7,181,187,375,8,111,107,226
152,0.02,"(12, 23)","(10, 13)",8,68,75,151,5,178,158,341
153,0.16,"(19, 22)","(12, 25)",8,113,120,241,10,136,126,272
154,0.04,"(27, 14)","(25, 12)",10,84,93,187,6,57,50,113
155,0.02,"(29, 27)","(3, 5)",15,118,132,265,12,86,85,183
156,0.1,"(12, 8)","(9, 4)",7,125,131,263,21,73,71,165
157,0.2,"(3, 27)","(0, 12)",6,146,151,303,4,156,146,306
158,0.12,"(17, 18)","(14, 21)",3,14,16,33,4,73,44,121
159,0.1,"(14, 5)","(24, 13)",9,97,105,211,7,182,176,365
160,0.08,"(22, 13)","(13, 6)",6,291,296,593,10,73,66,149
161,0.14,"(28, 9)","(18, 13)",6,242,247,495,9,81,64,154
162,0.04,"(27, 6)","(28, 5)",12,40,51,103,10,294,242,546
163,0.2,"(18, 28)","(21, 23)",3,88,90,181,5,24,14,43
164,0.12,"(16, 16)","(19, 12)",9,158,166,333,10,81,65,156
165,0.14,"(21, 22)","(5, 6)",6,73,78,157,6,47,41,94
166,0.14,"(5, 20)","(18, 16)",7,135,141,283,2,53,33,88
167,0.14,"(13, 15)","(27, 29)",11,108,118,237,11,72,71,154
168,0.02,"(23, 1)","(23, 5)",11,213,223,447,5,230,200,435
169,0.06,"(28, 17)","(27, 14)",2,12,13,27,7,40,29,76
170,0.2,"(27, 22)","(11, 1)",9,87,95,191,9,122,115,246
171,0.08,"(21, 2)","(1, 0)",5,32,36,73,6,47,35,88
172,0.08,"(19, 26)","(29, 19)",20,76,95,191,9,76,69,154
173,0.08,"(29, 15)","(6, 27)",7,109,115,231,3,209,180,392
174,0.16,"(1, 8)","(9, 29)",4,158,161,323,6,184,153,343
175,0.18,"(25, 29)","(8, 9)",2,238,239,479,3,315,286,604
176,0.06,"(25, 4)","(3, 7)",7,77,83,167,8,115,102,225
177,0.06,"(29, 16)","(9, 22)",10,257,266,533,3,151,137,291
178,0.18,"(5, 28)","(19, 13)",7,67,73,147,11,57,54,122
179,0.04,"(4, 14)","(25, 12)",8,59,66,133,5,131,120,256
180,0.18,"(4, 5)","(10, 0)",4,108,111,223,4,42,30,76
181,0.16,"(6, 17)","(3, 23)",23,129,151,303,7,56,43,106
182,0.06,"(8, 13)","(19, 6)",9,101,109,219,10,39,33,82
183,0.08,"(23, 3)","(22, 7)",5,107,111,223,5,498,469,972
184,0.18,"(11, 25)","(7, 6)",8,62,69,139,8,71,65,144
185,0.2,"(12, 5)","(8, 7)",7,153,159,319,6,196,169,371
186,0.08,"(13, 10)","(0, 22)",5,77,81,163,15,86,86,187
187,0.12,"(16, 4)","(22, 27)",21,143,163,327,9,226,218,453
188,0.12,"(5, 15)","(27, 27)",5,96,100,201,11,292,255,558
189,0.08,"(22, 2)","(15, 4)",4,296,299,599,3,66,44,113
190,0.06,"(10, 9)","(14, 27)",4,199,202,405,7,166,156,329
191,0.1,"(22, 21)","(20, 18)",10,214,223,447,6,127,118,251
192,0.1,"(2, 15)","(26, 10)",6,101,106,213,8,111,107,226
193,0.2,"(22, 0)","(9, 22)",3,89,91,183,11,147,143,301
194,0.04,"(22, 0)","(18, 14)",4,72,75,151,6,121,111,238
195,0.14,"(2, 26)","(4, 3)",4,222,225,451,3,82,71,156
196,0.06,"(18, 23)","(11, 19)",12,20,31,63,5,44,30,79
197,0.1,"(16, 23)","(10, 17)",7,115,121,243,6,290,262,558
198,0.04,"(26, 10)","(22, 28)",6,57,62,125,6,153,130,289
199,0.2,"(24, 3)","(4, 4)",5,168,172,345,3,167,129,299
200,0.16,"(2, 2)","(12, 18)",8,103,110,221,8,135,125,268
201,0.16,"(26, 18)","(19, 23)",7,79,85,171,22,174,169,365
202,0.08,"(21, 0)","(27, 10)",7,94,100,201,3,146,118,267
203,0.08,"(14, 0)","(23, 7)",5,47,51,103,7,179,146,332
204,0.2,"(0, 15)","(6, 25)",9,457,465,931,6,240,221,467
205,0.12,"(10, 11)","(29, 21)",10,161,170,341,17,57,62,136
206,0.02,"(15, 19)","(13, 22)",6,48,53,107,9,614,539,1162
207,0.18,"(20, 19)","(11, 14)",6,155,160,321,6,124,103,233
208,0.08,"(22, 25)","(11, 11)",8,213,220,441,6,55,45,106
209,0.16,"(5, 20)","(6, 16)",8,64,71,143,16,177,162,355
210,0.1,"(13, 1)","(9, 21)",17,180,196,393,6,77,65,148
211,0.2,"(29, 19)","(3, 25)",6,75,80,161,10,65,60,135
212,0.12,"(6, 7)","(28, 19)",4,45,48,97,11,177,164,352
213,0.2,"(20, 8)","(22, 19)",6,287,292,585,7,163,148,318
214,0.12,"(21, 2)","(5, 2)",10,219,228,457,4,34,21,59
215,0.1,"(24, 29)","(1, 17)",6,117,122,245,3,252,226,481
216,0.14,"(8, 10)","(28, 9)",6,121,126,253,11,132,128,271
217,0.16,"(7, 19)","(26, 27)",7,46,52,105,8,111,102,221
218,0.14,"(25, 26)","(9, 28)",4,235,238,477,10,47,45,102
219,0.04,"(11, 15)","(23, 9)",3,193,195,391,19,81,89,189
220,0.12,"(12, 25)","(18, 23)",9,178,186,373,11,107,97,215
221,0.08,"(20, 0)","(9, 8)",3,59,61,123,8,96,79,183
222,0.02,"(6, 13)","(11, 0)",6,88,93,187,9,43,39,91
223,0.14,"(4, 19)","(20, 26)",6,83,88,177,7,242,214,463
224,0.06,"(27, 15)","(8, 17)",6,162,167,335,18,42,48,108
225,0.02,"(16, 20)","(21, 18)",14,170,183,367,15,96,99,210
226,0.2,"(23, 11)","(7, 5)",6,95,100,201,4,161,151,316
227,0.12,"(18, 24)","(16, 15)",6,143,148,297,4,53,44,101
228,0.14,"(25, 11)","(10, 5)",4,113,116,233,10,234,213,457
229,0.2,"(15, 21)","(21, 5)",8,127,134,269,5,257,235,497
230,0.16,"(25, 19)","(12, 25)",12,308,319,639,8,147,139,294
231,0.12,"(6, 23)","(21, 7)",6,123,128,257,4,92,79,175
232,0.08,"(6, 13)","(4, 5)",13,81,93,187,10,132,130,272
233,0.06,"(7, 2)","(23, 7)",11,72,82,165,4,73,60,137
234,0.12,"(19, 8)","(14, 29)",15,57,71,143,10,100,87,197
235,0.08,"(23, 23)","(3, 12)",5,95,99,199,6,120,104,230
236,0.16,"(19, 23)","(1, 2)",5,172,176,353,15,249,228,492
237,0.02,"(6, 15)","(22, 4)",10,387,396,793,7,189,153,349
238,0.14,"(12, 15)","(28, 21)",6,66,71,143,4,68,50,122
239,0.06,"(22, 14)","(29, 5)",14,199,212,425,20,81,83,184
240,0.06,"(17, 13)","(16, 20)",5,566,570,1141,9,256,242,507
241,0.14,"(7, 23)","(10, 14)",8,5,12,25,11,151,147,309
242,0.08,"(22, 21)","(27, 9)",9,151,159,319,4,496,417,917
243,0.06,"(23, 2)","(11, 22)",7,87,93,187,8,181,155,344
244,0.14,"(1, 21)","(0, 15)",9,64,72,145,5,91,78,174
245,0.02,"(26, 19)","(28, 4)",3,38,40,81,3,342,312,657
246,0.2,"(19, 10)","(19, 13)",5,47,51,103,6,112,100,218
247,0.1,"(18, 12)","(27, 27)",8,25,32,65,7,222,203,432
248,0.12,"(28, 14)","(25, 18)",11,73,83,167,6,3,6,15
249,0.04,"(24, 8)","(19, 18)",7,216,222,445,10,37,32,79
250,0.16,"(3, 8)","(12, 24)",11,171,181,363,29,119,126,274
251,0.02,"(2, 10)","(29, 7)",10,119,128,257,6,119,98,223
252,0.06,"(24, 18)","(17, 12)",6,276,281,563,16,86,87,189
253,0.18,"(23, 4)","(0, 29)",8,116,123,247,4,192,172,368
254,0.02,"(26, 19)","(11, 11)",12,176,187,375,10,177,169,356
255,0.08,"(14, 23)","(10, 20)",6,11,16,33,15,105,99,219
256,0.04,"(13, 23)","(3, 29)",9,161,169,339,8,81,73,162
257,0.1,"(11, 5)","(5, 26)",14,32,45,91,15,57,57,129
258,0.16,"(10, 15)","(29, 24)",7,101,107,215,5,91,77,173
259,0.08,"(22, 27)","(5, 19)",4,343,346,693,4,97,82,183
260,0.08,"(10, 25)","(27, 20)",21,186,206,413,21,121,126,268
261,0.18,"(6, 25)","(15, 11)",4,86,89,179,9,212,200,421
262,0.12,"(0, 24)","(0, 16)",2,79,80,161,3,47,28,78
263,0.12,"(19, 1)","(0, 1)",3,94,96,193,10,32,30,72
264,0.16,"(25, 5)","(21, 18)",7,125,131,263,7,59,51,117
265,0.12,"(1, 22)","(17, 0)",7,146,152,305,8,49,41,98
266,0.1,"(21, 29)","(16, 7)",2,119,120,241,5,108,90,203
267,0.08,"(0, 22)","(16, 4)",8,153,160,321,3,262,238,503
268,0.06,"(0, 7)","(13, 26)",5,127,131,263,14,202,189,405
269,0.02,"(22, 27)","(27, 17)",3,100,102,205,7,347,337,691
270,0.16,"(13, 11)","(20, 21)",7,174,180,361,28,61,69,158
271,0.08,"(17, 11)","(16, 29)",4,153,156,313,5,396,374,775
272,0.04,"(10, 7)","(28, 17)",9,237,245,491,10,448,443,901
273,0.14,"(19, 21)","(15, 2)",4,48,51,103,6,120,108,234
274,0.2,"(2, 17)","(21, 16)",7,147,153,307,8,67,61,136
275,0.16,"(9, 29)","(8, 22)",5,63,67,135,10,131,128,269
276,0.04,"(2, 12)","(5, 24)",24,741,764,1529,7,111,99,217
277,0.02,"(20, 23)","(20, 15)",14,437,450,901,6,170,152,328
278,0.1,"(15, 15)","(0, 12)",12,130,141,283,8,170,155,333
279,0.04,"(1, 9)","(6, 29)",14,133,146,293,6,189,168,363
280,0.16,"(17, 15)","(25, 29)",27,111,137,275,5,82,71,158
281,0.2,"(16, 26)","(22, 25)",6,94,99,199,7,61,53,121
282,0.04,"(24, 5)","(16, 24)",8,315,322,645,7,122,105,234
283,0.18,"(28, 18)","(6, 0)",9,87,95,191,6,76,71,153
284,0.1,"(25, 21)","(13, 12)",10,234,243,487,5,196,190,391
285,0.14,"(12, 20)","(21, 13)",18,76,93,187,5,51,34,90
286,0.18,"(18, 0)","(13, 14)",7,115,121,243,4,223,213,440
287,0.2,"(17, 19)","(14, 27)",11,134,144,289,5,102,90,197
288,0.02,"(13, 10)","(18, 12)",9,150,158,317,8,486,461,955
289,0.2,"(18, 7)","(22, 16)",13,100,112,225,14,529,523,1066
290,0.14,"(12, 28)","(28, 1)",12,63,74,149,24,89,86,199
291,0.16,"(25, 2)","(26, 26)",6,102,107,215,6,181,167,354
292,0.08,"(6, 0)","(25, 4)",10,114,123,247,5,176,155,336
293,0.04,"(26, 21)","(28, 11)",4,150,153,307,5,132,119,256
294,0.16,"(27, 24)","(17, 2)",16,332,347,695,6,172,153,331
295,0.12,"(21, 27)","(11, 28)",7,16,22,45,6,70,61,137
296,0.1,"(5, 18)","(29, 11)",9,102,110,221,6,221,196,423
297,0.18,"(5, 9)","(0, 4)",3,257,259,519,8,32,25,65
298,0.12,"(3, 3)","(3, 17)",8,28,35,71,5,56,41,102
299,0.08,"(9, 21)","(11, 17)",4,139,142,285,7,117,107,231
300,0.08,"(6, 26)","(26, 11)",8,106,113,227,3,122,102,227
301,0.14,"(26, 15)","(9, 27)",8,121,128,257,8,59,53,120
302,0.1,"(25, 19)","(10, 4)",7,70,76,153,4,102,94,200
303,0.2,"(6, 24)","(18, 12)",13,70,82,165,6,72,64,142
304,0.06,"(19, 5)","(25, 13)",13,149,161,323,5,66,60,131
305,0.14,"(15, 24)","(9, 15)",6,184,189,379,12,102,100,214
306,0.12,"(17, 22)","(24, 23)",51,3,53,107,11,92,88,191
307,0.14,"(11, 16)","(3, 2)",8,164,171,343,11,87,86,184
308,0.16,"(10, 21)","(9, 27)",6,335,340,681,7,177,152,336
309,0.14,"(3, 20)","(3, 23)",6,122,127,255,3,100,75,178
310,0.06,"(14, 18)","(4, 5)",19,66,84,169,12,87,86,185
311,0.08,"(22, 14)","(7, 5)",5,243,247,495,5,52,43,100
312,0.12,"(4, 0)","(25, 2)",3,83,85,171,5,262,217,484
313,0.08,"(18, 0)","(11, 16)",7,221,227,455,3,116,101,220
314,0.16,"(10, 14)","(13, 16)",6,164,169,339,9,1,9,19
315,0.12,"(24, 18)","(1, 14)",11,43,53,107,8,150,134,292
316,0.16,"(15, 18)","(15, 15)",20,5,24,49,6,226,217,449
317,0.04,"(25, 22)","(14, 23)",4,44,47,95,8,266,219,493
318,0.04,"(20, 14)","(5, 21)",7,372,378,757,4,190,154,348
319,0.14,"(11, 0)","(11, 12)",5,90,94,189,4,232,204,440
320,0.16,"(23, 15)","(21, 9)",8,70,77,155,12,102,89,203
321,0.02,"(28, 19)","(20, 10)",4,379,382,765,5,546,506,1057
322,0.08,"(17, 6)","(25, 17)",3,372,374,749,6,117,98,221
323,0.12,"(26, 18)","(5, 17)",14,296,309,619,11,132,126,269
324,0.08,"(29, 28)","(29, 3)",2,84,85,171,4,106,81,191
325,0.02,"(14, 7)","(22, 17)",16,63,78,157,8,436,405,849
326,0.14,"(12, 28)","(20, 6)",4,41,44,89,6,261,239,506
327,0.16,"(22, 14)","(25, 11)",5,201,205,411,4,31,23,58
328,0.12,"(11, 8)","(25, 0)",9,139,147,295,8,146,126,280
329,0.14,"(7, 23)","(3, 6)",8,147,154,309,3,91,76,170
330,0.1,"(18, 5)","(26, 9)",8,47,54,109,11,242,230,483
331,0.16,"(3, 10)","(1, 26)",8,117,124,249,8,219,206,433
332,0.06,"(3, 11)","(8, 10)",7,31,37,75,5,72,49,126
333,0.14,"(15, 22)","(22, 11)",9,68,76,153,6,47,41,94
334,0.2,"(1, 13)","(24, 17)",3,211,213,427,5,70,58,133
335,0.12,"(2, 11)","(20, 1)",15,154,168,337,4,80,59,143
336,0.06,"(5, 19)","(15, 22)",6,124,129,259,5,73,64,142
337,0.02,"(14, 0)","(3, 21)",2,302,303,607,2,91,80,173
338,0.08,"(16, 15)","(19, 25)",28,111,138,277,10,267,238,515
339,0.02,"(4, 16)","(4, 20)",11,157,167,335,9,5,9,23
340,0.16,"(1, 6)","(7, 27)",10,47,56,113,10,102,89,201
341,0.02,"(1, 0)","(2, 18)",3,113,115,231,5,116,102,223
342,0.08,"(0, 10)","(24, 3)",11,136,146,293,8,82,73,163
343,0.02,"(0, 0)","(14, 6)",4,176,179,359,15,68,66,149
344,0.06,"(4, 22)","(24, 28)",5,109,113,227,6,131,117,254
345,0.16,"(11, 5)","(2, 17)",11,114,124,249,7,92,82,181
346,0.18,"(8, 8)","(12, 12)",3,112,114,229,5,157,121,283
347,0.08,"(0, 27)","(12, 3)",3,67,69,139,3,53,43,99
348,0.12,"(17, 22)","(0, 19)",11,299,309,619,8,229,210,447
349,0.06,"(23, 7)","(14, 18)",18,102,119,239,7,76,72,155
350,0.06,"(21, 12)","(5, 29)",4,101,104,209,9,102,92,203
351,0.18,"(4, 9)","(4, 19)",10,113,122,245,12,35,32,79
352,0.2,"(12, 3)","(23, 12)",6,248,253,507,5,172,140,317
353,0.18,"(25, 28)","(11, 26)",7,76,82,165,27,91,100,218
354,0.12,"(5, 27)","(11, 8)",5,299,303,607,15,157,160,332
355,0.14,"(5, 24)","(18, 16)",7,59,65,131,5,135,119,259
356,0.12,"(29, 4)","(11, 7)",2,33,34,69,5,284,258,547
357,0.04,"(19, 22)","(16, 17)",4,141,144,289,9,41,34,84
358,0.12,"(23, 15)","(10, 22)",10,59,68,137,11,217,190,418
359,0.08,"(0, 2)","(0, 22)",9,93,101,203,8,169,150,327
360,0.1,"(0, 4)","(3, 4)",13,79,91,183,9,78,64,151
361,0.12,"(19, 1)","(28, 0)",8,174,181,363,12,113,107,232
362,0.18,"(5, 19)","(3, 27)",4,143,146,293,9,171,164,344
363,0.14,"(4, 25)","(5, 22)",10,183,192,385,8,79,69,156
364,0.18,"(11, 27)","(9, 3)",6,37,42,85,9,227,219,455
365,0.12,"(14, 22)","(1, 19)",17,98,114,229,7,134,122,263
366,0.1,"(20, 1)","(7, 22)",6,379,384,769,6,97,84,187
367,0.18,"(20, 0)","(8, 13)",6,165,170,341,12,294,274,580
368,0.08,"(13, 17)","(9, 26)",15,89,103,207,6,85,75,166
369,0.06,"(9, 0)","(23, 24)",4,47,50,101,4,153,138,295
370,0.14,"(4, 6)","(18, 11)",4,345,348,697,3,91,80,174
371,0.14,"(17, 16)","(3, 2)",9,52,60,121,4,123,107,234
372,0.06,"(13, 10)","(19, 11)",9,49,57,115,11,81,81,173
373,0.16,"(16, 15)","(25, 26)",3,177,179,359,10,377,355,742
374,0.16,"(26, 26)","(21, 3)",8,193,200,401,7,66,62,135
375,0.16,"(23, 2)","(16, 17)",8,54,61,123,15,247,244,506
376,0.12,"(15, 17)","(16, 23)",8,49,56,113,20,56,62,138
377,0.04,"(1, 12)","(8, 22)",9,232,240,481,5,204,187,396
378,0.08,"(0, 23)","(6, 21)",4,169,172,345,4,171,137,312
379,0.16,"(20, 13)","(18, 21)",6,301,306,613,13,42,35,90
380,0.18,"(19, 10)","(7, 16)",6,89,94,189,42,78,107,227
381,0.08,"(19, 17)","(9, 24)",6,72,77,155,4,85,66,155
382,0.16,"(24, 23)","(14, 16)",10,91,100,201,10,86,81,177
383,0.12,"(25, 4)","(5, 24)",15,88,102,205,18,107,110,235
384,0.18,"(17, 16)","(29, 2)",4,155,158,317,5,41,34,80
385,0.12,"(4, 9)","(26, 19)",12,66,77,155,6,321,284,611
386,0.08,"(11, 3)","(29, 25)",4,120,123,247,12,486,450,948
387,0.08,"(29, 18)","(27, 17)",13,47,59,119,11,91,87,189
388,0.06,"(19, 0)","(9, 25)",8,302,309,619,4,211,190,405
389,0.12,"(22, 21)","(13, 23)",13,299,311,623,4,53,43,100
390,0.02,"(12, 26)","(14, 8)",21,157,177,355,4,106,92,202
391,0.2,"(10, 3)","(11, 27)",4,74,77,155,9,102,99,210
392,0.08,"(8, 13)","(17, 11)",12,100,111,223,12,16,17,45
393,0.18,"(27, 27)","(6, 29)",10,123,132,265,3,173,150,326
394,0.14,"(19, 27)","(16, 23)",5,119,123,247,8,164,144,316
395,0.04,"(22, 13)","(6, 17)",8,84,91,183,9,205,194,408
396,0.16,"(20, 23)","(14, 1)",11,136,146,293,10,116,115,241
397,0.12,"(16, 13)","(14, 15)",4,113,116,233,6,286,275,567
398,0.04,"(1, 19)","(2, 29)",10,71,80,161,20,96,95,211
399,0.04,"(12, 16)","(24, 28)",6,89,94,189,10,196,177,383
400,0.08,"(16, 14)","(23, 7)",6,63,68,137,8,141,131,280
401,0.02,"(7, 23)","(10, 21)",17,199,215,431,13,46,48,107
402,0.02,"(15, 8)","(19, 17)",5,77,81,163,3,29,18,50
403,0.14,"(20, 6)","(25, 14)",9,58,66,133,5,421,380,806
404,0.16,"(18, 0)","(3, 26)",8,80,87,175,2,283,271,556
405,0.04,"(22, 18)","(14, 15)",7,75,81,163,3,92,81,176
406,0.18,"(14, 16)","(0, 0)",8,252,259,519,17,138,135,290
407,0.08,"(25, 19)","(4, 6)",9,98,106,213,8,137,127,272
408,0.2,"(24, 9)","(23, 13)",17,136,152,305,12,207,187,406
409,0.04,"(21, 15)","(14, 16)",7,152,158,317,10,301,261,572
410,0.1,"(9, 20)","(13, 6)",15,99,113,227,15,96,97,208
411,0.14,"(23, 27)","(0, 14)",7,134,140,281,11,171,163,345
412,0.14,"(12, 0)","(17, 25)",11,94,104,209,9,112,92,213
413,0.18,"(20, 14)","(4, 3)",5,88,92,185,5,178,169,352
414,0.1,"(10, 12)","(8, 2)",3,100,102,205,6,69,58,133
415,0.14,"(4, 8)","(1, 27)",32,55,86,173,8,79,73,160
416,0.02,"(9, 12)","(26, 26)",14,295,308,617,6,67,58,131
417,0.1,"(27, 10)","(26, 28)",5,460,464,929,14,91,92,197
418,0.04,"(25, 17)","(0, 5)",8,40,47,95,4,261,240,505
419,0.18,"(29, 21)","(3, 28)",5,126,130,261,4,126,110,240
420,0.04,"(18, 16)","(1, 21)",16,127,142,285,14,93,93,200
421,0.14,"(23, 18)","(6, 9)",7,67,73,147,9,233,211,453
422,0.02,"(29, 23)","(25, 17)",10,29,38,77,5,88,80,173
423,0.06,"(12, 11)","(16, 28)",13,110,122,245,4,128,95,227
424,0.14,"(8, 18)","(16, 7)",8,138,145,291,7,162,150,319
425,0.06,"(1, 11)","(28, 5)",8,151,158,317,4,83,74,161
426,0.16,"(19, 6)","(12, 18)",8,67,74,149,4,49,33,86
427,0.04,"(10, 17)","(12, 28)",7,170,176,353,6,38,30,74
428,0.08,"(23, 25)","(26, 28)",7,105,111,223,6,41,35,82
429,0.2,"(7, 15)","(15, 0)",6,189,194,389,5,344,319,668
430,0.16,"(20, 21)","(13, 18)",4,10,13,27,9,58,54,121
431,0.12,"(15, 7)","(12, 2)",7,77,83,167,5,212,199,416
432,0.12,"(17, 21)","(19, 29)",14,136,149,299,16,22,26,64
433,0.16,"(26, 4)","(2, 19)",4,155,158,317,7,62,57,126
434,0.12,"(7, 2)","(12, 2)",5,4,8,17,4,422,375,801
435,0.16,"(24, 23)","(8, 27)",4,54,57,115,10,166,154,330
436,0.02,"(10, 21)","(4, 9)",9,68,76,153,10,106,101,217
437,0.2,"(19, 21)","(6, 1)",6,202,207,415,7,96,81,184
438,0.2,"(21, 13)","(29, 4)",11,234,244,489,11,121,115,247
439,0.14,"(0, 11)","(15, 11)",7,150,156,313,5,183,172,360
440,0.16,"(28, 6)","(13, 3)",3,177,179,359,5,87,69,161
441,0.06,"(7, 24)","(10, 12)",11,91,101,203,4,182,153,339
442,0.12,"(28, 20)","(13, 24)",3,290,292,585,5,194,173,372
443,0.1,"(29, 1)","(17, 28)",8,115,122,245,7,237,226,470
444,0.18,"(8, 13)","(17, 15)",13,55,67,135,6,236,231,473
445,0.1,"(13, 6)","(0, 25)",9,195,203,407,5,180,155,340
446,0.2,"(16, 6)","(2, 17)",3,246,248,497,10,228,204,442
447,0.02,"(11, 24)","(22, 29)",6,181,186,373,5,72,60,137
448,0.12,"(6, 2)","(20, 15)",13,126,138,277,8,86,80,174
449,0.06,"(16, 13)","(4, 29)",6,75,80,161,4,296,261,561
450,0.16,"(10, 20)","(10, 15)",16,138,153,307,9,15,9,33
451,0.04,"(2, 26)","(27, 6)",5,170,174,349,8,201,185,394
452,0.02,"(21, 21)","(27, 2)",10,169,178,357,18,247,240,505
453,0.1,"(21, 17)","(27, 15)",13,124,136,273,6,177,159,342
454,0.06,"(9, 26)","(23, 25)",8,123,130,261,7,40,32,79
455,0.04,"(16, 13)","(21, 15)",3,21,23,47,6,9,6,21
456,0.12,"(24, 19)","(19, 18)",8,307,314,629,8,188,180,376
457,0.04,"(10, 12)","(4, 7)",11,444,454,909,12,168,155,335
458,0.12,"(27, 4)","(17, 16)",7,49,55,111,12,51,50,113
459,0.14,"(17, 27)","(27, 20)",17,189,205,411,8,244,217,469
460,0.02,"(2, 6)","(18, 26)",6,1083,1088,2177,6,302,274,582
461,0.18,"(19, 7)","(26, 5)",8,31,38,77,8,37,32,77
462,0.02,"(8, 11)","(27, 2)",8,36,43,87,7,182,174,363
463,0.04,"(8, 4)","(28, 23)",5,184,188,377,3,146,129,278
464,0.02,"(7, 7)","(3, 28)",6,73,78,157,5,127,111,243
465,0.1,"(18, 22)","(7, 7)",6,97,102,205,9,110,102,221
466,0.14,"(2, 5)","(2, 22)",9,117,125,251,9,85,78,172
467,0.2,"(24, 29)","(20, 7)",4,112,115,231,7,630,610,1247
468,0.2,"(28, 2)","(10, 17)",5,191,195,391,9,153,148,310
469,0.18,"(6, 5)","(13, 8)",10,32,41,83,10,101,93,204
470,0.14,"(29, 21)","(20, 15)",8,9,16,33,16,77,71,164
471,0.2,"(17, 28)","(12, 0)",9,79,87,175,5,97,86,188
472,0.18,"(21, 3)","(3, 28)",10,81,90,181,4,126,113,243
473,0.14,"(3, 9)","(19, 20)",8,26,33,67,6,458,421,885
474,0.06,"(1, 7)","(7, 7)",6,24,29,59,5,22,12,39
475,0.16,"(13, 10)","(28, 17)",8,103,110,221,15,61,62,138
476,0.14,"(8, 1)","(18, 14)",13,59,71,143,10,147,127,284
477,0.2,"(13, 2)","(3, 22)",9,185,193,387,8,100,88,196
478,0.1,"(26, 14)","(12, 18)",6,72,77,155,8,174,151,333
479,0.1,"(18, 4)","(26, 23)",7,103,109,219,21,131,141,293
480,0.14,"(20, 6)","(13, 27)",10,86,95,191,6,121,109,236
481,0.2,"(23, 18)","(0, 12)",12,157,168,337,25,141,147,313
482,0.04,"(23, 24)","(1, 11)",16,245,260,521,6,63,54,123
483,0.1,"(20, 15)","(26, 29)",6,300,305,611,12,144,137,293
484,0.12,"(10, 8)","(5, 7)",9,48,56,113,12,292,265,569
485,0.02,"(19, 4)","(16, 13)",9,144,152,305,5,534,482,1021
486,0.16,"(24, 29)","(16, 8)",4,35,38,77,6,176,168,350
487,0.18,"(17, 8)","(6, 13)",3,17,19,39,4,312,280,596
488,0.14,"(11, 8)","(4, 16)",5,395,399,799,5,82,74,161
489,0.2,"(7, 0)","(17, 19)",7,274,280,561,7,59,51,117
490,0.12,"(15, 10)","(23, 20)",5,123,127,255,18,96,93,207
491,0.12,"(20, 16)","(19, 27)",8,302,309,619,5,83,73,161
492,0.1,"(10, 25)","(13, 24)",11,136,146,293,8,37,25,70
493,0.14,"(29, 11)","(2, 27)",3,383,385,771,5,57,50,112
494,0.06,"(19, 22)","(9, 6)",11,160,170,341,10,192,173,375
495,0.14,"(2, 23)","(19, 16)",5,109,113,227,3,356,328,687
496,0.12,"(25, 13)","(29, 26)",12,114,125,251,8,74,66,148
497,0.1,"(17, 21)","(3, 3)",4,40,43,87,3,59,43,105
498,0.14,"(2, 10)","(14, 25)",10,88,97,195,8,193,175,376
499,0.08,"(20, 9)","(16, 28)",6,209,214,429,7,139,115,261
500,0.18,"(13, 16)","(18, 4)",20,85,104,209,7,102,87,196
501,0.04,"(1, 5)","(17, 3)",6,121,126,253,5,120,109,234
502,0.1,"(28, 22)","(27, 3)",8,101,108,217,3,127,118,248
503,0.12,"(29, 9)","(22, 18)",4,158,161,323,9,44,39,92
504,0.08,"(23, 0)","(28, 11)",6,277,282,565,3,108,93,204
505,0.02,"(14, 23)","(5, 26)",5,523,527,1055,8,241,218,467
506,0.16,"(1, 29)","(1, 17)",3,108,110,221,3,38,25,66
507,0.18,"(7, 8)","(7, 25)",4,117,120,241,5,166,147,318
508,0.02,"(22, 28)","(2, 29)",7,125,131,263,5,147,133,285
509,0.08,"(7, 20)","(3, 4)",7,97,103,207,8,62,51,121
510,0.18,"(29, 27)","(17, 28)",31,12,42,85,40,132,149,321
511,0.16,"(25, 22)","(27, 27)",5,167,171,343,7,301,279,587
512,0.12,"(13, 27)","(5, 26)",2,45,46,93,2,65,35,102
513,0.08,"(13, 0)","(27, 19)",10,181,190,381,22,181,180,383
514,0.08,"(9, 8)","(23, 18)",13,143,155,311,3,82,63,148
515,0.14,"(24, 29)","(8, 8)",4,67,70,141,8,86,76,170
516,0.04,"(2, 19)","(7, 26)",9,69,77,155,7,192,176,375
517,0.08,"(17, 22)","(17, 4)",4,212,215,431,7,73,62,142
518,0.16,"(16, 29)","(29, 24)",6,325,330,661,8,85,78,171
519,0.02,"(1, 14)","(8, 12)",7,188,194,389,4,504,455,963
520,0.14,"(0, 8)","(15, 3)",5,143,147,295,6,51,41,98
521,0.06,"(16, 17)","(21, 7)",7,104,110,221,11,196,191,398
522,0.12,"(0, 1)","(9, 0)",4,101,104,209,4,17,8,29
523,0.14,"(14, 20)","(26, 2)",5,84,88,177,9,107,97,213
524,0.04,"(9, 2)","(0, 22)",13,92,104,209,10,72,67,149
525,0.1,"(4, 17)","(24, 2)",6,120,125,251,11,99,96,206
526,0.2,"(23, 16)","(21, 28)",5,162,166,333,7,122,117,246
527,0.06,"(0, 9)","(22, 27)",24,126,149,299,3,117,102,222
528,0.1,"(16, 4)","(25, 18)",18,76,93,187,7,155,140,302
529,0.2,"(21, 12)","(5, 19)",8,62,69,139,6,111,98,215
530,0.08,"(21, 4)","(18, 14)",5,144,148,297,4,115,81,200
531,0.14,"(7, 8)","(0, 26)",3,153,155,311,6,81,74,161
532,0.18,"(25, 3)","(25, 16)",4,64,67,135,7,168,161,336
533,0.12,"(0, 7)","(1, 12)",9,50,58,117,7,76,72,155
534,0.18,"(5, 10)","(21, 1)",18,375,392,785,24,154,150,328
535,0.02,"(15, 0)","(15, 15)",25,197,221,443,4,41,34,79
536,0.2,"(3, 25)","(0, 11)",7,389,395,791,7,175,158,340
537,0.16,"(28, 23)","(5, 14)",5,152,156,313,5,57,49,111
538,0.2,"(10, 13)","(15, 6)",4,104,107,215,6,92,83,181
539,0.16,"(9, 9)","(14, 20)",7,68,74,149,16,42,42,100
540,0.02,"(22, 1)","(22, 23)",6,425,430,861,6,98,75,179
541,0.12,"(27, 24)","(27, 29)",8,90,97,195,10,209,193,412
542,0.02,"(5, 26)","(29, 7)",11,62,72,145,8,354,331,693
543,0.12,"(9, 17)","(9, 18)",4,175,178,357,4,31,20,55
544,0.02,"(23, 2)","(9, 10)",5,32,36,73,11,156,156,323
545,0.1,"(27, 18)","(4, 0)",4,202,205,411,7,171,163,341
546,0.08,"(14, 10)","(1, 7)",23,97,119,239,8,327,277,612
547,0.2,"(6, 3)","(14, 19)",6,90,95,191,13,171,173,357
548,0.18,"(0, 29)","(12, 3)",4,80,83,167,3,202,164,369
549,0.2,"(10, 3)","(29, 18)",9,238,246,493,4,178,150,332
550,0.18,"(29, 15)","(29, 27)",6,165,170,341,12,76,75,163
551,0.08,"(1, 20)","(14, 17)",11,181,191,383,15,49,46,110
552,0.1,"(26, 19)","(9, 3)",10,115,124,249,9,96,81,186
553,0.18,"(27, 25)","(11, 24)",3,63,65,131,3,109,95,207
554,0.02,"(8, 23)","(26, 12)",12,307,318,637,6,141,122,269
555,0.02,"(28, 14)","(15, 26)",3,227,229,459,5,87,68,160
556,0.2,"(3, 25)","(12, 12)",7,78,84,169,16,163,155,334
557,0.18,"(11, 10)","(0, 27)",3,78,80,161,5,82,69,156
558,0.16,"(16, 19)","(9, 17)",12,158,169,339,8,220,199,427
559,0.12,"(19, 23)","(14, 24)",13,70,82,165,21,58,55,134
560,0.14,"(29, 4)","(26, 8)",7,161,167,335,8,47,43,98
561,0.06,"(25, 8)","(27, 2)",7,32,38,77,8,136,130,274
562,0.1,"(0, 25)","(16, 13)",7,273,279,559,6,217,198,421
563,0.14,"(29, 9)","(10, 15)",3,26,28,57,5,113,103,221
564,0.04,"(15, 18)","(14, 8)",14,99,112,225,24,368,363,755
565,0.08,"(8, 6)","(15, 2)",8,13,20,41,6,272,264,542
566,0.18,"(4, 11)","(0, 5)",20,25,44,89,15,46,50,111
567,0.18,"(25, 26)","(11, 4)",16,63,78,157,4,231,224,459
568,0.14,"(11, 9)","(25, 2)",4,65,68,137,16,128,128,272
569,0.06,"(23, 26)","(22, 26)",6,102,107,215,5,11,5,21
570,0.2,"(19, 26)","(11, 24)",7,362,368,737,5,91,73,169
571,0.06,"(16, 26)","(7, 15)",16,154,169,339,21,131,126,278
572,0.04,"(16, 19)","(17, 22)",13,175,187,375,5,229,200,434
573,0.12,"(15, 13)","(9, 0)",5,134,138,277,16,149,149,314
574,0.04,"(4, 18)","(3, 5)",9,129,137,275,4,157,146,307
575,0.2,"(14, 22)","(10, 16)",11,125,135,271,9,40,33,82
576,0.18,"(23, 1)","(18, 29)",8,74,81,163,13,156,140,309
577,0.02,"(20, 1)","(16, 7)",2,116,117,235,4,65,41,110
578,0.14,"(13, 2)","(24, 4)",8,138,145,291,3,38,28,69
579,0.04,"(23, 27)","(5, 9)",13,43,55,111,6,248,219,473
580,0.14,"(25, 21)","(15, 5)",7,61,67,135,14,184,180,378
581,0.2,"(9, 28)","(17, 11)",12,142,153,307,10,174,164,348
582,0.1,"(22, 14)","(6, 24)",4,185,188,377,8,85,72,165
583,0.12,"(6, 4)","(6, 24)",4,147,150,301,4,207,182,393
584,0.08,"(20, 21)","(17, 18)",9,181,189,379,4,47,38,89
585,0.16,"(2, 4)","(21, 16)",9,105,113,227,5,158,144,307
586,0.04,"(6, 19)","(5, 11)",9,166,174,349,9,251,249,509
587,0.06,"(14, 15)","(15, 13)",7,299,305,611,8,158,136,302
588,0.12,"(17, 5)","(29, 1)",5,101,105,211,10,268,254,532
589,0.06,"(10, 12)","(8, 25)",5,493,497,995,8,428,393,829
590,0.18,"(13, 2)","(12, 21)",5,94,98,197,5,124,111,240
591,0.12,"(10, 22)","(26, 25)",5,67,71,143,6,85,75,166
592,0.04,"(4, 14)","(2, 27)",11,332,342,685,3,44,32,79
593,0.12,"(21, 18)","(17, 14)",6,14,19,39,23,92,96,211
594,0.08,"(1, 12)","(7, 16)",9,73,81,163,4,137,126,267
595,0.16,"(7, 2)","(1, 7)",8,59,66,133,6,142,116,264
596,0.14,"(25, 10)","(3, 23)",5,285,289,579,19,48,54,121
597,0.1,"(2, 4)","(29, 21)",4,348,351,703,4,46,39,89
598,0.04,"(1, 28)","(20, 24)",7,225,231,463,3,431,362,796
599,0.06,"(0, 26)","(4, 8)",6,204,209,419,3,136,121,260
600,0.1,"(25, 8)","(24, 19)",14,309,322,645,6,102,91,199
601,0.18,"(25, 10)","(9, 0)",19,71,89,179,7,73,67,147
602,0.16,"(18, 6)","(0, 8)",5,13,17,35,4,297,278,579
603,0.1,"(8, 0)","(14, 3)",9,307,315,631,13,82,69,164
604,0.16,"(14, 9)","(1, 7)",5,80,84,169,14,31,31,76
605,0.12,"(23, 8)","(15, 10)",29,121,149,299,14,25,21,60
606,0.16,"(18, 12)","(17, 3)",16,198,213,427,9,219,186,414
607,0.16,"(13, 6)","(27, 19)",7,98,104,209,7,170,145,322
608,0.12,"(17, 28)","(23, 25)",3,157,159,319,8,37,33,78
609,0.2,"(10, 7)","(16, 27)",6,130,135,271,16,67,68,151
610,0.04,"(19, 25)","(22, 15)",8,399,406,813,23,484,448,955
611,0.1,"(9, 3)","(0, 4)",7,233,239,479,18,85,83,186
612,0.02,"(25, 13)","(9, 7)",6,191,196,393,7,314,286,607
613,0.16,"(3, 2)","(24, 16)",4,109,112,225,4,436,399,839
614,0.16,"(17, 4)","(20, 10)",5,14,18,37,3,73,60,136
615,0.08,"(28, 24)","(13, 22)",4,399,402,805,3,117,108,228
616,0.08,"(11, 5)","(0, 11)",6,17,22,45,13,132,128,273
617,0.02,"(23, 19)","(8, 7)",9,116,124,249,7,45,36,88
618,0.14,"(22, 26)","(15, 0)",4,123,126,253,5,157,128,290
619,0.04,"(20, 26)","(8, 7)",21,488,508,1017,9,356,319,684
620,0.12,"(7, 8)","(29, 24)",8,68,75,151,6,268,255,529
621,0.1,"(4, 24)","(28, 6)",8,277,284,569,4,161,139,304
622,0.12,"(26, 21)","(12, 10)",15,63,77,155,5,50,37,92
623,0.16,"(9, 19)","(1, 3)",3,127,129,259,5,48,39,92
624,0.08,"(13, 8)","(20, 26)",5,205,209,419,10,92,87,189
625,0.12,"(29, 18)","(24, 15)",5,46,50,101,3,82,54,139
626,0.08,"(29, 10)","(14, 29)",9,136,144,289,5,140,121,266
627,0.02,"(3, 29)","(15, 9)",14,170,183,367,4,79,65,148
628,0.14,"(19, 0)","(12, 26)",8,197,204,409,7,93,85,185
629,0.04,"(14, 13)","(23, 27)",5,107,111,223,14,82,84,180
630,0.02,"(9, 19)","(12, 8)",8,81,88,177,5,240,195,440
631,0.1,"(9, 23)","(5, 23)",20,298,317,635,3,31,22,56
632,0.04,"(2, 7)","(25, 21)",4,259,262,525,7,352,300,659
633,0.02,"(20, 9)","(18, 2)",4,55,58,117,19,222,209,450
634,0.16,"(17, 10)","(18, 0)",4,192,195,391,7,211,184,402
635,0.12,"(7, 0)","(7, 7)",10,23,32,65,5,28,16,49
636,0.08,"(13, 16)","(12, 2)",25,527,551,1103,4,92,83,179
637,0.14,"(28, 25)","(3, 13)",16,48,63,127,3,198,180,381
638,0.04,"(10, 1)","(22, 16)",17,270,286,573,14,35,34,83
639,0.06,"(4, 22)","(9, 25)",9,143,151,303,17,64,57,138
640,0.16,"(25, 17)","(27, 13)",5,88,92,185,6,121,113,240
641,0.06,"(21, 24)","(1, 8)",6,228,233,467,9,179,155,343
642,0.2,"(4, 16)","(4, 4)",11,122,132,265,7,16,12,35
643,0.18,"(22, 11)","(11, 15)",7,24,30,61,5,82,66,153
644,0.04,"(3, 12)","(15, 13)",14,258,271,543,18,92,92,202
645,0.14,"(27, 28)","(20, 18)",13,66,78,157,7,37,29,73
646,0.14,"(22, 11)","(20, 28)",6,84,89,179,7,178,167,352
647,0.1,"(7, 22)","(6, 0)",7,107,113,227,9,68,57,134
648,0.06,"(6, 22)","(28, 14)",7,103,109,219,13,106,93,212
649,0.12,"(15, 7)","(0, 28)",6,93,98,197,11,152,142,305
650,0.14,"(15, 28)","(14, 19)",4,17,20,41,7,162,140,309
651,0.18,"(16, 28)","(17, 18)",16,305,320,641,9,59,51,119
652,0.14,"(6, 27)","(1, 0)",8,435,442,885,5,71,65,141
653,0.14,"(15, 11)","(9, 13)",8,126,133,267,14,183,174,371
654,0.04,"(5, 16)","(13, 14)",4,78,81,163,6,112,103,221
655,0.16,"(1, 28)","(13, 24)",24,123,146,293,4,73,59,136
656,0.08,"(10, 16)","(23, 6)",20,85,104,209,5,77,70,152
657,0.18,"(7, 18)","(8, 22)",14,57,70,141,5,42,28,75
658,0.04,"(25, 4)","(11, 9)",6,63,68,137,6,47,32,85
659,0.14,"(2, 23)","(28, 7)",10,230,239,479,22,58,67,147
660,0.16,"(12, 9)","(15, 11)",37,130,166,333,10,1,10,21
661,0.08,"(11, 4)","(28, 12)",9,107,115,231,17,377,348,742
662,0.2,"(13, 2)","(0, 15)",4,56,59,119,8,83,68,159
663,0.04,"(15, 0)","(8, 16)",18,107,124,249,7,140,124,271
664,0.06,"(26, 17)","(4, 25)",7,71,77,155,4,112,95,211
665,0.12,"(9, 5)","(22, 16)",15,168,182,365,6,65,54,125
666,0.02,"(26, 22)","(3, 22)",6,157,162,325,6,71,61,138
667,0.16,"(14, 12)","(10, 25)",15,140,154,309,12,91,85,188
668,0.08,"(9, 10)","(14, 7)",4,164,167,335,3,127,111,241
669,0.16,"(7, 2)","(9, 28)",4,38,41,83,4,117,95,216
670,0.08,"(23, 4)","(8, 6)",6,63,68,137,4,70,57,131
671,0.14,"(15, 23)","(12, 0)",7,150,156,313,12,87,87,186
672,0.12,"(24, 6)","(0, 21)",3,46,48,97,4,214,180,398
673,0.08,"(6, 11)","(4, 15)",6,145,150,301,4,67,55,126
674,0.2,"(3, 9)","(8, 17)",9,161,169,339,4,35,22,61
675,0.12,"(1, 10)","(3, 23)",9,250,258,517,3,84,73,160
676,0.18,"(1, 16)","(11, 18)",6,328,333,667,4,145,115,264
677,0.04,"(26, 20)","(27, 3)",6,89,94,189,5,132,123,260
678,0.14,"(12, 18)","(13, 11)",8,90,97,195,3,104,93,200
679,0.08,"(11, 27)","(16, 18)",16,279,294,589,17,120,115,252
680,0.08,"(12, 2)","(4, 12)",8,205,212,425,8,59,47,114
681,0.2,"(16, 17)","(10, 23)",11,281,291,583,14,62,52,128
682,0.06,"(8, 9)","(26, 19)",9,131,139,279,6,141,117,264
683,0.14,"(0, 15)","(12, 11)",4,237,240,481,4,55,44,103
684,0.08,"(20, 1)","(9, 5)",6,219,224,449,16,52,56,124
685,0.12,"(10, 2)","(25, 28)",3,131,133,267,4,178,151,333
686,0.04,"(2, 26)","(13, 8)",6,177,182,365,9,66,62,137
687,0.1,"(21, 10)","(9, 23)",16,109,124,249,6,273,261,540
688,0.06,"(15, 0)","(6, 4)",4,319,322,645,12,65,50,127
689,0.2,"(0, 7)","(16, 13)",7,663,669,1339,2,81,72,155
690,0.16,"(16, 3)","(6, 15)",10,125,134,269,3,110,98,211
691,0.14,"(17, 1)","(9, 17)",3,24,26,53,4,100,83,187
692,0.04,"(12, 8)","(7, 9)",3,79,81,163,6,92,78,176
693,0.18,"(23, 10)","(27, 18)",15,91,105,211,13,195,179,387
694,0.12,"(26, 8)","(5, 29)",6,177,182,365,8,65,58,131
695,0.16,"(6, 24)","(4, 15)",8,95,102,205,7,89,82,178
696,0.1,"(24, 19)","(2, 28)",9,44,52,105,5,112,97,214
697,0.16,"(3, 22)","(12, 19)",13,171,183,367,6,153,137,296
698,0.1,"(25, 12)","(25, 27)",11,250,260,521,14,86,85,185
699,0.14,"(19, 19)","(19, 16)",25,41,65,131,12,41,40,93
700,0.2,"(17, 10)","(16, 12)",4,171,174,349,8,32,25,65
701,0.12,"(21, 4)","(25, 24)",7,56,62,125,19,60,64,143
702,0.16,"(0, 5)","(22, 5)",8,95,102,205,15,141,131,287
703,0.12,"(22, 3)","(4, 22)",5,66,70,141,8,169,144,321
704,0.16,"(29, 28)","(19, 29)",5,319,323,647,4,153,135,292
705,0.04,"(5, 6)","(8, 12)",4,153,156,313,6,97,85,188
706,0.2,"(7, 21)","(22, 16)",16,59,74,149,10,173,150,333
707,0.02,"(13, 10)","(29, 10)",13,28,40,81,9,319,299,627
708,0.08,"(24, 22)","(9, 22)",5,202,206,413,8,92,77,177
709,0.04,"(20, 19)","(19, 0)",4,73,76,153,8,73,63,144
710,0.04,"(14, 14)","(3, 5)",5,232,236,473,7,57,51,115
711,0.1,"(13, 19)","(17, 15)",7,118,124,249,17,187,181,385
712,0.12,"(27, 18)","(15, 5)",5,21,25,51,3,51,43,97
713,0.08,"(28, 29)","(5, 5)",5,127,131,263,7,216,203,426
714,0.08,"(19, 5)","(3, 6)",2,157,158,317,7,131,120,258
715,0.1,"(5, 25)","(19, 0)",5,262,266,533,7,322,273,602
716,0.14,"(19, 13)","(23, 27)",4,102,105,211,13,91,93,197
717,0.02,"(3, 20)","(18, 15)",8,50,57,115,16,173,166,355
718,0.12,"(13, 8)","(4, 0)",5,198,202,405,4,72,64,140
719,0.04,"(28, 4)","(21, 3)",4,97,100,201,4,37,20,61
720,0.02,"(21, 17)","(29, 24)",11,106,116,233,12,74,68,154
721,0.04,"(16, 14)","(25, 27)",6,94,99,199,13,62,59,134
722,0.2,"(22, 19)","(22, 13)",14,184,197,395,6,102,89,197
723,0.08,"(1, 5)","(18, 15)",8,59,66,133,12,77,74,163
724,0.14,"(26, 15)","(28, 16)",8,114,121,243,13,28,25,66
725,0.1,"(12, 19)","(10, 2)",5,250,254,509,4,227,198,429
726,0.16,"(27, 9)","(8, 26)",11,121,131,263,11,98,92,201
727,0.04,"(3, 12)","(28, 2)",13,134,146,293,9,141,122,272
728,0.2,"(19, 16)","(6, 22)",15,109,123,247,6,79,65,150
729,0.06,"(2, 1)","(14, 27)",9,99,107,215,8,93,84,185
730,0.02,"(6, 15)","(18, 13)",7,343,349,699,9,102,99,210
731,0.04,"(1, 6)","(21, 23)",5,204,208,417,6,327,274,607
732,0.06,"(0, 20)","(27, 15)",5,73,77,155,12,101,99,212
733,0.16,"(3, 26)","(21, 27)",6,335,340,681,11,123,107,241
734,0.16,"(18, 28)","(29, 7)",17,96,112,225,7,114,106,227
735,0.14,"(28, 4)","(26, 5)",6,33,38,77,4,66,40,110
736,0.12,"(0, 2)","(2, 14)",5,42,46,93,9,287,259,555
737,0.08,"(4, 9)","(28, 0)",12,74,85,171,7,151,145,303
738,0.08,"(11, 17)","(25, 12)",7,198,204,409,10,108,99,217
739,0.12,"(15, 16)","(8, 18)",13,99,111,223,6,46,36,88
740,0.1,"(7, 0)","(28, 6)",5,632,636,1273,3,186,159,348
741,0.08,"(25, 16)","(20, 21)",6,38,43,87,12,128,127,267
742,0.1,"(15, 11)","(9, 4)",7,79,85,171,9,56,49,114
743,0.06,"(25, 23)","(22, 21)",5,7,11,23,6,36,30,72
744,0.08,"(23, 21)","(28, 7)",9,144,152,305,9,59,46,114
745,0.16,"(23, 2)","(21, 16)",9,102,110,221,11,115,103,229
746,0.02,"(29, 10)","(11, 18)",4,153,156,313,2,231,219,452
747,0.04,"(27, 16)","(27, 4)",12,53,64,129,4,87,76,167
748,0.02,"(27, 29)","(24, 16)",7,33,39,79,7,118,107,232
749,0.2,"(26, 15)","(0, 4)",22,130,151,303,6,61,56,123
750,0.06,"(29, 5)","(29, 26)",6,370,375,751,4,205,166,375
751,0.08,"(26, 23)","(9, 28)",8,278,285,571,5,156,144,305
752,0.08,"(3, 16)","(27, 28)",5,141,145,291,11,91,91,193
753,0.14,"(13, 11)","(27, 21)",11,66,76,153,9,87,82,178
754,0.08,"(27, 18)","(29, 22)",12,28,39,79,10,33,27,70
755,0.12,"(22, 5)","(12, 7)",20,127,146,293,6,48,39,93
756,0.08,"(25, 20)","(23, 1)",6,98,103,207,11,188,180,379
757,0.06,"(22, 3)","(26, 26)",5,492,496,993,6,50,41,97
758,0.02,"(2, 2)","(24, 28)",3,144,146,293,3,196,172,371
759,0.16,"(13, 17)","(8, 3)",10,89,98,197,11,100,96,207
760,0.06,"(29, 15)","(9, 29)",4,97,100,201,6,66,61,133
761,0.04,"(8, 29)","(18, 5)",3,125,127,255,7,153,134,294
762,0.2,"(9, 12)","(13, 22)",4,202,205,411,7,58,52,117
763,0.02,"(6, 24)","(27, 18)",5,211,215,431,6,112,98,216
764,0.18,"(1, 0)","(29, 1)",3,134,136,273,5,126,117,248
765,0.2,"(14, 20)","(11, 16)",4,34,37,75,4,67,48,119
766,0.16,"(8, 28)","(8, 3)",4,65,68,137,5,204,195,404
767,0.14,"(28, 22)","(0, 13)",8,213,220,441,5,75,62,142
768,0.18,"(6, 21)","(6, 23)",9,178,186,373,10,107,100,217
769,0.1,"(2, 8)","(21, 15)",8,185,192,385,10,76,69,155
770,0.06,"(8, 12)","(29, 2)",9,60,68,137,13,222,194,429
771,0.14,"(19, 13)","(12, 20)",10,110,119,239,6,138,131,275
772,0.14,"(18, 8)","(2, 4)",13,156,168,337,4,146,138,288
773,0.12,"(6, 7)","(26, 23)",8,70,77,155,15,55,54,124
774,0.18,"(24, 13)","(20, 19)",4,74,77,155,3,161,136,300
775,0.02,"(22, 22)","(28, 17)",10,249,258,517,12,126,122,260
776,0.16,"(11, 24)","(3, 21)",6,105,110,221,5,279,234,518
777,0.08,"(14, 20)","(25, 24)",5,122,126,253,8,68,61,137
778,0.14,"(19, 8)","(18, 22)",13,57,69,139,12,137,116,265
779,0.06,"(1, 7)","(10, 8)",7,69,75,151,7,136,130,273
780,0.02,"(22, 17)","(1, 4)",11,395,405,811,3,63,47,113
781,0.1,"(22, 20)","(23, 15)",5,26,30,61,4,531,499,1034
782,0.06,"(4, 16)","(9, 10)",2,75,76,153,11,32,28,71
783,0.12,"(5, 21)","(27, 9)",5,67,71,143,6,185,165,356
784,0.1,"(7, 10)","(3, 18)",11,29,39,79,7,71,57,135
785,0.02,"(22, 15)","(16, 8)",4,121,124,249,4,109,92,205
786,0.12,"(2, 16)","(16, 17)",5,152,156,313,15,117,107,239
787,0.04,"(20, 23)","(14, 13)",4,111,114,229,13,127,124,264
788,0.14,"(26, 5)","(4, 24)",16,72,87,175,5,97,85,187
789,0.02,"(22, 16)","(12, 8)",4,298,301,603,22,96,105,223
790,0.14,"(26, 24)","(5, 26)",6,112,117,235,5,83,69,157
791,0.18,"(6, 5)","(9, 10)",19,45,63,127,12,34,29,75
792,0.06,"(6, 12)","(28, 27)",11,37,47,95,15,49,50,114
793,0.06,"(20, 5)","(10, 13)",6,131,136,273,6,38,31,75
794,0.14,"(27, 6)","(6, 15)",4,253,256,513,6,131,121,258
795,0.18,"(25, 24)","(15, 11)",12,114,125,251,7,66,62,135
796,0.08,"(16, 22)","(8, 24)",7,674,680,1361,7,102,96,205
797,0.04,"(6, 4)","(16, 21)",9,219,227,455,6,152,138,296
798,0.02,"(1, 6)","(11, 19)",4,289,292,585,5,156,143,304
799,0.06,"(19, 8)","(23, 25)",4,107,110,221,5,92,84,181
800,0.06,"(21, 8)","(5, 25)",4,400,403,807,12,317,291,620
801,0.16,"(13, 3)","(26, 15)",5,53,57,115,7,241,221,469
802,0.18,"(29, 25)","(10, 2)",14,82,95,191,7,226,199,432
803,0.06,"(3, 9)","(20, 21)",11,91,101,203,7,61,57,125
804,0.12,"(9, 17)","(3, 10)",10,137,146,293,3,162,148,313
805,0.14,"(19, 29)","(29, 0)",8,154,161,323,4,87,79,170
806,0.2,"(12, 1)","(26, 6)",5,86,90,181,4,156,131,291
807,0.16,"(29, 24)","(8, 5)",13,77,89,179,6,84,76,166
808,0.14,"(18, 23)","(10, 19)",9,151,159,319,3,93,77,173
809,0.14,"(23, 1)","(16, 19)",3,165,167,335,4,82,67,153
810,0.12,"(6, 15)","(27, 29)",12,84,95,191,6,61,56,123
811,0.04,"(28, 20)","(5, 15)",9,124,132,265,6,181,175,362
812,0.14,"(0, 23)","(3, 10)",3,86,88,177,4,127,110,241
813,0.12,"(28, 26)","(26, 28)",8,14,21,43,5,27,19,51
814,0.12,"(22, 6)","(25, 28)",6,102,107,215,7,101,97,205
815,0.02,"(13, 25)","(15, 26)",20,268,287,575,5,235,198,438
816,0.08,"(1, 13)","(8, 7)",3,12,14,29,5,136,115,256
817,0.16,"(1, 1)","(12, 6)",3,139,141,283,9,54,49,112
818,0.18,"(19, 6)","(6, 8)",4,145,148,297,4,98,83,185
819,0.12,"(4, 12)","(4, 2)",14,26,39,79,9,349,326,684
820,0.12,"(14, 15)","(18, 12)",5,87,91,183,10,145,130,285
821,0.14,"(27, 28)","(23, 10)",6,211,216,433,2,116,102,220
822,0.14,"(19, 11)","(22, 7)",5,68,72,145,5,37,26,68
823,0.12,"(27, 12)","(7, 8)",7,192,198,397,5,206,155,366
824,0.18,"(20, 28)","(17, 14)",15,96,110,221,9,197,175,381
825,0.14,"(19, 4)","(5, 10)",4,145,148,297,3,47,38,88
826,0.02,"(15, 21)","(17, 15)",8,211,218,437,16,7,16,39
827,0.08,"(18, 13)","(8, 19)",7,188,194,389,4,112,92,208
828,0.02,"(9, 19)","(25, 18)",6,178,183,367,12,203,190,405
829,0.18,"(14, 1)","(4, 12)",5,308,312,625,3,74,59,136
830,0.02,"(29, 18)","(13, 6)",11,142,152,305,6,100,86,192
831,0.16,"(24, 12)","(16, 9)",5,9,13,27,6,126,111,243
832,0.06,"(14, 17)","(2, 22)",7,124,130,261,8,139,130,277
833,0.06,"(0, 11)","(25, 4)",4,61,64,129,24,266,255,545
834,0.1,"(17, 1)","(15, 4)",7,137,143,287,5,29,19,53
835,0.2,"(0, 7)","(10, 11)",12,62,73,147,4,47,34,85
836,0.2,"(0, 25)","(2, 27)",13,8,20,41,12,15,12,39
837,0.18,"(14, 12)","(12, 26)",4,92,95,191,4,53,42,99
838,0.1,"(20, 12)","(25, 5)",8,270,277,555,4,109,99,212
839,0.12,"(24, 5)","(1, 24)",7,95,101,203,17,121,123,261
840,0.14,"(28, 6)","(19, 25)",5,220,224,449,12,59,56,127
841,0.16,"(20, 1)","(19, 16)",11,268,278,557,4,79,60,143
842,0.12,"(7, 6)","(17, 16)",12,176,187,375,3,108,91,202
843,0.06,"(9, 7)","(19, 2)",7,476,482,965,12,196,179,387
844,0.08,"(17, 1)","(5, 29)",10,91,100,201,4,289,271,564
845,0.1,"(29, 14)","(10, 26)",2,58,59,119,4,76,69,149
846,0.16,"(26, 5)","(28, 20)",14,247,260,521,6,110,101,217
847,0.08,"(5, 12)","(28, 15)",12,142,153,307,6,66,57,129
848,0.14,"(13, 26)","(16, 22)",7,42,48,97,6,149,132,287
849,0.02,"(13, 17)","(29, 11)",4,147,150,301,6,156,132,294
850,0.1,"(20, 3)","(11, 20)",3,97,99,199,13,105,101,219
851,0.02,"(29, 23)","(25, 26)",28,108,135,271,7,113,95,215
852,0.18,"(5, 19)","(3, 11)",6,277,282,565,5,246,230,481
853,0.04,"(0, 2)","(24, 14)",7,92,98,197,4,109,99,212
854,0.06,"(4, 24)","(10, 5)",5,74,78,157,5,56,49,110
855,0.08,"(1, 29)","(25, 0)",3,82,84,169,6,127,116,249
856,0.14,"(29, 0)","(29, 18)",4,29,32,65,5,250,227,482
857,0.16,"(26, 7)","(17, 9)",4,96,99,199,22,66,71,159
858,0.1,"(28, 1)","(1, 17)",5,283,287,575,6,141,134,281
859,0.1,"(20, 23)","(16, 20)",7,25,31,63,3,61,50,114
860,0.16,"(16, 1)","(20, 25)",6,99,104,209,15,331,295,641
861,0.02,"(12, 11)","(28, 19)",9,161,169,339,18,157,150,325
862,0.04,"(23, 0)","(1, 26)",4,76,79,159,11,129,109,249
863,0.12,"(7, 15)","(18, 4)",16,200,215,431,7,192,178,377
864,0.12,"(27, 25)","(18, 17)",16,75,90,181,6,167,136,309
865,0.08,"(15, 8)","(14, 19)",10,70,79,159,16,120,112,248
866,0.14,"(14, 20)","(7, 21)",5,48,52,105,4,80,53,137
867,0.14,"(19, 17)","(17, 18)",5,36,40,81,5,97,77,179
868,0.16,"(11, 0)","(1, 10)",7,141,147,295,8,92,81,181
869,0.2,"(28, 7)","(29, 2)",5,113,117,235,6,57,51,114
870,0.16,"(5, 2)","(16, 22)",26,108,133,267,5,92,83,180
871,0.12,"(23, 16)","(4, 10)",4,133,136,273,4,96,87,187
872,0.06,"(1, 10)","(28, 1)",5,143,147,295,4,81,72,157
873,0.14,"(27, 28)","(5, 6)",5,54,58,117,5,66,59,130
874,0.12,"(0, 26)","(9, 22)",6,20,25,51,6,147,132,285
875,0.14,"(20, 13)","(17, 9)",13,61,73,147,10,127,110,247
876,0.16,"(18, 8)","(22, 21)",9,64,72,145,6,151,135,292
877,0.1,"(11, 16)","(22, 3)",8,240,247,495,6,112,100,218
878,0.12,"(23, 1)","(5, 9)",6,67,72,145,6,117,87,210
879,0.02,"(0, 29)","(3, 2)",4,138,141,283,3,517,461,981
880,0.04,"(25, 10)","(1, 2)",9,128,136,273,9,71,62,142
881,0.04,"(3, 13)","(17, 16)",5,131,135,271,3,299,270,572
882,0.02,"(6, 8)","(1, 18)",10,217,226,453,7,390,340,737
883,0.02,"(4, 12)","(11, 13)",4,360,363,727,4,41,26,71
884,0.08,"(28, 13)","(8, 17)",6,146,151,303,12,52,51,115
885,0.14,"(20, 17)","(25, 16)",4,72,75,151,7,121,114,242
886,0.14,"(21, 9)","(7, 16)",3,28,30,61,3,189,174,366
887,0.16,"(22, 14)","(11, 27)",8,88,95,191,4,96,78,178
888,0.08,"(17, 19)","(25, 19)",10,181,190,381,6,97,88,191
889,0.14,"(6, 9)","(18, 0)",13,22,34,69,5,57,50,112
890,0.14,"(15, 19)","(1, 4)",12,33,44,89,6,90,71,167
891,0.18,"(28, 11)","(16, 20)",3,164,166,333,4,194,172,370
892,0.02,"(1, 10)","(29, 11)",11,161,171,343,9,257,228,494
893,0.12,"(1, 8)","(20, 23)",10,60,69,139,7,69,62,138
894,0.16,"(5, 20)","(29, 0)",4,63,66,133,5,126,118,249
895,0.2,"(9, 6)","(7, 0)",11,165,175,351,3,181,155,339
896,0.04,"(24, 27)","(6, 9)",4,54,57,115,7,217,207,431
897,0.06,"(26, 21)","(2, 17)",7,76,82,165,3,105,82,190
898,0.02,"(17, 8)","(5, 23)",4,289,292,585,3,96,88,187
899,0.14,"(16, 20)","(28, 24)",6,316,321,643,5,191,180,376
900,0.2,"(27, 25)","(21, 22)",4,165,168,337,4,37,29,70
901,0.18,"(15, 15)","(18, 15)",9,43,51,103,15,331,334,680
902,0.14,"(8, 29)","(16, 15)",5,261,265,531,10,31,30,71
903,0.04,"(28, 29)","(19, 13)",4,552,555,1111,9,301,289,599
904,0.04,"(7, 23)","(11, 18)",3,61,63,127,4,50,39,93
905,0.14,"(22, 10)","(17, 16)",5,181,185,371,4,57,48,109
906,0.14,"(18, 11)","(20, 20)",48,217,264,529,8,82,76,166
907,0.14,"(17, 7)","(27, 15)",13,147,159,319,3,34,23,60
908,0.08,"(6, 15)","(12, 14)",8,205,212,425,14,32,31,77
909,0.18,"(8, 17)","(26, 19)",5,84,88,177,4,158,129,291
910,0.1,"(12, 17)","(24, 17)",6,166,171,343,3,141,121,265
911,0.16,"(24, 2)","(26, 23)",6,149,154,309,4,299,273,576
912,0.1,"(19, 26)","(3, 22)",5,56,60,121,29,134,149,312
913,0.04,"(21, 16)","(2, 13)",16,137,152,305,21,79,84,184
914,0.16,"(2, 0)","(16, 21)",10,99,108,217,4,59,39,102
915,0.04,"(28, 28)","(0, 15)",6,90,95,191,6,130,114,250
916,0.2,"(10, 5)","(16, 16)",11,164,174,349,4,92,72,168
917,0.02,"(3, 7)","(15, 1)",5,230,234,469,8,286,267,561
918,0.12,"(18, 18)","(27, 24)",8,87,94,189,6,126,121,253
919,0.04,"(15, 21)","(14, 9)",15,159,173,347,14,106,94,214
920,0.02,"(29, 11)","(20, 23)",12,104,115,231,4,191,180,375
921,0.2,"(23, 8)","(13, 13)",9,54,62,125,10,66,59,135
922,0.16,"(25, 7)","(26, 20)",13,67,79,159,8,150,143,301
923,0.08,"(19, 22)","(6, 10)",4,173,176,353,8,142,129,279
924,0.06,"(16, 1)","(15, 17)",4,481,484,969,9,231,204,444
925,0.12,"(13, 23)","(21, 28)",11,266,276,553,6,72,65,143
926,0.18,"(1, 5)","(17, 14)",3,40,42,85,5,162,129,296
927,0.06,"(28, 4)","(29, 18)",4,55,58,117,8,163,150,321
928,0.14,"(21, 22)","(14, 26)",4,127,130,261,3,15,3,21
929,0.18,"(27, 15)","(10, 24)",7,91,97,195,5,98,86,189
930,0.04,"(28, 22)","(0, 16)",4,287,290,581,2,241,216,459
931,0.18,"(27, 12)","(11, 23)",6,175,180,361,9,164,129,302
932,0.16,"(9, 21)","(29, 3)",5,93,97,195,8,58,46,112
933,0.18,"(26, 0)","(11, 8)",4,102,105,211,4,96,88,188
934,0.04,"(24, 26)","(0, 27)",8,62,69,139,15,107,99,221
935,0.02,"(21, 0)","(11, 2)",14,95,108,217,13,189,181,383
936,0.06,"(16, 28)","(22, 23)",9,170,178,357,4,39,27,70
937,0.12,"(13, 24)","(20, 25)",6,40,45,91,6,66,60,132
938,0.06,"(6, 23)","(24, 21)",11,173,183,367,6,75,64,145
939,0.1,"(7, 16)","(9, 14)",3,49,51,103,9,299,278,586
940,0.04,"(13, 1)","(19, 6)",2,350,351,703,10,91,87,188
941,0.04,"(12, 12)","(8, 24)",4,212,215,431,10,490,454,954
942,0.2,"(2, 13)","(28, 5)",7,71,77,155,3,77,67,147
943,0.02,"(29, 28)","(5, 2)",4,92,95,191,2,141,123,266
944,0.18,"(15, 23)","(20, 8)",9,38,46,93,5,107,96,208
945,0.12,"(26, 14)","(17, 20)",3,136,138,277,8,35,28,71
946,0.14,"(27, 11)","(14, 27)",10,104,113,227,7,77,72,156
947,0.12,"(21, 22)","(9, 19)",7,208,214,429,6,76,52,134
948,0.14,"(13, 4)","(14, 16)",4,163,166,333,3,113,95,211
949,0.18,"(0, 0)","(8, 4)",6,28,33,67,9,99,74,182
950,0.18,"(11, 26)","(13, 24)",4,1,4,9,5,32,23,60
951,0.2,"(21, 29)","(19, 3)",2,161,162,325,2,139,116,257
952,0.14,"(23, 14)","(21, 24)",3,122,124,249,7,71,63,141
953,0.02,"(3, 28)","(11, 28)",8,16,23,47,6,21,16,43
954,0.06,"(2, 12)","(16, 9)",4,209,212,425,8,75,68,151
955,0.06,"(14, 1)","(1, 11)",5,129,133,267,8,119,102,229
956,0.02,"(26, 17)","(4, 8)",9,134,142,285,12,152,135,299
957,0.1,"(5, 24)","(23, 21)",5,101,105,211,9,71,69,149
958,0.12,"(18, 2)","(11, 24)",5,114,118,237,4,217,200,421
959,0.08,"(10, 0)","(18, 7)",7,49,55,111,4,76,67,147
960,0.16,"(20, 6)","(19, 28)",6,75,80,161,36,61,86,183
961,0.18,"(25, 28)","(27, 28)",4,25,28,57,5,218,163,386
962,0.06,"(18, 24)","(6, 13)",4,96,99,199,7,126,108,241
963,0.04,"(8, 17)","(24, 10)",16,259,274,549,10,68,52,130
964,0.18,"(12, 21)","(14, 14)",12,85,96,193,6,285,246,537
965,0.06,"(16, 3)","(28, 12)",8,193,200,401,12,80,69,161
966,0.16,"(13, 28)","(4, 6)",4,70,73,147,6,131,113,250
967,0.18,"(6, 29)","(24, 15)",9,28,36,73,3,61,52,116
968,0.1,"(22, 21)","(18, 25)",8,73,80,161,5,376,329,710
969,0.08,"(1, 17)","(0, 12)",9,21,29,59,5,57,41,103
970,0.04,"(18, 26)","(11, 11)",11,76,86,173,6,176,145,327
971,0.14,"(7, 20)","(20, 7)",7,257,263,527,6,56,49,111
972,0.2,"(20, 6)","(15, 27)",6,229,234,469,13,163,149,325
973,0.02,"(2, 9)","(12, 18)",7,302,308,617,17,153,148,318
974,0.12,"(22, 15)","(16, 12)",12,47,58,117,5,93,83,181
975,0.08,"(22, 4)","(18, 0)",8,42,49,99,10,457,407,874
976,0.16,"(17, 23)","(1, 7)",6,51,56,113,4,215,192,411
977,0.2,"(10, 28)","(29, 0)",7,201,207,415,3,210,180,393
978,0.02,"(9, 15)","(11, 5)",9,53,61,123,9,405,365,779
979,0.18,"(14, 23)","(16, 9)",4,129,132,265,16,149,132,297
980,0.12,"(8, 27)","(9, 12)",3,155,157,315,4,117,99,220
981,0.02,"(10, 7)","(9, 25)",6,96,101,203,9,544,503,1056
982,0.1,"(5, 4)","(1, 25)",6,57,62,125,11,230,215,456
983,0.02,"(5, 19)","(13, 10)",7,158,164,329,8,96,90,194
984,0.08,"(19, 16)","(0, 17)",10,178,187,375,6,293,276,575
985,0.04,"(20, 26)","(24, 18)",7,117,123,247,7,299,273,579
986,0.04,"(16, 14)","(17, 10)",5,59,63,127,4,46,37,87
987,0.06,"(11, 25)","(19, 4)",7,361,367,735,17,182,145,344
988,0.06,"(24, 8)","(11, 26)",32,81,112,225,8,84,71,163
989,0.06,"(4, 15)","(3, 24)",8,77,84,169,6,77,66,149
990,0.18,"(17, 3)","(4, 16)",15,174,188,377,20,114,119,253
991,0.02,"(28, 22)","(16, 0)",6,621,626,1253,7,186,177,370
992,0.2,"(8, 5)","(29, 20)",13,130,142,285,25,77,90,192
993,0.2,"(21, 5)","(20, 18)",7,47,53,107,8,58,49,115
994,0.16,"(24, 3)","(15, 10)",4,62,65,131,5,32,22,59
995,0.18,"(9, 21)","(6, 13)",12,106,117,235,14,176,164,354
996,0.04,"(27, 6)","(18, 8)",4,101,104,209,11,170,156,337
997,0.04,"(1, 5)","(13, 29)",7,170,176,353,4,252,239,495
998,0.1,"(5, 15)","(9, 16)",24,125,148,297,21,41,49,111
999,0.04,"(28, 6)","(20, 0)",6,108,113,227,4,233,199,436
