test,alpha,bot_pos,rat_pos,neighbor_sensings_1,ping_tries_1,moves_1,total_actions_1,neighbor_sensings_2,ping_tries_2,moves_2,total_actions_2
0,0.08,"(22, 0)","(12, 24)",5,95,99,199,5,111,83,199
1,0.04,"(16, 8)","(5, 14)",4,82,85,171,4,96,68,168
2,0.14,"(0, 12)","(21, 15)",12,76,87,175,16,111,105,232
3,0.18,"(11, 11)","(22, 28)",7,58,64,129,5,141,129,275
4,0.08,"(3, 21)","(12, 25)",19,89,107,215,11,96,88,195
5,0.08,"(16, 14)","(9, 4)",12,127,138,277,5,121,102,228
6,0.1,"(3, 10)","(29, 0)",5,88,92,185,6,161,141,308
7,0.14,"(6, 20)","(6, 8)",3,83,85,171,7,66,61,134
8,0.02,"(6, 17)","(18, 14)",8,174,181,363,5,176,155,336
9,0.12,"(27, 20)","(27, 28)",20,58,77,155,10,51,43,104
10,0.2,"(27, 9)","(16, 22)",5,93,97,195,3,96,79,178
11,0.04,"(24, 10)","(27, 11)",5,61,65,131,6,76,46,128
12,0.2,"(25, 11)","(18, 15)",21,82,102,205,19,31,34,84
13,0.08,"(9, 2)","(4, 26)",11,72,82,165,9,96,89,194
14,0.16,"(8, 29)","(2, 7)",4,150,153,307,6,96,83,185
15,0.02,"(23, 2)","(24, 17)",6,117,122,245,14,76,61,151
16,0.12,"(27, 16)","(23, 20)",16,45,60,121,6,66,44,116
17,0.02,"(25, 24)","(21, 15)",5,127,131,263,6,106,66,178
18,0.08,"(1, 13)","(28, 10)",7,164,170,341,8,96,81,185
19,0.06,"(29, 3)","(10, 9)",5,89,93,187,4,131,94,229
20,0.2,"(7, 20)","(9, 18)",23,40,62,125,10,36,31,77
21,0.04,"(20, 10)","(7, 4)",10,90,99,199,7,91,73,171
22,0.16,"(2, 2)","(16, 25)",4,78,81,163,6,81,62,149
23,0.14,"(25, 16)","(28, 20)",7,149,155,311,6,111,89,206
24,0.08,"(22, 20)","(0, 6)",5,69,73,147,12,136,121,269
25,0.2,"(6, 9)","(14, 11)",4,82,85,171,6,46,39,91
26,0.02,"(11, 5)","(26, 17)",7,144,150,301,10,96,84,190
27,0.16,"(10, 0)","(5, 8)",2,126,127,255,6,101,81,188
28,0.18,"(25, 20)","(13, 22)",12,108,119,239,6,81,57,144
29,0.2,"(19, 4)","(1, 16)",23,65,87,175,17,86,86,189
30,0.02,"(1, 4)","(13, 2)",16,143,158,317,9,126,85,220
31,0.08,"(28, 17)","(14, 29)",5,102,106,213,4,226,206,436
32,0.14,"(22, 19)","(27, 18)",5,32,36,73,6,36,19,61
33,0.2,"(7, 20)","(12, 17)",6,8,13,27,4,36,25,65
34,0.04,"(24, 22)","(19, 29)",6,100,105,211,9,251,227,487
35,0.1,"(26, 25)","(18, 27)",7,15,21,43,17,96,73,186
36,0.04,"(3, 14)","(24, 17)",8,69,76,153,9,66,56,131
37,0.1,"(16, 19)","(2, 5)",2,30,31,63,3,146,126,275
38,0.18,"(0, 19)","(16, 18)",3,162,164,329,5,86,74,165
39,0.06,"(15, 27)","(21, 28)",3,138,140,281,9,146,136,291
40,0.2,"(5, 15)","(1, 1)",20,151,170,341,17,126,114,257
41,0.18,"(22, 6)","(16, 13)",6,13,18,37,4,76,66,146
42,0.06,"(10, 0)","(24, 9)",3,124,126,253,17,106,99,222
43,0.04,"(17, 17)","(7, 14)",16,102,117,235,9,86,60,155
44,0.1,"(12, 8)","(22, 10)",11,108,118,237,16,121,113,250
45,0.14,"(24, 27)","(1, 22)",10,111,120,241,5,91,80,176
46,0.02,"(16, 0)","(19, 26)",6,202,207,415,3,151,113,267
47,0.12,"(11, 4)","(22, 14)",7,68,74,149,12,61,58,131
48,0.06,"(5, 26)","(2, 25)",7,82,88,177,6,61,33,100
49,0.18,"(29, 14)","(4, 29)",15,61,75,151,14,166,165,345
50,0.06,"(26, 23)","(22, 25)",4,109,112,225,7,81,64,152
51,0.16,"(6, 14)","(24, 15)",14,109,122,245,7,101,85,193
52,0.14,"(26, 15)","(2, 29)",5,128,132,265,6,116,102,224
53,0.12,"(3, 3)","(12, 28)",5,76,80,161,10,141,122,273
54,0.1,"(19, 17)","(1, 21)",9,85,93,187,8,161,143,312
55,0.14,"(3, 28)","(11, 22)",6,115,120,241,3,61,46,110
56,0.12,"(0, 9)","(2, 10)",6,6,11,23,10,61,53,124
57,0.18,"(18, 4)","(2, 9)",4,99,102,205,7,76,55,138
58,0.08,"(23, 2)","(22, 17)",15,139,153,307,8,56,53,117
59,0.18,"(8, 7)","(16, 5)",5,127,131,263,9,101,89,199
60,0.2,"(15, 29)","(19, 5)",7,112,118,237,17,136,128,281
61,0.16,"(7, 25)","(26, 29)",8,134,141,283,13,86,78,177
62,0.06,"(13, 20)","(14, 1)",4,61,64,129,4,116,96,216
63,0.08,"(22, 14)","(21, 23)",14,95,108,217,4,56,43,103
64,0.06,"(0, 17)","(10, 19)",10,41,50,101,4,121,74,199
65,0.1,"(1, 19)","(29, 23)",9,118,126,253,14,136,120,270
66,0.02,"(22, 7)","(12, 23)",3,85,87,175,5,201,173,379
67,0.1,"(17, 2)","(0, 1)",4,89,92,185,10,101,87,198
68,0.08,"(12, 12)","(13, 28)",8,50,57,115,5,116,106,227
69,0.06,"(12, 0)","(16, 13)",7,99,105,211,4,106,78,188
70,0.06,"(14, 7)","(0, 9)",8,56,63,127,7,71,63,141
71,0.06,"(9, 24)","(15, 4)",10,81,90,181,3,151,113,267
72,0.14,"(25, 10)","(26, 27)",8,195,202,405,14,136,130,280
73,0.02,"(8, 10)","(20, 3)",5,104,108,217,6,116,90,212
74,0.16,"(2, 19)","(9, 18)",8,92,99,199,14,46,43,103
75,0.16,"(22, 27)","(16, 22)",5,95,99,199,7,61,33,101
76,0.06,"(25, 3)","(17, 18)",5,113,117,235,13,106,93,212
77,0.1,"(29, 14)","(0, 24)",5,107,111,223,4,91,79,174
78,0.1,"(14, 13)","(22, 11)",4,157,160,321,9,41,35,85
79,0.06,"(23, 27)","(0, 15)",13,125,137,275,6,101,82,189
80,0.14,"(23, 16)","(8, 23)",4,85,88,177,4,106,82,192
81,0.18,"(9, 29)","(20, 18)",6,131,136,273,4,56,40,100
82,0.02,"(1, 26)","(10, 13)",26,78,103,207,10,226,168,404
83,0.08,"(5, 26)","(18, 7)",6,86,91,183,14,56,55,125
84,0.1,"(5, 14)","(9, 29)",9,184,192,385,8,86,71,165
85,0.04,"(3, 0)","(6, 13)",5,55,59,119,8,76,66,150
86,0.02,"(15, 28)","(2, 12)",4,103,106,213,11,106,69,186
87,0.12,"(4, 2)","(5, 22)",3,119,121,243,4,81,71,156
88,0.12,"(27, 16)","(13, 10)",3,76,78,157,4,81,65,150
89,0.14,"(10, 4)","(18, 11)",6,76,81,163,8,81,67,156
90,0.18,"(6, 17)","(6, 12)",5,85,89,179,6,56,49,111
91,0.18,"(12, 10)","(12, 17)",6,11,16,33,23,71,79,173
92,0.18,"(17, 8)","(23, 5)",10,43,52,105,13,91,79,183
93,0.08,"(12, 3)","(22, 6)",10,128,137,275,3,101,91,195
94,0.12,"(5, 1)","(23, 22)",3,78,80,161,4,81,69,154
95,0.08,"(23, 29)","(11, 27)",15,109,123,247,31,36,46,113
96,0.16,"(0, 17)","(1, 11)",9,118,126,253,3,36,16,55
97,0.16,"(13, 2)","(5, 23)",6,79,84,169,4,76,62,142
98,0.14,"(26, 29)","(13, 16)",7,26,32,65,7,36,32,75
99,0.06,"(16, 14)","(29, 12)",3,76,78,157,4,111,96,211
100,0.08,"(16, 28)","(13, 29)",6,3,8,17,5,26,17,48
101,0.04,"(29, 12)","(24, 2)",4,79,82,165,6,141,99,246
102,0.12,"(28, 3)","(19, 23)",5,124,128,257,15,191,186,392
103,0.02,"(20, 15)","(15, 8)",6,165,170,341,8,126,105,239
104,0.06,"(0, 28)","(5, 6)",3,27,29,59,3,51,33,87
105,0.18,"(26, 22)","(28, 4)",9,151,159,319,13,86,83,182
106,0.06,"(0, 8)","(15, 22)",17,32,48,97,31,126,132,289
107,0.16,"(17, 0)","(21, 6)",20,148,167,335,17,101,97,215
108,0.02,"(26, 1)","(12, 15)",4,147,150,301,4,141,83,228
109,0.12,"(11, 5)","(16, 24)",6,73,78,157,6,111,84,201
110,0.14,"(8, 9)","(21, 0)",8,162,169,339,4,101,90,195
111,0.02,"(22, 6)","(1, 24)",8,42,49,99,12,171,134,317
112,0.06,"(0, 11)","(7, 9)",3,111,113,227,8,71,53,132
113,0.06,"(10, 24)","(9, 1)",5,79,83,167,5,201,173,379
114,0.14,"(16, 8)","(17, 18)",8,65,72,145,11,106,99,216
115,0.12,"(19, 3)","(25, 9)",6,122,127,255,9,46,39,94
116,0.1,"(7, 26)","(11, 3)",5,75,79,159,9,96,82,187
117,0.18,"(24, 29)","(12, 20)",7,94,100,201,10,81,60,151
118,0.04,"(16, 8)","(4, 0)",3,103,105,211,2,71,57,130
119,0.06,"(24, 14)","(26, 7)",4,204,207,415,5,91,71,167
120,0.04,"(5, 10)","(0, 13)",9,74,82,165,19,51,43,113
121,0.06,"(5, 21)","(7, 23)",13,46,58,117,22,41,40,103
122,0.14,"(15, 8)","(20, 18)",7,72,78,157,10,71,59,140
123,0.04,"(16, 17)","(12, 19)",6,52,57,115,7,66,36,109
124,0.08,"(9, 1)","(17, 7)",8,44,51,103,8,111,82,201
125,0.04,"(12, 19)","(18, 4)",8,60,67,135,12,136,117,265
126,0.14,"(6, 14)","(26, 5)",9,54,62,125,6,91,77,174
127,0.16,"(26, 7)","(24, 9)",5,28,32,65,7,16,12,35
128,0.14,"(18, 7)","(17, 24)",31,81,111,223,14,141,142,297
129,0.06,"(10, 10)","(5, 10)",15,12,26,53,6,141,113,260
130,0.2,"(10, 7)","(8, 25)",6,135,140,281,9,136,112,257
131,0.04,"(20, 25)","(28, 23)",17,112,128,257,3,61,46,110
132,0.16,"(5, 9)","(12, 26)",11,96,106,213,5,71,58,134
133,0.16,"(6, 24)","(12, 6)",5,71,75,151,11,61,57,129
134,0.08,"(29, 8)","(17, 1)",6,143,148,297,7,86,64,157
135,0.16,"(17, 0)","(6, 17)",3,67,69,139,9,51,44,104
136,0.06,"(12, 22)","(7, 5)",9,76,84,169,5,86,70,161
137,0.2,"(18, 12)","(10, 0)",11,78,88,177,7,136,128,271
138,0.02,"(7, 0)","(25, 0)",34,144,177,355,5,141,100,246
139,0.16,"(11, 1)","(27, 23)",4,62,65,131,8,181,175,364
140,0.02,"(28, 20)","(2, 17)",10,66,75,151,6,136,97,239
141,0.2,"(17, 23)","(8, 11)",10,68,77,155,8,96,82,186
142,0.12,"(18, 25)","(14, 10)",7,163,169,339,6,106,81,193
143,0.18,"(28, 5)","(29, 2)",4,51,54,109,5,41,28,74
144,0.18,"(3, 12)","(14, 1)",16,122,137,275,6,141,132,279
145,0.02,"(4, 20)","(5, 4)",5,95,99,199,4,186,155,345
146,0.2,"(15, 0)","(20, 5)",15,94,108,217,6,61,49,116
147,0.02,"(1, 20)","(27, 0)",16,45,60,121,12,171,115,298
148,0.08,"(14, 24)","(1, 21)",6,122,127,255,7,76,51,134
149,0.2,"(10, 15)","(5, 27)",14,115,128,257,15,186,184,385
150,0.14,"(12, 18)","(28, 29)",14,101,114,229,7,86,79,172
151,0.18,"(14, 12)","(1, 11)",6,134,139,279,5,46,36,87
152,0.14,"(25, 15)","(22, 17)",3,7,9,19,16,21,22,59
153,0.14,"(7, 6)","(8, 0)",8,39,46,93,11,36,32,79
154,0.18,"(18, 23)","(20, 12)",5,72,76,153,14,66,68,148
155,0.16,"(26, 15)","(16, 9)",11,50,60,121,5,131,111,247
156,0.1,"(7, 26)","(15, 5)",9,90,98,197,9,86,78,173
157,0.2,"(15, 25)","(11, 8)",5,86,90,181,8,66,55,129
158,0.06,"(18, 19)","(26, 9)",6,77,82,165,12,106,100,218
159,0.12,"(12, 10)","(13, 27)",11,58,68,137,5,106,81,192
160,0.14,"(16, 10)","(18, 3)",9,12,20,41,7,66,43,116
161,0.1,"(14, 14)","(24, 12)",4,84,87,175,5,71,51,127
162,0.18,"(12, 19)","(6, 21)",9,45,53,107,5,51,34,90
163,0.1,"(10, 27)","(21, 27)",12,101,112,225,6,71,66,143
164,0.14,"(21, 13)","(14, 29)",14,105,118,237,22,76,83,181
165,0.02,"(2, 1)","(7, 22)",5,26,30,61,7,91,87,185
166,0.08,"(6, 18)","(12, 29)",8,91,98,197,5,91,73,169
167,0.14,"(22, 20)","(15, 3)",4,79,82,165,7,96,74,177
168,0.12,"(13, 0)","(10, 10)",9,91,99,199,5,96,72,173
169,0.08,"(17, 11)","(3, 17)",12,123,134,269,13,56,57,126
170,0.2,"(8, 29)","(8, 5)",4,92,95,191,2,76,66,144
171,0.12,"(5, 12)","(26, 2)",6,37,42,85,12,136,125,273
172,0.16,"(5, 21)","(3, 5)",3,91,93,187,9,91,82,182
173,0.08,"(1, 0)","(21, 1)",5,161,165,331,7,91,74,172
174,0.1,"(10, 1)","(5, 8)",8,181,188,377,4,76,44,124
175,0.1,"(6, 18)","(4, 11)",5,90,94,189,4,66,43,113
176,0.06,"(25, 9)","(13, 26)",12,116,127,255,16,171,165,352
177,0.2,"(20, 5)","(25, 14)",7,91,97,195,9,61,50,120
178,0.02,"(0, 14)","(9, 22)",13,161,173,347,6,186,159,351
179,0.14,"(13, 24)","(2, 6)",4,109,112,225,4,126,108,238
180,0.2,"(25, 23)","(1, 22)",5,82,86,173,7,201,184,392
181,0.18,"(13, 16)","(11, 19)",10,87,96,193,23,46,50,119
182,0.2,"(12, 18)","(24, 8)",8,71,78,157,4,86,67,157
183,0.12,"(1, 25)","(0, 3)",9,114,122,245,5,111,97,213
184,0.1,"(25, 19)","(17, 12)",4,128,131,263,5,76,46,127
185,0.06,"(1, 1)","(11, 8)",4,87,90,181,4,131,86,221
186,0.02,"(27, 11)","(10, 17)",6,102,107,215,8,146,113,267
187,0.16,"(7, 7)","(7, 0)",5,61,65,131,10,31,26,67
188,0.2,"(20, 6)","(18, 13)",14,68,81,163,5,101,87,193
189,0.2,"(22, 22)","(20, 14)",8,29,36,73,11,41,37,89
190,0.06,"(26, 13)","(27, 20)",5,63,67,135,10,111,101,222
191,0.08,"(9, 16)","(0, 4)",5,111,115,231,16,76,61,153
192,0.12,"(3, 21)","(7, 29)",3,124,126,253,7,71,59,137
193,0.1,"(29, 20)","(25, 18)",5,37,41,83,13,46,42,101
194,0.02,"(3, 2)","(19, 10)",9,107,115,231,8,196,134,338
195,0.14,"(3, 22)","(27, 25)",13,117,129,259,4,86,67,157
196,0.18,"(19, 16)","(26, 27)",12,129,140,281,9,126,114,249
197,0.12,"(18, 0)","(1, 10)",8,95,102,205,12,196,193,401
198,0.2,"(6, 19)","(24, 15)",8,161,168,337,2,76,63,141
199,0.1,"(6, 11)","(26, 18)",13,78,90,181,5,71,63,139
200,0.12,"(22, 25)","(21, 26)",7,2,8,17,6,16,7,29
201,0.1,"(3, 1)","(12, 7)",4,14,17,35,11,46,46,103
202,0.04,"(3, 6)","(0, 4)",7,26,32,65,5,16,8,29
203,0.06,"(9, 4)","(11, 10)",8,79,86,173,14,86,61,161
204,0.2,"(1, 26)","(29, 2)",6,62,67,135,6,131,126,263
205,0.1,"(29, 8)","(15, 3)",6,112,117,235,3,126,107,236
206,0.06,"(20, 4)","(5, 27)",4,64,67,135,12,156,126,294
207,0.18,"(17, 27)","(7, 18)",16,69,84,169,12,71,55,138
208,0.02,"(5, 25)","(16, 21)",3,119,121,243,8,96,64,168
209,0.18,"(13, 16)","(5, 21)",10,113,122,245,3,51,35,89
210,0.08,"(24, 19)","(8, 26)",6,79,84,169,6,76,54,136
211,0.1,"(14, 17)","(17, 9)",9,65,73,147,8,61,58,127
212,0.06,"(18, 1)","(24, 15)",8,188,195,391,7,146,139,292
213,0.02,"(1, 2)","(0, 2)",6,2,7,15,8,21,10,39
214,0.08,"(22, 4)","(17, 16)",13,77,89,179,7,31,27,65
215,0.02,"(6, 28)","(18, 29)",6,169,174,349,4,46,36,86
216,0.08,"(12, 24)","(11, 14)",5,106,110,221,5,81,64,150
217,0.12,"(13, 17)","(21, 24)",12,88,99,199,19,71,64,154
218,0.2,"(26, 24)","(26, 8)",10,91,100,201,16,51,56,123
219,0.1,"(10, 6)","(1, 16)",13,95,107,215,10,56,51,117
220,0.06,"(24, 1)","(27, 24)",7,120,126,253,5,111,89,205
221,0.06,"(29, 24)","(23, 15)",7,64,70,141,6,191,156,353
222,0.14,"(7, 6)","(21, 1)",10,89,98,197,6,91,78,175
223,0.06,"(13, 9)","(23, 16)",6,83,88,177,4,66,41,111
224,0.02,"(0, 0)","(7, 18)",9,97,105,211,29,156,139,324
225,0.14,"(8, 3)","(14, 8)",13,107,119,239,3,56,40,99
226,0.04,"(13, 7)","(25, 22)",15,162,176,353,11,116,98,225
227,0.16,"(28, 9)","(12, 18)",4,82,85,171,4,81,61,146
228,0.1,"(11, 2)","(29, 28)",4,103,106,213,4,106,88,198
229,0.16,"(13, 23)","(17, 1)",10,86,95,191,6,66,49,121
230,0.02,"(17, 2)","(4, 22)",9,39,47,95,10,121,101,232
231,0.08,"(16, 24)","(1, 21)",7,70,76,153,16,86,70,172
232,0.04,"(7, 2)","(22, 29)",7,60,66,133,6,136,102,244
233,0.06,"(21, 12)","(16, 0)",12,144,155,311,5,126,114,245
234,0.04,"(25, 18)","(1, 28)",12,156,167,335,9,111,102,222
235,0.1,"(22, 17)","(21, 1)",5,118,122,245,5,116,106,227
236,0.12,"(12, 0)","(24, 26)",4,41,44,89,4,146,120,270
237,0.06,"(19, 29)","(23, 11)",9,81,89,179,18,81,72,171
238,0.18,"(18, 2)","(19, 4)",4,93,96,193,6,36,27,69
239,0.2,"(10, 11)","(13, 20)",6,13,18,37,8,66,57,131
240,0.04,"(20, 9)","(29, 2)",5,103,107,215,25,201,151,377
241,0.14,"(22, 24)","(11, 27)",5,91,95,191,4,76,50,130
242,0.04,"(27, 24)","(19, 24)",4,146,149,299,4,196,149,349
243,0.16,"(9, 28)","(10, 18)",3,24,26,53,2,51,29,82
244,0.2,"(1, 14)","(24, 22)",5,92,96,193,5,66,55,126
245,0.06,"(1, 21)","(22, 16)",10,101,110,221,4,91,61,156
246,0.18,"(18, 20)","(21, 23)",8,27,34,69,7,51,42,100
247,0.08,"(5, 5)","(3, 25)",5,89,93,187,8,126,115,249
248,0.14,"(4, 22)","(2, 19)",8,109,116,233,9,66,57,132
249,0.02,"(3, 21)","(20, 25)",27,107,133,267,5,181,156,342
250,0.14,"(1, 25)","(28, 0)",8,54,61,123,7,81,72,160
251,0.02,"(14, 4)","(29, 25)",5,158,162,325,13,151,130,294
252,0.04,"(4, 15)","(27, 23)",7,65,71,143,5,141,98,244
253,0.12,"(15, 14)","(2, 7)",17,60,76,153,4,71,56,131
254,0.16,"(0, 7)","(29, 14)",10,118,127,255,12,66,63,141
255,0.02,"(13, 23)","(16, 29)",4,134,137,275,8,116,93,217
256,0.2,"(22, 5)","(21, 25)",7,106,112,225,11,136,132,279
257,0.04,"(11, 9)","(15, 22)",26,83,108,217,12,131,110,253
258,0.18,"(15, 7)","(7, 13)",13,77,89,179,10,91,74,175
259,0.16,"(18, 1)","(19, 17)",6,153,158,317,6,96,78,180
260,0.06,"(27, 19)","(28, 7)",10,136,145,291,5,86,63,154
261,0.04,"(5, 10)","(2, 27)",19,86,104,209,7,71,56,134
262,0.1,"(0, 22)","(28, 4)",9,61,69,139,7,161,140,308
263,0.06,"(12, 28)","(14, 11)",9,139,147,295,10,196,167,373
264,0.14,"(28, 6)","(28, 11)",4,119,122,245,11,156,155,322
265,0.12,"(12, 19)","(3, 29)",8,78,85,171,5,71,51,127
266,0.02,"(4, 28)","(10, 15)",6,85,90,181,5,291,186,482
267,0.2,"(19, 3)","(15, 11)",15,13,27,55,9,86,76,171
268,0.18,"(23, 19)","(19, 23)",6,28,33,67,6,46,26,78
269,0.06,"(21, 29)","(10, 11)",3,95,97,195,5,111,78,194
270,0.1,"(20, 29)","(9, 19)",17,85,101,203,3,56,41,100
271,0.14,"(6, 26)","(0, 1)",10,145,154,309,12,136,127,275
272,0.14,"(21, 13)","(27, 27)",8,65,72,145,8,136,118,262
273,0.2,"(8, 7)","(29, 1)",3,135,137,275,4,196,187,387
274,0.04,"(2, 28)","(2, 8)",5,117,121,243,11,56,51,118
275,0.2,"(16, 6)","(16, 17)",7,113,119,239,6,91,74,171
276,0.06,"(13, 13)","(17, 4)",5,160,164,329,23,81,74,178
277,0.04,"(4, 16)","(11, 24)",5,114,118,237,2,81,45,128
278,0.12,"(16, 4)","(18, 24)",5,114,118,237,6,86,68,160
279,0.02,"(16, 2)","(17, 23)",7,84,90,181,8,221,159,388
280,0.14,"(19, 7)","(27, 6)",14,61,74,149,8,61,54,123
281,0.2,"(22, 1)","(3, 23)",5,61,65,131,3,271,256,530
282,0.18,"(17, 26)","(27, 22)",9,162,170,341,4,76,65,145
283,0.2,"(10, 6)","(13, 2)",12,19,30,61,9,46,30,85
284,0.12,"(28, 15)","(7, 21)",36,84,119,239,7,86,70,163
285,0.18,"(15, 26)","(26, 16)",6,130,135,271,8,101,94,203
286,0.18,"(26, 27)","(20, 12)",13,102,114,229,7,66,52,125
287,0.1,"(12, 29)","(6, 2)",5,99,103,207,6,101,75,182
288,0.12,"(14, 25)","(13, 21)",12,98,109,219,11,141,132,284
289,0.16,"(5, 7)","(21, 18)",8,110,117,235,9,131,109,249
290,0.14,"(0, 25)","(2, 6)",9,130,138,277,5,86,79,170
291,0.16,"(3, 11)","(23, 6)",5,109,113,227,6,156,131,293
292,0.2,"(13, 11)","(9, 11)",5,88,92,185,23,46,53,122
293,0.12,"(13, 0)","(2, 17)",2,159,160,321,2,186,160,348
294,0.04,"(20, 6)","(5, 13)",14,53,66,133,7,106,80,193
295,0.08,"(7, 7)","(28, 8)",4,142,145,291,3,81,70,154
296,0.14,"(25, 27)","(15, 14)",4,116,119,239,7,51,38,96
297,0.2,"(22, 3)","(14, 29)",6,94,99,199,6,116,90,212
298,0.04,"(14, 8)","(16, 9)",9,38,46,93,10,41,30,81
299,0.2,"(9, 11)","(13, 7)",18,91,108,217,15,101,96,212
300,0.1,"(20, 27)","(26, 17)",11,118,128,257,8,101,90,199
301,0.04,"(24, 19)","(6, 29)",6,179,184,369,6,171,137,314
302,0.08,"(1, 0)","(10, 16)",15,28,42,85,8,91,78,177
303,0.08,"(9, 10)","(28, 15)",8,118,125,251,18,161,145,324
304,0.02,"(14, 3)","(26, 13)",6,91,96,193,4,121,92,217
305,0.14,"(12, 2)","(6, 0)",5,21,25,51,6,71,61,138
306,0.2,"(21, 13)","(11, 29)",6,59,64,129,22,116,125,263
307,0.06,"(19, 22)","(13, 2)",5,149,153,307,7,66,54,127
308,0.02,"(18, 3)","(14, 5)",8,67,74,149,7,26,15,48
309,0.18,"(2, 12)","(14, 8)",9,109,117,235,12,81,65,158
310,0.12,"(26, 16)","(27, 4)",5,136,140,281,5,51,40,96
311,0.14,"(11, 19)","(24, 0)",8,34,41,83,9,146,139,294
312,0.16,"(4, 4)","(28, 16)",9,82,90,181,22,206,212,440
313,0.16,"(19, 24)","(7, 12)",4,94,97,195,6,81,68,155
314,0.02,"(26, 29)","(5, 7)",28,189,216,433,6,66,58,130
315,0.06,"(1, 24)","(29, 4)",5,63,67,135,11,151,145,307
316,0.1,"(14, 5)","(5, 11)",8,104,111,223,4,36,29,69
317,0.18,"(8, 14)","(26, 20)",5,109,113,227,5,71,58,134
318,0.2,"(12, 20)","(15, 3)",12,58,69,139,13,116,109,238
319,0.06,"(11, 0)","(23, 22)",10,60,69,139,28,126,124,278
320,0.12,"(17, 28)","(29, 8)",7,113,119,239,4,116,99,219
321,0.16,"(4, 0)","(20, 5)",13,154,166,333,3,91,69,163
322,0.18,"(21, 9)","(14, 17)",4,138,141,283,7,76,65,148
323,0.14,"(1, 7)","(27, 12)",5,82,86,173,6,121,108,235
324,0.1,"(19, 7)","(15, 17)",21,93,113,227,7,81,62,150
325,0.06,"(15, 26)","(10, 5)",8,120,127,255,10,71,69,150
326,0.1,"(29, 11)","(18, 28)",11,135,145,291,6,106,82,194
327,0.12,"(25, 4)","(6, 20)",8,101,108,217,7,71,61,139
328,0.1,"(11, 6)","(10, 14)",13,100,112,225,7,86,58,151
329,0.18,"(5, 27)","(12, 23)",11,102,112,225,6,46,38,90
330,0.04,"(10, 17)","(12, 8)",5,48,52,105,3,51,26,80
331,0.06,"(22, 8)","(1, 7)",11,68,78,157,5,126,113,244
332,0.08,"(6, 23)","(3, 4)",10,149,158,317,11,101,89,201
333,0.02,"(4, 5)","(4, 2)",21,88,108,217,9,96,58,163
334,0.02,"(7, 8)","(17, 9)",9,162,170,341,39,81,94,214
335,0.02,"(25, 27)","(26, 25)",10,30,39,79,4,51,33,88
336,0.1,"(2, 4)","(22, 4)",14,141,154,309,12,126,111,249
337,0.16,"(21, 29)","(20, 27)",6,2,7,15,12,46,34,92
338,0.18,"(28, 15)","(4, 10)",9,153,161,323,46,86,110,242
339,0.18,"(8, 22)","(23, 7)",10,57,66,133,9,136,132,277
340,0.18,"(7, 11)","(27, 11)",2,186,187,375,7,96,85,188
341,0.06,"(26, 9)","(21, 10)",8,91,98,197,5,56,41,102
342,0.2,"(21, 15)","(0, 20)",12,50,61,123,4,46,34,84
343,0.18,"(27, 12)","(2, 19)",16,76,91,183,3,61,47,111
344,0.16,"(2, 25)","(13, 27)",9,175,183,367,9,101,88,198
345,0.08,"(6, 26)","(11, 1)",6,101,106,213,5,136,116,257
346,0.18,"(19, 8)","(27, 22)",9,95,103,207,6,186,163,355
347,0.1,"(22, 23)","(14, 6)",4,69,72,145,5,76,48,129
348,0.14,"(26, 4)","(10, 7)",7,119,125,251,7,61,39,107
349,0.08,"(3, 11)","(5, 21)",5,42,46,93,5,46,23,74
350,0.02,"(20, 5)","(4, 21)",6,77,82,165,5,191,170,366
351,0.1,"(22, 4)","(29, 18)",10,102,111,223,10,126,107,243
352,0.16,"(2, 17)","(10, 28)",5,121,125,251,3,86,69,158
353,0.04,"(1, 23)","(2, 1)",13,139,151,303,13,91,88,192
354,0.08,"(5, 26)","(10, 29)",7,122,128,257,4,51,43,98
355,0.14,"(7, 28)","(21, 2)",14,64,77,155,4,86,68,158
356,0.2,"(4, 19)","(0, 25)",13,104,116,233,7,176,172,355
357,0.18,"(26, 3)","(8, 25)",5,66,70,141,3,81,57,141
358,0.2,"(6, 2)","(20, 1)",5,156,160,321,10,131,118,259
359,0.08,"(23, 4)","(2, 6)",4,98,101,203,3,136,92,231
360,0.08,"(22, 0)","(19, 10)",14,99,112,225,11,106,81,198
361,0.1,"(29, 4)","(8, 25)",8,41,48,97,11,191,170,372
362,0.08,"(3, 19)","(16, 17)",13,85,97,195,10,101,86,197
363,0.1,"(28, 12)","(8, 7)",6,101,106,213,7,131,116,254
364,0.14,"(21, 16)","(29, 23)",8,130,137,275,4,71,55,130
365,0.06,"(26, 27)","(0, 23)",6,131,136,273,3,96,88,187
366,0.2,"(2, 13)","(8, 21)",13,83,95,191,8,96,82,186
367,0.18,"(6, 23)","(20, 24)",6,126,131,263,10,76,71,157
368,0.02,"(28, 0)","(6, 16)",5,141,145,291,3,91,61,155
369,0.08,"(17, 8)","(21, 16)",4,174,177,355,10,81,77,168
370,0.02,"(6, 25)","(22, 12)",4,145,148,297,4,121,108,233
371,0.06,"(7, 10)","(6, 22)",3,91,93,187,3,101,73,177
372,0.04,"(14, 4)","(8, 16)",8,23,30,61,7,111,87,205
373,0.18,"(15, 3)","(23, 23)",6,91,96,193,8,76,67,151
374,0.2,"(8, 6)","(10, 7)",12,113,124,249,8,21,14,43
375,0.04,"(20, 11)","(29, 29)",17,81,97,195,5,101,78,184
376,0.04,"(23, 17)","(11, 5)",7,113,119,239,6,96,63,165
377,0.06,"(17, 10)","(12, 18)",9,107,115,231,13,151,131,295
378,0.12,"(22, 22)","(28, 18)",6,25,30,61,17,86,92,195
379,0.18,"(9, 22)","(14, 4)",3,85,87,175,3,91,71,165
380,0.2,"(2, 11)","(25, 0)",4,95,98,197,3,111,96,210
381,0.16,"(17, 2)","(6, 16)",4,69,72,145,21,86,92,199
382,0.14,"(8, 14)","(17, 4)",6,98,103,207,3,156,143,302
383,0.14,"(7, 21)","(4, 17)",8,131,138,277,6,41,34,81
384,0.1,"(9, 12)","(2, 15)",11,73,83,167,4,81,61,146
385,0.12,"(16, 19)","(4, 24)",5,108,112,225,10,46,41,97
386,0.04,"(18, 21)","(7, 27)",12,112,123,247,4,221,194,419
387,0.04,"(7, 27)","(19, 12)",3,48,50,101,5,121,86,212
388,0.18,"(19, 11)","(3, 14)",4,60,63,127,3,61,47,111
389,0.08,"(3, 18)","(25, 0)",5,42,46,93,8,91,73,172
390,0.02,"(16, 7)","(26, 7)",8,173,180,361,15,141,120,276
391,0.2,"(5, 27)","(3, 0)",4,143,146,293,4,201,188,393
392,0.08,"(29, 13)","(9, 11)",7,75,81,163,11,101,97,209
393,0.02,"(26, 10)","(5, 2)",33,175,207,415,18,156,130,304
394,0.06,"(13, 5)","(20, 22)",4,106,109,219,11,161,142,314
395,0.02,"(23, 12)","(16, 9)",9,17,25,51,6,26,21,53
396,0.14,"(21, 10)","(29, 20)",5,232,236,473,16,141,141,298
397,0.1,"(29, 7)","(23, 20)",10,182,191,383,14,101,84,199
398,0.02,"(17, 5)","(28, 1)",4,94,97,195,5,46,37,88
399,0.08,"(7, 16)","(8, 7)",11,92,102,205,14,91,78,183
400,0.12,"(21, 26)","(24, 22)",4,190,193,387,14,71,65,150
401,0.08,"(27, 12)","(3, 28)",7,40,46,93,3,71,59,133
402,0.2,"(10, 7)","(3, 3)",11,150,160,321,6,111,103,220
403,0.08,"(18, 19)","(10, 21)",26,185,210,421,7,106,89,202
404,0.14,"(20, 3)","(11, 28)",10,66,75,151,8,91,79,178
405,0.1,"(22, 9)","(1, 15)",5,63,67,135,7,86,63,156
406,0.06,"(2, 0)","(7, 29)",4,156,159,319,9,86,80,175
407,0.12,"(6, 12)","(17, 10)",5,113,117,235,6,71,54,131
408,0.14,"(17, 16)","(13, 16)",4,29,32,65,8,41,20,69
409,0.06,"(0, 6)","(12, 19)",7,91,97,195,24,121,119,264
410,0.2,"(21, 2)","(11, 5)",10,85,94,189,4,56,31,91
411,0.12,"(26, 1)","(8, 0)",6,107,112,225,7,66,56,129
412,0.1,"(27, 16)","(19, 20)",7,17,23,47,6,56,38,100
413,0.04,"(29, 20)","(9, 6)",8,36,43,87,14,71,70,155
414,0.1,"(18, 19)","(28, 19)",7,127,133,267,6,76,65,147
415,0.14,"(21, 6)","(19, 14)",3,99,101,203,9,81,62,152
416,0.06,"(20, 3)","(5, 4)",3,122,124,249,5,161,145,311
417,0.12,"(19, 12)","(3, 29)",7,39,45,91,4,76,61,141
418,0.12,"(12, 14)","(5, 8)",3,117,119,239,3,51,39,93
419,0.1,"(28, 25)","(7, 9)",12,38,49,99,4,66,44,114
420,0.08,"(22, 0)","(7, 19)",5,33,37,75,11,101,94,206
421,0.12,"(13, 17)","(27, 27)",5,128,132,265,6,156,143,305
422,0.14,"(22, 4)","(2, 27)",13,79,91,183,9,101,76,186
423,0.18,"(29, 24)","(10, 24)",5,109,113,227,3,56,47,106
424,0.08,"(14, 28)","(13, 20)",9,35,43,87,5,91,74,170
425,0.06,"(25, 7)","(15, 14)",21,108,128,257,7,66,49,122
426,0.12,"(7, 5)","(7, 29)",6,98,103,207,7,116,105,228
427,0.06,"(1, 9)","(1, 23)",6,105,110,221,8,71,57,136
428,0.06,"(2, 17)","(17, 21)",6,190,195,391,6,126,94,226
429,0.08,"(3, 27)","(21, 1)",3,72,74,149,5,81,65,151
430,0.18,"(8, 11)","(9, 25)",7,115,121,243,6,86,76,168
431,0.18,"(22, 16)","(25, 19)",6,93,98,197,10,76,62,148
432,0.18,"(17, 22)","(26, 29)",38,203,240,481,20,111,110,241
433,0.1,"(6, 11)","(5, 5)",6,10,15,31,15,106,90,211
434,0.16,"(8, 1)","(21, 17)",3,34,36,73,10,86,81,177
435,0.06,"(14, 26)","(5, 24)",7,96,102,205,5,76,68,149
436,0.2,"(11, 26)","(3, 17)",7,103,109,219,3,136,120,259
437,0.04,"(28, 11)","(2, 6)",7,130,136,273,4,151,126,281
438,0.1,"(3, 15)","(13, 25)",12,66,77,155,9,41,39,89
439,0.2,"(7, 25)","(9, 4)",14,97,110,221,6,116,103,225
440,0.04,"(21, 19)","(24, 0)",4,75,78,157,6,126,96,228
441,0.1,"(23, 25)","(23, 9)",4,145,148,297,9,46,37,92
442,0.1,"(5, 14)","(3, 3)",8,145,152,305,8,111,91,210
443,0.18,"(15, 28)","(9, 19)",6,83,88,177,7,51,39,97
444,0.06,"(24, 2)","(7, 12)",8,85,92,185,20,146,124,290
445,0.12,"(29, 17)","(1, 22)",8,83,90,181,6,166,140,312
446,0.06,"(5, 7)","(5, 11)",3,37,39,79,6,66,40,112
447,0.08,"(17, 19)","(7, 15)",7,36,42,85,8,91,69,168
448,0.14,"(0, 22)","(6, 8)",5,117,121,243,7,91,72,170
449,0.18,"(29, 21)","(7, 9)",7,45,51,103,9,91,81,181
450,0.16,"(12, 5)","(3, 20)",5,104,108,217,10,86,77,173
451,0.02,"(10, 10)","(20, 27)",6,30,35,71,9,171,136,316
452,0.08,"(19, 9)","(7, 17)",7,61,67,135,11,51,46,108
453,0.02,"(14, 28)","(28, 9)",14,183,196,393,35,76,79,190
454,0.02,"(5, 15)","(12, 16)",11,83,93,187,9,81,46,136
455,0.1,"(7, 16)","(17, 17)",6,101,106,213,3,86,77,166
456,0.14,"(7, 27)","(16, 5)",3,66,68,137,4,66,49,119
457,0.1,"(1, 17)","(8, 13)",5,60,64,129,4,36,27,67
458,0.18,"(1, 20)","(4, 29)",5,118,122,245,5,71,54,130
459,0.16,"(9, 9)","(12, 15)",10,101,110,221,9,101,91,201
460,0.1,"(14, 15)","(3, 19)",4,61,64,129,8,126,115,249
461,0.18,"(21, 12)","(13, 17)",8,71,78,157,7,71,61,139
462,0.2,"(10, 13)","(24, 11)",5,161,165,331,15,131,122,268
463,0.18,"(28, 4)","(7, 22)",4,68,71,143,4,101,81,186
464,0.08,"(19, 22)","(2, 4)",7,62,68,137,21,111,117,249
465,0.14,"(8, 19)","(9, 26)",10,37,46,93,8,96,85,189
466,0.02,"(10, 29)","(17, 7)",13,259,271,543,5,171,160,336
467,0.12,"(14, 3)","(18, 0)",17,27,43,87,5,91,79,175
468,0.12,"(13, 8)","(8, 14)",9,99,107,215,7,56,38,101
469,0.2,"(17, 14)","(25, 25)",5,84,88,177,9,136,124,269
470,0.16,"(22, 23)","(29, 25)",9,112,120,241,7,61,47,115
471,0.2,"(11, 21)","(7, 8)",10,121,130,261,13,106,100,219
472,0.14,"(27, 6)","(4, 20)",4,79,82,165,5,96,83,184
473,0.14,"(6, 29)","(2, 23)",8,113,120,241,6,61,46,113
474,0.14,"(9, 13)","(18, 2)",8,90,97,195,5,121,109,235
475,0.1,"(25, 5)","(25, 2)",7,14,20,41,4,46,29,79
476,0.14,"(14, 13)","(0, 0)",9,97,105,211,14,196,195,405
477,0.1,"(6, 7)","(29, 27)",6,77,82,165,4,136,119,259
478,0.2,"(8, 11)","(10, 27)",9,98,106,213,6,151,133,290
479,0.06,"(12, 22)","(5, 0)",7,171,177,355,16,131,125,272
480,0.1,"(6, 26)","(4, 25)",31,38,68,137,5,31,25,61
481,0.06,"(19, 7)","(12, 28)",9,95,103,207,6,136,116,258
482,0.06,"(17, 5)","(12, 28)",17,68,84,169,5,91,78,174
483,0.08,"(14, 26)","(25, 18)",25,139,163,327,17,76,71,164
484,0.18,"(22, 12)","(0, 3)",6,71,76,153,9,191,178,378
485,0.08,"(15, 3)","(11, 24)",6,101,106,213,12,151,136,299
486,0.06,"(24, 27)","(1, 8)",9,91,99,199,10,146,114,270
487,0.02,"(10, 0)","(23, 6)",4,93,96,193,5,81,71,157
488,0.08,"(10, 22)","(1, 22)",9,98,106,213,7,121,106,234
489,0.02,"(2, 11)","(29, 5)",15,143,157,315,5,186,170,361
490,0.1,"(0, 2)","(23, 20)",3,89,91,183,11,86,79,176
491,0.12,"(25, 21)","(24, 11)",3,125,127,255,11,126,108,245
492,0.12,"(16, 12)","(16, 3)",21,25,45,91,9,86,67,162
493,0.14,"(12, 9)","(8, 20)",9,100,108,217,3,66,43,112
494,0.1,"(11, 16)","(26, 10)",17,58,74,149,15,61,47,123
495,0.14,"(19, 27)","(19, 2)",10,97,106,213,8,91,79,178
496,0.04,"(10, 5)","(19, 11)",10,126,135,271,8,96,68,172
497,0.12,"(19, 16)","(23, 6)",8,120,127,255,9,91,72,172
498,0.1,"(0, 12)","(1, 13)",12,16,27,55,3,26,8,37
499,0.2,"(0, 4)","(8, 8)",12,94,105,211,4,46,25,75
500,0.06,"(16, 19)","(0, 12)",3,79,81,163,7,106,100,213
501,0.08,"(14, 25)","(17, 5)",13,98,110,221,4,111,102,217
502,0.16,"(23, 10)","(4, 7)",10,88,97,195,7,66,60,133
503,0.04,"(26, 12)","(25, 27)",3,105,107,215,7,61,52,120
504,0.06,"(20, 10)","(5, 7)",6,95,100,201,5,106,81,192
505,0.06,"(9, 29)","(4, 28)",12,63,74,149,8,56,27,91
506,0.12,"(0, 13)","(23, 5)",13,83,95,191,8,106,78,192
507,0.06,"(2, 28)","(3, 6)",3,140,142,285,2,106,73,181
508,0.16,"(25, 13)","(0, 13)",11,111,121,243,9,96,86,191
509,0.02,"(8, 2)","(13, 17)",4,293,296,593,19,81,63,163
510,0.2,"(16, 9)","(1, 10)",7,113,119,239,14,161,163,338
511,0.18,"(15, 26)","(11, 22)",15,8,22,45,5,51,42,98
512,0.14,"(0, 26)","(1, 1)",6,128,133,267,10,76,55,141
513,0.18,"(7, 21)","(2, 19)",3,121,123,247,8,61,49,118
514,0.2,"(29, 20)","(7, 29)",7,140,146,293,11,101,93,205
515,0.04,"(24, 0)","(27, 3)",14,26,39,79,8,51,28,87
516,0.12,"(1, 17)","(14, 13)",6,80,85,171,11,116,97,224
517,0.02,"(1, 27)","(16, 2)",4,199,202,405,7,206,176,389
518,0.08,"(23, 16)","(17, 19)",4,47,50,101,6,106,95,207
519,0.1,"(21, 4)","(10, 5)",4,71,74,149,7,91,73,171
520,0.02,"(8, 8)","(28, 15)",8,131,138,277,7,121,100,228
521,0.06,"(6, 5)","(20, 12)",5,110,114,229,2,151,113,266
522,0.02,"(0, 12)","(6, 2)",3,157,159,319,8,126,119,253
523,0.1,"(29, 28)","(29, 20)",9,154,162,325,11,46,37,94
524,0.1,"(4, 28)","(9, 5)",22,97,118,237,4,91,80,175
525,0.08,"(7, 29)","(10, 26)",5,9,13,27,6,31,20,57
526,0.08,"(26, 14)","(21, 27)",6,66,71,143,6,101,90,197
527,0.12,"(13, 12)","(10, 1)",14,117,130,261,9,56,41,106
528,0.1,"(29, 3)","(8, 27)",6,88,93,187,11,101,79,191
529,0.06,"(17, 13)","(1, 10)",7,64,70,141,8,71,55,134
530,0.18,"(2, 21)","(11, 18)",8,111,118,237,6,121,94,221
531,0.08,"(9, 1)","(10, 21)",27,176,202,405,3,176,155,334
532,0.1,"(12, 1)","(0, 17)",10,88,97,195,15,111,113,239
533,0.18,"(21, 25)","(7, 1)",11,57,67,135,4,101,82,187
534,0.16,"(9, 15)","(9, 27)",11,71,81,163,14,56,58,128
535,0.18,"(11, 12)","(27, 0)",20,128,147,295,6,206,199,411
536,0.14,"(18, 22)","(14, 12)",9,124,132,265,7,51,38,96
537,0.06,"(5, 14)","(14, 17)",8,97,104,209,8,51,44,103
538,0.02,"(7, 26)","(26, 17)",7,154,160,321,4,311,226,541
539,0.08,"(19, 11)","(11, 17)",10,67,76,153,4,56,32,92
540,0.1,"(28, 8)","(2, 27)",7,67,73,147,9,96,78,183
541,0.14,"(23, 22)","(26, 23)",4,81,84,169,12,31,24,67
542,0.14,"(6, 29)","(2, 29)",6,16,21,43,8,31,19,58
543,0.16,"(10, 12)","(6, 25)",7,148,154,309,7,81,65,153
544,0.06,"(20, 4)","(25, 22)",14,107,120,241,15,86,84,185
545,0.06,"(6, 1)","(12, 22)",7,78,84,169,12,111,87,210
546,0.08,"(19, 14)","(15, 17)",5,120,124,249,3,36,18,57
547,0.08,"(16, 1)","(5, 23)",19,90,108,217,5,146,128,279
548,0.18,"(22, 6)","(0, 12)",7,69,75,151,16,121,122,259
549,0.12,"(23, 2)","(7, 19)",8,108,115,231,11,141,114,266
550,0.08,"(26, 3)","(12, 16)",25,96,120,241,13,81,75,169
551,0.2,"(26, 22)","(16, 19)",10,141,150,301,6,46,41,93
552,0.04,"(23, 17)","(17, 8)",18,93,110,221,9,121,95,225
553,0.04,"(0, 22)","(16, 4)",7,106,112,225,11,116,92,219
554,0.08,"(14, 28)","(14, 19)",6,99,104,209,12,41,42,95
555,0.18,"(5, 13)","(8, 26)",11,118,128,257,7,81,68,156
556,0.1,"(27, 24)","(16, 7)",10,152,161,323,6,151,110,267
557,0.18,"(13, 17)","(17, 17)",7,67,73,147,5,56,41,102
558,0.08,"(28, 12)","(9, 16)",6,99,104,209,6,51,41,98
559,0.08,"(22, 11)","(17, 23)",8,87,94,189,9,76,62,147
560,0.2,"(19, 10)","(3, 24)",4,48,51,103,8,101,94,203
561,0.2,"(29, 2)","(25, 9)",3,104,106,213,3,41,23,67
562,0.02,"(19, 13)","(9, 6)",4,121,124,249,5,76,44,125
563,0.08,"(9, 0)","(23, 20)",7,105,111,223,23,171,162,356
564,0.2,"(4, 7)","(9, 20)",7,99,105,211,5,101,89,195
565,0.18,"(0, 3)","(29, 1)",7,160,166,333,14,226,218,458
566,0.16,"(20, 19)","(14, 14)",3,76,78,157,10,56,49,115
567,0.06,"(13, 9)","(4, 20)",9,84,92,185,12,126,115,253
568,0.06,"(13, 0)","(12, 22)",5,73,77,155,7,106,95,208
569,0.14,"(21, 22)","(2, 7)",5,36,40,81,5,56,45,106
570,0.06,"(16, 24)","(16, 27)",20,85,104,209,7,41,34,82
571,0.12,"(24, 26)","(15, 5)",4,102,105,211,6,86,81,173
572,0.06,"(12, 2)","(2, 9)",9,122,130,261,4,76,56,136
573,0.14,"(20, 3)","(26, 6)",14,68,81,163,8,61,49,118
574,0.14,"(4, 2)","(8, 11)",12,61,72,145,7,76,48,131
575,0.12,"(26, 6)","(6, 23)",8,34,41,83,8,101,82,191
576,0.12,"(22, 6)","(25, 9)",7,90,96,193,6,51,34,91
577,0.14,"(29, 20)","(9, 14)",8,70,77,155,6,91,82,179
578,0.18,"(7, 27)","(14, 15)",2,126,127,255,4,91,79,174
579,0.06,"(17, 14)","(6, 9)",5,91,95,191,6,171,137,314
580,0.18,"(8, 7)","(10, 13)",6,93,98,197,4,71,54,129
581,0.02,"(15, 21)","(2, 11)",4,134,137,275,4,201,149,354
582,0.14,"(15, 28)","(8, 21)",9,90,98,197,14,101,84,199
583,0.18,"(25, 24)","(26, 29)",4,8,11,23,13,41,33,87
584,0.14,"(2, 7)","(24, 0)",7,105,111,223,18,66,73,157
585,0.16,"(26, 29)","(2, 24)",7,139,145,291,9,136,122,267
586,0.12,"(22, 0)","(24, 26)",12,166,177,355,22,96,105,223
587,0.16,"(13, 9)","(5, 29)",4,183,186,373,9,126,117,252
588,0.14,"(4, 3)","(16, 12)",8,114,121,243,4,71,48,123
589,0.04,"(15, 0)","(14, 23)",3,83,85,171,10,106,91,207
590,0.1,"(13, 7)","(4, 7)",7,55,61,123,3,96,69,168
591,0.02,"(13, 2)","(25, 0)",7,83,89,179,6,196,139,341
592,0.2,"(0, 24)","(17, 18)",3,88,90,181,3,201,174,378
593,0.16,"(12, 6)","(21, 25)",5,71,75,151,6,126,109,241
594,0.1,"(5, 18)","(0, 21)",7,67,73,147,12,76,69,157
595,0.04,"(25, 15)","(23, 20)",5,149,153,307,11,131,100,242
596,0.08,"(8, 4)","(10, 24)",9,81,89,179,3,86,63,152
597,0.2,"(4, 14)","(19, 5)",7,61,67,135,12,56,51,119
598,0.06,"(0, 1)","(29, 4)",19,139,157,315,4,76,63,143
599,0.2,"(6, 0)","(2, 3)",3,165,167,335,3,36,15,54
600,0.18,"(29, 2)","(16, 15)",8,110,117,235,5,61,53,119
601,0.18,"(21, 17)","(22, 17)",5,14,18,37,8,26,17,51
602,0.02,"(21, 10)","(11, 3)",15,154,168,337,9,91,71,171
603,0.16,"(15, 1)","(16, 7)",4,14,17,35,4,36,23,63
604,0.14,"(11, 0)","(29, 13)",4,186,189,379,6,101,91,198
605,0.16,"(13, 24)","(11, 2)",6,110,115,231,4,96,89,189
606,0.14,"(27, 26)","(25, 3)",5,92,96,193,11,116,103,230
607,0.04,"(7, 23)","(18, 15)",6,115,120,241,7,126,93,226
608,0.04,"(2, 3)","(19, 10)",9,124,132,265,13,91,82,186
609,0.06,"(9, 18)","(2, 18)",6,141,146,293,5,106,83,194
610,0.2,"(10, 2)","(6, 23)",7,98,104,209,10,71,67,148
611,0.04,"(24, 10)","(14, 25)",6,67,72,145,7,86,71,164
612,0.08,"(25, 18)","(11, 18)",9,67,75,151,8,111,86,205
613,0.18,"(7, 9)","(20, 7)",9,57,65,131,11,91,85,187
614,0.14,"(13, 7)","(18, 18)",6,35,40,81,6,76,64,146
615,0.12,"(12, 22)","(11, 24)",10,94,103,207,4,41,26,71
616,0.18,"(21, 0)","(4, 7)",12,156,167,335,11,86,66,163
617,0.18,"(16, 4)","(24, 29)",18,113,130,261,13,66,66,145
618,0.08,"(21, 20)","(10, 4)",6,34,39,79,9,106,93,208
619,0.1,"(1, 17)","(19, 20)",8,83,90,181,15,101,96,212
620,0.06,"(1, 4)","(4, 18)",17,94,110,221,6,96,76,178
621,0.02,"(14, 27)","(18, 4)",6,81,86,173,9,111,96,216
622,0.18,"(15, 25)","(13, 20)",13,73,85,171,6,31,18,55
623,0.16,"(25, 25)","(19, 16)",6,18,23,47,5,86,70,161
624,0.18,"(9, 27)","(11, 5)",4,79,82,165,8,121,118,247
625,0.14,"(17, 24)","(20, 26)",8,32,39,79,8,71,49,128
626,0.16,"(2, 3)","(6, 1)",14,184,197,395,6,91,84,181
627,0.02,"(12, 16)","(28, 1)",10,127,136,273,5,141,123,269
628,0.06,"(13, 25)","(29, 13)",6,96,101,203,16,121,94,231
629,0.1,"(19, 13)","(7, 28)",5,181,185,371,14,106,101,221
630,0.12,"(21, 10)","(29, 15)",6,111,116,233,26,151,166,343
631,0.2,"(6, 23)","(17, 20)",8,104,111,223,8,81,75,164
632,0.04,"(24, 6)","(29, 18)",5,206,210,421,4,146,131,281
633,0.12,"(6, 21)","(6, 19)",4,6,9,19,6,46,36,88
634,0.12,"(29, 20)","(7, 19)",3,80,82,165,13,86,73,172
635,0.2,"(3, 5)","(28, 12)",8,120,127,255,5,71,57,133
636,0.02,"(22, 6)","(20, 26)",3,65,67,135,4,166,150,320
637,0.04,"(24, 10)","(26, 2)",8,158,165,331,13,106,91,210
638,0.2,"(17, 20)","(7, 5)",31,75,105,211,6,96,87,189
639,0.08,"(29, 26)","(7, 9)",5,71,75,151,7,76,61,144
640,0.14,"(26, 16)","(18, 22)",8,128,135,271,5,86,71,162
641,0.1,"(2, 5)","(10, 1)",10,104,113,227,6,31,26,63
642,0.2,"(23, 18)","(2, 7)",12,55,66,133,10,126,121,257
643,0.1,"(27, 8)","(12, 2)",3,93,95,191,15,86,72,173
644,0.14,"(3, 23)","(9, 26)",6,111,116,233,5,96,87,188
645,0.06,"(7, 29)","(29, 16)",6,108,113,227,15,106,106,227
646,0.04,"(11, 3)","(26, 21)",6,236,241,483,6,91,69,166
647,0.04,"(14, 16)","(2, 5)",12,93,104,209,8,136,109,253
648,0.1,"(16, 21)","(29, 25)",19,104,122,245,17,106,101,224
649,0.18,"(16, 19)","(14, 16)",4,85,88,177,14,46,39,99
650,0.02,"(6, 12)","(6, 0)",4,243,246,493,5,136,117,258
651,0.1,"(6, 25)","(7, 14)",6,118,123,247,8,61,40,109
652,0.12,"(26, 21)","(25, 11)",10,94,103,207,5,51,32,88
653,0.02,"(13, 21)","(17, 8)",7,130,136,273,5,146,104,255
654,0.12,"(24, 24)","(27, 3)",12,100,111,223,11,106,104,221
655,0.2,"(17, 6)","(26, 15)",14,90,103,207,5,76,65,146
656,0.02,"(19, 22)","(11, 2)",9,96,104,209,12,211,180,403
657,0.06,"(20, 12)","(13, 5)",5,130,134,269,5,91,77,173
658,0.06,"(29, 22)","(2, 1)",6,53,58,117,5,86,61,152
659,0.1,"(23, 25)","(19, 27)",13,126,138,277,10,41,29,80
660,0.2,"(12, 13)","(9, 19)",5,169,173,347,8,36,31,75
661,0.06,"(1, 18)","(23, 3)",6,82,87,175,7,116,97,220
662,0.1,"(14, 9)","(8, 1)",7,112,118,237,10,76,61,147
663,0.04,"(28, 18)","(1, 20)",3,73,75,151,7,96,86,189
664,0.06,"(6, 29)","(16, 9)",1,74,74,149,1,106,82,189
665,0.08,"(25, 25)","(16, 26)",8,89,96,193,8,106,75,189
666,0.12,"(28, 13)","(14, 24)",6,77,82,165,9,106,87,202
667,0.16,"(3, 14)","(26, 22)",3,51,53,107,19,116,112,247
668,0.08,"(9, 20)","(29, 20)",8,129,136,273,4,91,62,157
669,0.02,"(17, 22)","(9, 11)",6,82,87,175,12,301,245,558
670,0.18,"(8, 21)","(28, 29)",7,80,86,173,4,96,89,189
671,0.2,"(9, 1)","(6, 7)",7,26,32,65,24,46,49,119
672,0.08,"(5, 4)","(2, 3)",10,131,140,281,21,76,70,167
673,0.02,"(1, 21)","(19, 5)",5,121,125,251,5,56,41,102
674,0.02,"(27, 2)","(15, 16)",5,138,142,285,5,261,246,512
675,0.18,"(29, 23)","(22, 26)",9,128,136,273,17,36,32,85
676,0.12,"(11, 22)","(21, 18)",12,150,161,323,10,91,87,188
677,0.18,"(6, 14)","(0, 19)",10,76,85,171,4,26,17,47
678,0.16,"(18, 16)","(17, 18)",4,45,48,97,3,16,5,24
679,0.18,"(17, 21)","(3, 6)",4,40,43,87,9,151,143,303
680,0.16,"(9, 1)","(4, 12)",6,99,104,209,4,76,60,140
681,0.16,"(10, 9)","(3, 4)",15,89,103,207,3,126,102,231
682,0.1,"(8, 4)","(27, 19)",12,95,106,213,15,71,65,151
683,0.06,"(23, 18)","(20, 15)",4,61,64,129,5,111,74,190
684,0.1,"(4, 14)","(12, 27)",5,94,98,197,6,111,100,217
685,0.08,"(14, 7)","(5, 5)",8,126,133,267,14,86,74,174
686,0.04,"(24, 21)","(8, 12)",4,90,93,187,4,166,147,317
687,0.14,"(21, 22)","(11, 2)",5,91,95,191,7,76,63,146
688,0.02,"(10, 18)","(2, 10)",9,174,182,365,16,206,156,378
689,0.06,"(21, 4)","(23, 0)",4,74,77,155,9,31,25,65
690,0.06,"(20, 11)","(26, 5)",4,66,69,139,3,131,108,242
691,0.06,"(20, 3)","(23, 24)",6,134,139,279,10,106,105,221
692,0.08,"(11, 16)","(7, 26)",4,98,101,203,3,86,58,147
693,0.2,"(18, 13)","(17, 15)",7,2,8,17,6,36,19,61
694,0.1,"(17, 13)","(22, 14)",10,98,107,215,6,56,25,87
695,0.04,"(7, 3)","(22, 16)",8,135,142,285,11,86,76,173
696,0.2,"(20, 24)","(16, 5)",9,116,124,249,7,56,47,110
697,0.2,"(27, 28)","(27, 19)",11,108,118,237,6,106,91,203
698,0.2,"(29, 15)","(15, 11)",4,97,100,201,3,66,58,127
699,0.08,"(20, 26)","(14, 23)",6,88,93,187,12,66,43,121
700,0.1,"(22, 29)","(10, 1)",3,68,70,141,3,126,102,231
701,0.1,"(9, 7)","(0, 29)",9,172,180,361,8,156,149,313
702,0.12,"(3, 6)","(8, 23)",11,79,89,179,8,86,64,158
703,0.02,"(2, 10)","(19, 6)",12,108,119,239,6,301,233,540
704,0.12,"(26, 23)","(19, 17)",8,79,86,173,12,101,81,194
705,0.2,"(27, 3)","(29, 24)",5,171,175,351,3,271,251,525
706,0.02,"(9, 28)","(19, 11)",7,166,172,345,14,126,91,231
707,0.12,"(0, 1)","(7, 27)",3,94,96,193,3,81,73,157
708,0.12,"(13, 4)","(0, 0)",14,178,191,383,9,76,74,159
709,0.12,"(28, 11)","(10, 9)",7,77,83,167,8,161,149,318
710,0.16,"(5, 3)","(16, 9)",8,19,26,53,8,56,45,109
711,0.12,"(4, 6)","(0, 24)",19,100,118,237,11,121,116,248
712,0.08,"(1, 12)","(19, 16)",11,88,98,197,22,91,98,211
713,0.18,"(18, 17)","(8, 9)",6,58,63,127,5,46,40,91
714,0.14,"(11, 6)","(17, 25)",3,99,101,203,6,131,120,257
715,0.1,"(25, 22)","(11, 25)",7,84,90,181,7,136,112,255
716,0.12,"(3, 3)","(15, 5)",3,35,37,75,7,56,44,107
717,0.16,"(19, 28)","(15, 26)",3,110,112,225,2,36,13,51
718,0.06,"(27, 24)","(24, 21)",13,99,111,223,10,106,85,201
719,0.06,"(25, 17)","(17, 27)",6,92,97,195,4,141,134,279
720,0.18,"(28, 14)","(13, 10)",3,102,104,209,10,81,69,160
721,0.16,"(15, 2)","(11, 21)",12,92,103,207,5,71,59,135
722,0.14,"(19, 17)","(21, 8)",7,119,125,251,3,86,71,160
723,0.18,"(21, 23)","(6, 1)",5,73,77,155,19,76,83,178
724,0.04,"(21, 8)","(11, 12)",6,54,59,119,4,61,37,102
725,0.1,"(5, 8)","(10, 29)",12,108,119,239,12,131,118,261
726,0.16,"(1, 18)","(27, 5)",3,64,66,133,5,321,311,637
727,0.16,"(1, 8)","(27, 19)",11,69,79,159,5,91,77,173
728,0.2,"(26, 2)","(6, 18)",8,71,78,157,5,76,62,143
729,0.02,"(19, 11)","(12, 18)",8,80,87,175,5,86,61,152
730,0.2,"(24, 17)","(7, 1)",11,56,66,133,15,111,112,238
731,0.12,"(19, 17)","(0, 19)",18,124,141,283,6,121,107,234
732,0.12,"(7, 12)","(23, 28)",8,47,54,109,7,211,190,408
733,0.12,"(10, 13)","(4, 6)",5,101,105,211,13,51,47,111
734,0.08,"(18, 11)","(19, 8)",5,127,131,263,12,51,39,102
735,0.06,"(4, 12)","(6, 24)",10,64,73,147,8,71,59,138
736,0.12,"(25, 28)","(2, 2)",14,59,72,145,5,91,68,164
737,0.04,"(24, 12)","(0, 13)",8,78,85,171,17,136,112,265
738,0.2,"(22, 8)","(20, 24)",10,169,178,357,6,86,76,168
739,0.08,"(3, 19)","(11, 24)",11,70,80,161,8,121,92,221
740,0.2,"(21, 15)","(25, 16)",10,120,129,259,12,41,31,84
741,0.14,"(13, 19)","(9, 23)",6,99,104,209,7,66,49,122
742,0.06,"(26, 27)","(18, 14)",12,124,135,271,4,91,76,171
743,0.08,"(2, 15)","(10, 21)",13,102,114,229,6,116,105,227
744,0.08,"(15, 16)","(25, 29)",6,89,94,189,8,56,53,117
745,0.02,"(13, 21)","(16, 9)",10,33,42,85,4,116,84,204
746,0.02,"(3, 12)","(6, 25)",5,35,39,79,4,96,56,156
747,0.1,"(17, 6)","(29, 18)",12,139,150,301,6,111,97,214
748,0.06,"(1, 7)","(24, 0)",4,97,100,201,4,86,66,156
749,0.02,"(8, 20)","(21, 25)",6,76,81,163,7,81,71,159
750,0.04,"(1, 6)","(24, 1)",6,118,123,247,8,171,161,340
751,0.2,"(19, 8)","(5, 26)",5,63,67,135,9,171,155,335
752,0.2,"(28, 14)","(23, 7)",75,111,185,371,17,51,47,115
753,0.14,"(13, 3)","(27, 27)",16,63,78,157,5,161,141,307
754,0.18,"(13, 17)","(13, 9)",7,99,105,211,3,81,63,147
755,0.06,"(11, 9)","(16, 19)",7,43,49,99,4,121,108,233
756,0.08,"(8, 26)","(19, 20)",3,92,94,189,7,71,60,138
757,0.12,"(11, 4)","(12, 0)",3,51,53,107,6,31,21,58
758,0.06,"(27, 11)","(19, 12)",6,79,84,169,5,151,118,274
759,0.1,"(18, 14)","(4, 17)",10,83,92,185,5,76,48,129
760,0.08,"(2, 2)","(8, 3)",4,36,39,79,4,56,35,95
761,0.1,"(19, 26)","(6, 29)",6,155,160,321,10,51,34,95
762,0.04,"(12, 2)","(22, 26)",8,141,148,297,14,96,77,187
763,0.16,"(16, 12)","(14, 29)",10,97,106,213,6,141,132,279
764,0.16,"(2, 28)","(27, 17)",10,84,93,187,10,106,77,193
765,0.02,"(8, 10)","(3, 22)",9,50,58,117,4,101,65,170
766,0.12,"(28, 10)","(6, 4)",9,93,101,203,8,161,153,322
767,0.08,"(15, 6)","(14, 29)",3,138,140,281,5,91,79,175
768,0.08,"(9, 10)","(3, 16)",14,96,109,219,6,61,38,105
769,0.04,"(11, 25)","(12, 22)",4,96,99,199,9,36,27,72
770,0.18,"(22, 5)","(19, 21)",4,111,114,229,11,61,48,120
771,0.04,"(12, 0)","(26, 8)",5,87,91,183,6,96,83,185
772,0.14,"(5, 7)","(20, 0)",4,180,183,367,4,56,39,99
773,0.02,"(8, 24)","(3, 18)",3,101,103,207,4,66,34,104
774,0.14,"(12, 3)","(18, 6)",4,102,105,211,9,81,68,158
775,0.16,"(27, 7)","(3, 26)",10,67,76,153,8,81,67,156
776,0.06,"(15, 25)","(2, 28)",13,120,132,265,9,71,48,128
777,0.16,"(9, 3)","(10, 26)",9,119,127,255,41,221,239,501
778,0.16,"(17, 16)","(18, 15)",7,44,50,101,6,36,24,66
779,0.02,"(1, 6)","(28, 16)",8,121,128,257,3,226,184,413
780,0.12,"(23, 2)","(28, 26)",4,120,123,247,13,116,99,228
781,0.04,"(5, 7)","(2, 4)",5,96,100,201,5,116,91,212
782,0.08,"(6, 6)","(6, 10)",9,16,24,49,4,61,47,112
783,0.12,"(16, 10)","(1, 23)",8,33,40,81,6,121,96,223
784,0.16,"(17, 5)","(23, 13)",7,91,97,195,15,61,53,129
785,0.08,"(14, 23)","(27, 15)",7,80,86,173,24,176,159,359
786,0.02,"(26, 3)","(6, 20)",8,162,169,339,7,91,71,169
787,0.02,"(7, 25)","(27, 17)",13,66,78,157,19,251,194,464
788,0.14,"(16, 14)","(16, 4)",11,119,129,259,4,81,66,151
789,0.02,"(14, 0)","(13, 5)",4,133,136,273,21,186,159,366
790,0.16,"(18, 18)","(4, 2)",4,59,62,125,6,71,64,141
791,0.02,"(8, 8)","(29, 10)",8,207,214,429,5,106,85,196
792,0.04,"(14, 14)","(2, 0)",13,135,147,295,14,71,58,143
793,0.06,"(11, 26)","(9, 17)",3,131,133,267,4,51,33,88
794,0.08,"(18, 16)","(27, 20)",13,118,130,261,12,176,158,346
795,0.02,"(28, 20)","(20, 9)",3,162,164,329,8,211,174,393
796,0.18,"(15, 25)","(6, 29)",9,216,224,449,9,101,96,206
797,0.16,"(0, 7)","(10, 19)",12,20,31,63,10,86,75,171
798,0.02,"(8, 13)","(10, 6)",3,100,102,205,8,176,134,318
799,0.08,"(10, 27)","(16, 11)",3,69,71,143,6,71,52,129
800,0.18,"(0, 3)","(6, 4)",8,108,115,231,8,36,30,74
801,0.12,"(20, 1)","(22, 3)",3,99,101,203,7,36,18,61
802,0.2,"(21, 2)","(3, 19)",5,38,42,85,13,106,95,214
803,0.18,"(15, 6)","(14, 1)",21,163,183,367,5,56,39,100
804,0.04,"(0, 1)","(24, 19)",6,172,177,355,3,156,136,295
805,0.04,"(1, 13)","(12, 15)",7,92,98,197,5,66,55,126
806,0.02,"(14, 12)","(11, 5)",3,50,52,105,9,66,35,110
807,0.1,"(2, 6)","(12, 3)",3,117,119,239,4,91,77,172
808,0.18,"(8, 18)","(11, 2)",9,99,107,215,12,96,97,205
809,0.08,"(25, 21)","(23, 20)",8,4,11,23,16,16,17,49
810,0.04,"(2, 14)","(23, 22)",12,164,175,351,5,56,50,111
811,0.18,"(29, 25)","(22, 21)",4,104,107,215,8,71,47,126
812,0.08,"(9, 20)","(9, 13)",15,101,115,231,9,86,70,165
813,0.18,"(8, 13)","(16, 20)",6,66,71,143,23,51,60,134
814,0.08,"(28, 8)","(19, 1)",18,111,128,257,10,71,70,151
815,0.18,"(21, 2)","(29, 24)",7,116,122,245,10,86,83,179
816,0.06,"(19, 0)","(15, 9)",3,60,62,125,4,71,43,118
817,0.14,"(17, 11)","(1, 18)",7,26,32,65,15,56,58,129
818,0.16,"(6, 25)","(27, 16)",5,150,154,309,7,116,100,223
819,0.18,"(26, 10)","(13, 15)",6,76,81,163,5,91,79,175
820,0.1,"(4, 14)","(15, 16)",6,86,91,183,10,56,49,115
821,0.12,"(8, 12)","(0, 17)",8,90,97,195,10,91,90,191
822,0.08,"(3, 9)","(5, 9)",5,6,10,21,6,16,7,29
823,0.16,"(0, 12)","(10, 24)",14,67,80,161,5,46,29,80
824,0.2,"(8, 22)","(15, 2)",5,69,73,147,5,71,53,129
825,0.2,"(9, 14)","(9, 0)",9,87,95,191,5,131,122,258
826,0.16,"(26, 20)","(21, 2)",7,102,108,217,7,76,62,145
827,0.04,"(17, 10)","(26, 18)",6,169,174,349,6,166,143,315
828,0.16,"(21, 21)","(28, 26)",5,120,124,249,3,41,31,75
829,0.1,"(29, 9)","(12, 7)",13,92,104,209,4,76,61,141
830,0.12,"(25, 6)","(19, 13)",9,86,94,189,7,66,59,132
831,0.14,"(11, 14)","(19, 19)",7,113,119,239,5,76,70,151
832,0.08,"(0, 18)","(10, 26)",5,54,58,117,4,116,104,224
833,0.1,"(0, 3)","(7, 27)",5,121,125,251,28,151,149,328
834,0.14,"(8, 10)","(29, 12)",9,72,80,161,5,96,89,190
835,0.16,"(15, 17)","(28, 10)",20,98,117,235,5,81,60,146
836,0.06,"(28, 14)","(6, 8)",6,78,83,167,8,86,68,162
837,0.2,"(5, 24)","(15, 0)",18,109,126,253,6,71,54,131
838,0.04,"(4, 4)","(1, 26)",4,163,166,333,13,151,131,295
839,0.08,"(22, 11)","(0, 27)",6,42,47,95,4,116,108,228
840,0.18,"(20, 10)","(6, 20)",6,78,83,167,5,121,99,225
841,0.14,"(28, 5)","(11, 27)",10,70,79,159,11,71,65,147
842,0.16,"(7, 27)","(15, 14)",6,20,25,51,7,41,37,85
843,0.06,"(26, 5)","(10, 26)",8,146,153,307,7,121,88,216
844,0.1,"(24, 29)","(4, 10)",4,68,71,143,10,121,106,237
845,0.14,"(19, 28)","(16, 19)",4,117,120,241,10,56,48,114
846,0.2,"(27, 18)","(27, 26)",8,143,150,301,4,71,59,134
847,0.08,"(20, 2)","(24, 15)",17,88,104,209,7,111,90,208
848,0.08,"(17, 29)","(12, 29)",6,23,28,57,10,36,25,71
849,0.12,"(21, 3)","(4, 26)",2,62,63,127,8,76,65,149
850,0.18,"(29, 12)","(7, 18)",7,66,72,145,23,131,134,288
851,0.06,"(15, 19)","(5, 12)",6,109,114,229,8,51,43,102
852,0.2,"(1, 0)","(9, 15)",7,21,27,55,7,81,66,154
853,0.14,"(28, 3)","(21, 14)",9,99,107,215,10,46,41,97
854,0.08,"(11, 24)","(23, 2)",6,60,65,131,6,81,55,142
855,0.12,"(9, 22)","(19, 22)",6,97,102,205,6,66,42,114
856,0.18,"(29, 14)","(5, 10)",7,65,71,143,4,131,118,253
857,0.2,"(5, 4)","(0, 1)",8,105,112,225,6,26,17,49
858,0.14,"(0, 23)","(22, 15)",10,86,95,191,4,61,50,115
859,0.06,"(15, 12)","(7, 12)",9,37,45,91,8,71,48,127
860,0.1,"(18, 28)","(9, 28)",16,52,67,135,4,71,33,108
861,0.04,"(11, 4)","(7, 6)",9,66,74,149,9,81,49,139
862,0.04,"(14, 12)","(9, 13)",18,101,118,237,5,56,34,95
863,0.02,"(2, 18)","(14, 8)",3,80,82,165,8,166,134,308
864,0.16,"(21, 7)","(26, 0)",7,51,57,115,7,151,131,289
865,0.12,"(18, 0)","(5, 1)",6,81,86,173,11,56,54,121
866,0.08,"(6, 15)","(9, 11)",8,25,32,65,11,36,31,78
867,0.12,"(23, 3)","(25, 19)",19,119,137,275,13,136,111,260
868,0.02,"(9, 23)","(16, 27)",6,235,240,481,8,126,98,232
869,0.2,"(8, 23)","(3, 15)",14,111,124,249,9,96,88,193
870,0.18,"(21, 23)","(17, 20)",15,112,126,253,10,36,24,70
871,0.02,"(26, 29)","(19, 10)",7,88,94,189,5,146,116,267
872,0.12,"(27, 3)","(17, 7)",16,80,95,191,7,56,48,111
873,0.06,"(26, 6)","(17, 5)",9,107,115,231,5,71,65,141
874,0.16,"(19, 5)","(14, 0)",7,136,142,285,3,91,79,173
875,0.06,"(16, 16)","(18, 25)",10,105,114,229,6,156,121,283
876,0.12,"(13, 25)","(11, 6)",6,85,90,181,6,141,121,268
877,0.18,"(9, 12)","(3, 24)",4,121,124,249,5,206,199,410
878,0.14,"(24, 23)","(8, 8)",6,81,86,173,5,106,74,185
879,0.2,"(0, 22)","(8, 5)",3,101,103,207,6,76,64,146
880,0.02,"(29, 7)","(1, 17)",11,45,55,111,10,136,96,242
881,0.14,"(2, 4)","(14, 13)",9,25,33,67,7,81,68,156
882,0.12,"(2, 0)","(6, 12)",7,138,144,289,2,76,64,142
883,0.12,"(16, 15)","(18, 11)",13,82,94,189,6,51,29,86
884,0.02,"(19, 9)","(7, 24)",11,144,154,309,6,146,111,263
885,0.12,"(9, 7)","(20, 26)",17,70,86,173,4,91,80,175
886,0.08,"(2, 10)","(29, 21)",5,59,63,127,12,86,73,171
887,0.16,"(13, 15)","(8, 5)",19,65,83,167,12,76,72,160
888,0.12,"(25, 22)","(20, 27)",6,35,40,81,5,66,52,123
889,0.1,"(16, 16)","(23, 28)",5,137,141,283,10,241,231,482
890,0.12,"(15, 25)","(27, 16)",7,99,105,211,11,71,57,139
891,0.16,"(23, 5)","(18, 16)",8,96,103,207,7,101,87,195
892,0.1,"(0, 6)","(27, 2)",5,132,136,273,6,101,80,187
893,0.12,"(0, 7)","(5, 28)",6,95,100,201,7,116,104,227
894,0.08,"(0, 4)","(21, 11)",9,109,117,235,8,91,68,167
895,0.02,"(18, 4)","(1, 4)",18,118,135,271,4,176,130,310
896,0.08,"(18, 22)","(11, 17)",7,81,87,175,6,36,20,62
897,0.14,"(27, 4)","(12, 16)",6,32,37,75,4,101,79,184
898,0.18,"(11, 1)","(8, 12)",4,135,138,277,8,91,80,179
899,0.2,"(19, 2)","(15, 11)",7,86,92,185,12,96,93,201
900,0.16,"(18, 10)","(27, 0)",2,102,103,207,2,126,113,241
901,0.02,"(3, 11)","(5, 15)",6,89,94,189,13,46,33,92
902,0.12,"(25, 6)","(21, 14)",9,86,94,189,7,61,53,121
903,0.08,"(21, 12)","(27, 7)",3,110,112,225,3,176,162,341
904,0.02,"(28, 13)","(14, 15)",28,120,147,295,7,91,62,160
905,0.12,"(17, 10)","(29, 5)",6,135,140,281,7,106,89,202
906,0.12,"(17, 24)","(23, 4)",3,81,83,167,7,61,57,125
907,0.16,"(3, 20)","(9, 5)",7,118,124,249,4,76,55,135
908,0.2,"(8, 12)","(2, 26)",8,203,210,421,4,81,71,156
909,0.08,"(10, 5)","(4, 9)",8,27,34,69,17,76,76,169
910,0.04,"(12, 5)","(7, 27)",22,150,171,343,8,146,117,271
911,0.04,"(5, 9)","(21, 22)",5,113,117,235,5,126,91,222
912,0.02,"(6, 23)","(22, 19)",7,113,119,239,5,121,82,208
913,0.04,"(4, 19)","(19, 28)",9,106,114,229,9,76,71,156
914,0.1,"(16, 20)","(14, 0)",8,54,61,123,8,136,128,272
915,0.08,"(3, 2)","(1, 7)",7,18,24,49,9,61,45,115
916,0.1,"(22, 20)","(4, 3)",4,56,59,119,3,106,77,186
917,0.06,"(13, 25)","(20, 28)",4,132,135,271,6,131,96,233
918,0.1,"(2, 29)","(17, 2)",12,120,131,263,7,91,85,183
919,0.04,"(26, 5)","(18, 16)",12,123,134,269,8,96,90,194
920,0.04,"(2, 16)","(0, 21)",16,50,65,131,6,46,28,80
921,0.12,"(10, 7)","(11, 12)",33,60,92,185,9,126,113,248
922,0.16,"(1, 12)","(17, 12)",11,106,116,233,8,131,114,253
923,0.08,"(6, 9)","(3, 2)",7,108,114,229,4,101,82,187
924,0.1,"(24, 2)","(26, 8)",4,121,124,249,2,46,26,74
925,0.02,"(16, 28)","(9, 8)",4,138,141,283,7,281,195,483
926,0.12,"(1, 22)","(5, 5)",8,131,138,277,7,86,76,169
927,0.1,"(0, 10)","(1, 9)",4,2,5,11,6,16,7,29
928,0.18,"(13, 1)","(10, 29)",10,116,125,251,9,61,55,125
929,0.16,"(29, 17)","(29, 6)",5,140,144,289,8,66,52,126
930,0.2,"(6, 4)","(22, 9)",7,113,119,239,7,66,61,134
931,0.18,"(2, 23)","(23, 22)",14,114,127,255,4,151,132,287
932,0.08,"(8, 2)","(13, 16)",8,95,102,205,7,76,57,140
933,0.12,"(28, 4)","(20, 11)",8,94,101,203,12,66,49,127
934,0.18,"(9, 11)","(4, 15)",18,68,85,171,11,51,48,110
935,0.16,"(12, 13)","(9, 12)",3,34,36,73,8,41,34,83
936,0.12,"(26, 26)","(21, 18)",12,95,106,213,15,106,94,215
937,0.1,"(26, 6)","(11, 26)",4,83,86,173,3,126,105,234
938,0.18,"(15, 2)","(14, 10)",5,16,20,41,8,106,97,211
939,0.08,"(25, 6)","(19, 4)",6,121,126,253,3,46,26,75
940,0.02,"(28, 21)","(10, 26)",5,196,200,401,2,61,52,115
941,0.06,"(17, 21)","(12, 21)",4,9,12,25,22,111,80,213
942,0.18,"(20, 5)","(8, 21)",15,63,77,155,11,66,63,140
943,0.06,"(5, 13)","(6, 11)",9,85,93,187,8,101,75,184
944,0.18,"(20, 5)","(13, 17)",6,111,116,233,9,56,49,114
945,0.04,"(12, 10)","(5, 23)",4,86,89,179,15,166,147,328
946,0.14,"(7, 16)","(26, 28)",10,135,144,289,10,271,264,545
947,0.12,"(21, 15)","(12, 8)",5,62,66,133,5,71,50,126
948,0.06,"(18, 0)","(1, 7)",6,96,101,203,3,81,53,137
949,0.04,"(14, 26)","(17, 18)",5,24,28,57,6,181,144,331
950,0.16,"(18, 15)","(11, 7)",6,116,121,243,6,56,41,103
951,0.04,"(26, 3)","(19, 21)",6,121,126,253,9,71,66,146
952,0.1,"(12, 25)","(25, 14)",4,74,77,155,10,121,102,233
953,0.08,"(7, 1)","(0, 10)",7,118,124,249,15,111,100,226
954,0.08,"(26, 27)","(16, 9)",10,117,126,253,7,96,72,175
955,0.08,"(8, 24)","(29, 22)",4,74,77,155,5,91,76,172
956,0.02,"(15, 15)","(17, 21)",4,155,158,317,4,106,80,190
957,0.16,"(0, 17)","(7, 1)",14,85,98,197,13,56,45,114
958,0.2,"(29, 9)","(9, 9)",7,132,138,277,6,96,90,192
959,0.12,"(25, 17)","(25, 6)",25,106,130,261,3,96,78,177
960,0.14,"(21, 29)","(6, 26)",11,117,127,255,19,76,81,176
961,0.06,"(20, 10)","(7, 15)",3,135,137,275,5,146,117,268
962,0.08,"(12, 8)","(9, 8)",11,8,18,37,7,41,28,76
963,0.16,"(25, 18)","(7, 22)",9,147,155,311,5,81,58,144
964,0.06,"(28, 14)","(16, 21)",6,110,115,231,3,131,112,246
965,0.08,"(9, 14)","(18, 3)",5,100,104,209,5,91,69,165
966,0.08,"(8, 14)","(4, 21)",7,42,48,97,7,121,89,217
967,0.1,"(3, 22)","(22, 26)",3,153,155,311,4,86,66,156
968,0.06,"(17, 23)","(8, 18)",10,12,21,43,7,76,65,148
969,0.14,"(1, 29)","(18, 13)",9,86,94,189,6,116,96,218
970,0.02,"(29, 14)","(0, 27)",8,47,54,109,10,221,182,413
971,0.16,"(16, 11)","(6, 26)",6,116,121,243,3,126,108,237
972,0.18,"(27, 15)","(24, 10)",16,114,129,259,5,46,28,79
973,0.14,"(14, 8)","(16, 0)",4,115,118,237,4,171,156,331
974,0.16,"(4, 7)","(23, 29)",7,87,93,187,13,106,95,214
975,0.16,"(6, 5)","(20, 14)",7,26,32,65,7,56,44,107
976,0.06,"(24, 16)","(10, 29)",2,81,82,165,5,66,55,126
977,0.14,"(1, 6)","(24, 15)",15,84,98,197,3,81,66,150
978,0.1,"(25, 19)","(4, 24)",8,99,106,213,15,166,155,336
979,0.2,"(18, 17)","(15, 24)",4,79,82,165,6,41,26,73
980,0.16,"(15, 2)","(13, 0)",8,7,14,29,9,76,64,149
981,0.2,"(24, 25)","(11, 9)",19,31,49,99,11,56,55,122
982,0.16,"(12, 18)","(27, 13)",3,129,131,263,13,66,61,140
983,0.14,"(12, 15)","(25, 24)",9,41,49,99,8,91,79,178
984,0.06,"(23, 13)","(25, 12)",8,61,68,137,15,21,18,54
985,0.08,"(21, 21)","(2, 16)",10,85,94,189,4,116,96,216
986,0.14,"(15, 25)","(18, 5)",13,75,87,175,14,156,149,319
987,0.18,"(17, 23)","(10, 12)",6,113,118,237,5,61,54,120
988,0.06,"(16, 11)","(15, 27)",5,231,235,471,15,81,83,179
989,0.02,"(26, 13)","(8, 3)",4,179,182,365,4,96,89,189
990,0.12,"(18, 12)","(24, 19)",14,73,86,173,10,71,59,140
991,0.12,"(17, 9)","(25, 1)",9,115,123,247,4,101,84,189
992,0.1,"(11, 20)","(4, 7)",8,132,139,279,9,151,126,286
993,0.12,"(14, 7)","(18, 23)",8,23,30,61,6,86,81,173
994,0.06,"(15, 17)","(21, 16)",4,153,156,313,29,201,196,426
995,0.08,"(18, 15)","(17, 16)",11,27,37,75,12,21,15,48
996,0.16,"(15, 11)","(7, 21)",9,107,115,231,8,71,51,130
997,0.14,"(7, 24)","(0, 0)",11,115,125,251,9,191,185,385
998,0.16,"(0, 18)","(0, 14)",4,67,70,141,8,31,22,61
999,0.06,"(13, 18)","(3, 18)",10,45,54,109,10,131,105,246
