0,0.18,"(0, 18)","(21, 19)",9,146,125,280,6,161,116,283
1,0.14,"(27, 0)","(23, 27)",8,123,101,232,9,151,112,272
2,0.06,"(21, 19)","(6, 4)",5,128,103,236,14,81,67,162
3,0.2,"(5, 12)","(29, 29)",8,73,51,132,4,271,254,529
4,0.2,"(16, 1)","(19, 8)",5,79,54,138,4,101,59,164
5,0.1,"(6, 0)","(10, 7)",9,79,58,146,12,141,75,228
6,0.06,"(22, 24)","(21, 12)",9,95,74,178,7,81,42,130
7,0.02,"(13, 22)","(27, 12)",9,109,88,206,8,101,66,175
8,0.18,"(12, 28)","(1, 8)",8,177,155,340,9,121,66,196
9,0.02,"(21, 7)","(14, 0)",9,141,120,270,14,241,115,370
10,0.04,"(17, 26)","(8, 29)",31,101,102,234,13,91,37,141
11,0.14,"(26, 20)","(16, 8)",7,141,118,266,7,71,50,128
12,0.08,"(1, 28)","(4, 4)",5,63,38,106,5,91,61,157
13,0.08,"(8, 4)","(7, 18)",5,83,58,146,6,101,56,163
14,0.12,"(18, 13)","(22, 0)",4,85,59,148,5,101,76,182
15,0.12,"(0, 4)","(9, 24)",9,116,95,220,7,91,57,155
16,0.02,"(25, 18)","(26, 14)",4,111,85,200,5,41,17,63
17,0.12,"(0, 23)","(17, 15)",5,85,60,150,15,71,56,142
18,0.02,"(16, 5)","(28, 23)",5,90,65,160,3,161,99,263
19,0.2,"(26, 4)","(4, 0)",21,182,173,376,15,111,97,223
20,0.1,"(29, 4)","(2, 6)",5,115,90,210,20,121,104,245
21,0.02,"(2, 3)","(23, 22)",4,261,235,500,3,241,120,364
22,0.08,"(14, 12)","(27, 19)",9,131,110,250,8,111,89,208
23,0.2,"(19, 0)","(5, 7)",12,75,57,144,9,51,32,92
24,0.14,"(28, 0)","(25, 4)",9,63,42,114,6,91,35,132
25,0.2,"(0, 29)","(0, 5)",17,156,143,316,5,131,83,219
26,0.04,"(21, 1)","(4, 15)",4,95,69,168,3,141,92,236
27,0.18,"(25, 25)","(9, 19)",8,73,51,132,5,101,62,168
28,0.12,"(17, 6)","(15, 7)",19,54,43,116,20,71,36,127
29,0.06,"(11, 6)","(23, 27)",22,84,76,182,6,91,46,143
30,0.18,"(12, 20)","(2, 17)",6,74,50,130,8,71,37,116
31,0.16,"(11, 23)","(5, 7)",6,106,82,194,8,81,45,134
32,0.04,"(5, 9)","(19, 4)",4,125,99,228,3,141,99,243
33,0.1,"(18, 24)","(20, 14)",6,118,94,218,3,151,107,261
34,0.18,"(16, 4)","(13, 10)",5,47,22,74,4,61,26,91
35,0.02,"(14, 19)","(24, 6)",4,125,99,228,6,181,101,288
36,0.06,"(13, 17)","(0, 9)",8,63,41,112,11,91,59,161
37,0.04,"(26, 10)","(6, 27)",4,105,79,188,6,181,89,276
38,0.06,"(19, 2)","(21, 9)",9,114,93,216,4,121,63,188
39,0.14,"(14, 27)","(16, 1)",8,174,152,334,4,61,39,104
40,0.16,"(11, 9)","(21, 28)",9,88,67,164,11,71,45,127
41,0.1,"(26, 11)","(0, 3)",5,141,116,262,5,111,78,194
42,0.04,"(9, 16)","(25, 23)",17,159,146,322,11,201,147,359
43,0.08,"(28, 27)","(7, 15)",9,108,87,204,17,131,75,223
44,0.06,"(21, 16)","(8, 4)",11,89,70,170,5,71,47,123
45,0.16,"(7, 16)","(17, 9)",6,102,78,186,6,71,56,133
46,0.2,"(28, 26)","(2, 19)",6,134,110,250,7,91,62,160
47,0.02,"(10, 0)","(9, 7)",6,82,58,146,6,191,115,312
48,0.02,"(22, 29)","(13, 2)",7,130,107,244,8,171,126,305
49,0.16,"(9, 19)","(14, 17)",5,92,67,164,6,71,34,111
50,0.1,"(1, 5)","(0, 18)",7,49,26,82,4,81,43,128
51,0.02,"(29, 15)","(23, 20)",3,86,59,148,2,141,66,209
52,0.02,"(0, 19)","(28, 3)",6,80,56,142,8,191,142,341
53,0.04,"(5, 23)","(23, 11)",3,113,86,202,3,91,46,140
54,0.04,"(27, 9)","(27, 6)",9,37,16,62,8,111,41,160
55,0.16,"(12, 5)","(27, 17)",8,130,108,246,9,141,88,238
56,0.12,"(23, 24)","(28, 22)",9,90,69,168,6,71,45,122
57,0.02,"(22, 15)","(18, 8)",8,152,130,290,4,101,60,165
58,0.02,"(4, 27)","(22, 16)",8,145,123,276,13,131,86,230
59,0.14,"(16, 7)","(14, 14)",5,79,54,138,11,71,42,124
60,0.08,"(19, 25)","(23, 8)",6,128,104,238,6,121,75,202
61,0.18,"(28, 15)","(1, 21)",3,124,97,224,9,151,120,280
62,0.08,"(21, 4)","(7, 28)",8,99,77,184,3,131,103,237
63,0.02,"(9, 29)","(9, 24)",14,107,91,212,7,141,45,193
64,0.16,"(2, 10)","(29, 0)",3,114,87,204,4,101,76,181
65,0.2,"(25, 8)","(23, 9)",5,70,45,120,9,1,9,19
66,0.1,"(14, 19)","(15, 24)",5,43,18,66,5,71,35,111
67,0.14,"(24, 22)","(2, 2)",7,73,50,130,7,81,53,141
68,0.04,"(17, 18)","(19, 4)",5,131,106,242,4,131,101,236
69,0.2,"(7, 9)","(8, 21)",4,142,116,262,5,101,84,190
70,0.14,"(14, 9)","(6, 25)",10,81,61,152,9,121,68,198
71,0.1,"(10, 11)","(9, 13)",12,34,16,62,9,91,47,147
72,0.08,"(0, 8)","(21, 24)",3,95,68,166,17,101,78,196
73,0.1,"(6, 9)","(10, 8)",7,54,31,92,9,111,62,182
74,0.2,"(20, 17)","(24, 19)",9,1,9,19,16,71,56,143
75,0.18,"(4, 3)","(2, 12)",15,63,48,126,7,111,43,161
76,0.12,"(9, 4)","(13, 27)",5,111,86,202,8,91,47,146
77,0.16,"(3, 16)","(28, 8)",6,211,187,404,4,91,51,146
78,0.08,"(28, 21)","(13, 1)",8,115,93,216,7,121,81,209
79,0.04,"(18, 8)","(4, 29)",8,116,94,218,32,101,85,218
80,0.14,"(22, 25)","(29, 15)",8,124,102,234,3,151,110,264
81,0.04,"(14, 29)","(11, 5)",13,84,67,164,8,131,71,210
82,0.2,"(16, 28)","(11, 27)",6,35,11,52,4,51,17,72
83,0.08,"(17, 17)","(9, 20)",6,80,56,142,19,51,31,101
84,0.16,"(15, 1)","(18, 17)",11,106,87,204,6,111,65,182
85,0.14,"(13, 4)","(27, 29)",9,77,56,142,8,151,123,282
86,0.04,"(22, 2)","(17, 16)",3,99,72,174,6,101,61,168
87,0.08,"(5, 20)","(2, 16)",5,93,68,166,3,61,20,84
88,0.08,"(3, 12)","(20, 18)",7,213,190,410,6,91,53,150
89,0.04,"(17, 16)","(8, 20)",22,58,50,130,21,191,136,348
90,0.16,"(2, 3)","(22, 24)",8,99,77,184,15,91,67,173
91,0.1,"(3, 23)","(16, 5)",7,112,89,208,8,131,104,243
92,0.02,"(0, 7)","(2, 18)",8,45,23,76,10,121,71,202
93,0.18,"(1, 6)","(10, 24)",12,125,107,244,12,171,141,324
94,0.14,"(18, 28)","(4, 13)",27,170,167,364,5,101,71,177
95,0.02,"(17, 29)","(3, 28)",10,52,32,94,4,111,63,178
96,0.08,"(2, 27)","(11, 28)",8,69,47,124,8,61,41,110
97,0.08,"(17, 14)","(7, 0)",4,68,42,114,4,81,45,130
98,0.04,"(15, 6)","(29, 1)",7,168,145,320,9,191,111,311
99,0.08,"(28, 0)","(3, 9)",5,79,54,138,8,141,105,254
100,0.16,"(12, 17)","(3, 23)",12,54,36,102,9,101,62,172
101,0.14,"(18, 12)","(3, 5)",3,101,74,178,7,61,41,109
102,0.2,"(13, 0)","(27, 10)",9,175,154,338,4,131,89,224
103,0.04,"(15, 9)","(18, 27)",6,133,109,248,3,151,89,243
104,0.02,"(21, 25)","(22, 17)",7,149,126,282,6,131,56,193
105,0.14,"(27, 22)","(25, 21)",8,33,11,52,14,51,22,87
106,0.04,"(24, 22)","(6, 3)",13,83,66,162,10,141,91,242
107,0.06,"(21, 9)","(18, 12)",4,38,12,54,11,71,25,107
108,0.14,"(16, 12)","(22, 28)",10,97,77,184,4,111,55,170
109,0.08,"(1, 21)","(1, 28)",8,81,59,148,6,71,34,111
110,0.14,"(19, 6)","(16, 19)",13,84,67,164,13,71,50,134
111,0.14,"(10, 21)","(21, 22)",7,96,73,176,10,151,108,269
112,0.2,"(18, 10)","(8, 12)",14,91,75,180,10,51,33,94
113,0.04,"(0, 8)","(0, 27)",4,53,27,84,3,121,76,200
114,0.14,"(16, 28)","(12, 20)",10,58,38,106,6,81,49,136
115,0.04,"(6, 23)","(6, 29)",9,75,54,138,9,131,65,205
116,0.08,"(29, 15)","(10, 15)",10,54,34,98,8,51,29,88
117,0.02,"(29, 18)","(29, 23)",5,168,143,316,5,141,42,188
118,0.12,"(22, 8)","(28, 11)",13,91,74,178,22,121,94,237
119,0.08,"(25, 7)","(15, 0)",12,113,95,220,9,111,66,186
120,0.18,"(18, 26)","(8, 9)",8,139,117,264,8,121,82,211
121,0.14,"(3, 1)","(24, 9)",2,134,106,242,2,121,75,198
122,0.04,"(0, 6)","(11, 26)",6,107,83,196,5,141,72,218
123,0.12,"(25, 25)","(27, 29)",11,82,63,156,4,61,41,106
124,0.08,"(15, 13)","(10, 27)",6,103,79,188,12,151,114,277
125,0.04,"(15, 14)","(2, 12)",3,129,102,234,6,121,87,214
126,0.06,"(18, 3)","(9, 25)",7,123,100,230,5,171,96,272
127,0.06,"(22, 28)","(24, 9)",3,115,88,206,6,121,56,183
128,0.02,"(9, 10)","(0, 8)",5,95,70,170,5,71,26,102
129,0.02,"(10, 6)","(12, 16)",4,81,55,140,4,181,98,283
130,0.1,"(28, 26)","(8, 8)",5,67,42,114,15,91,77,183
131,0.1,"(2, 13)","(0, 3)",5,51,26,82,6,121,104,231
132,0.1,"(7, 26)","(22, 15)",4,126,100,230,7,101,64,172
133,0.14,"(24, 11)","(17, 0)",10,85,65,160,9,151,121,281
134,0.2,"(10, 26)","(1, 12)",6,230,206,442,5,151,106,262
135,0.02,"(25, 3)","(19, 22)",9,196,175,380,5,121,51,177
136,0.06,"(2, 4)","(13, 20)",4,73,47,124,7,91,45,143
137,0.1,"(13, 23)","(19, 14)",6,102,78,186,10,91,59,160
138,0.02,"(22, 27)","(25, 11)",6,159,135,300,4,181,105,290
139,0.16,"(7, 19)","(9, 15)",17,55,42,114,5,101,56,162
140,0.14,"(25, 5)","(7, 19)",13,86,69,168,10,91,62,163
141,0.06,"(4, 10)","(28, 23)",5,153,128,286,11,121,70,202
142,0.16,"(1, 8)","(5, 8)",23,54,47,124,8,61,37,106
143,0.08,"(0, 27)","(6, 19)",10,68,48,126,4,101,36,141
144,0.06,"(19, 10)","(12, 6)",15,42,27,84,13,111,66,190
145,0.08,"(15, 27)","(8, 14)",7,146,123,276,9,71,54,134
146,0.08,"(28, 25)","(26, 1)",7,123,100,230,6,161,113,280
147,0.12,"(9, 23)","(11, 17)",5,55,30,90,6,61,30,97
148,0.2,"(8, 7)","(16, 28)",5,91,66,162,13,111,91,215
149,0.18,"(5, 3)","(2, 11)",9,59,38,106,9,51,25,85
150,0.02,"(11, 25)","(25, 2)",18,136,124,278,6,221,164,391
151,0.14,"(16, 1)","(16, 12)",7,79,56,142,7,71,45,123
152,0.08,"(29, 26)","(7, 3)",4,95,69,168,5,151,102,258
153,0.14,"(22, 7)","(1, 9)",3,66,39,108,7,141,114,262
154,0.1,"(4, 26)","(29, 10)",6,100,76,182,7,91,72,170
155,0.02,"(9, 7)","(11, 25)",5,81,56,142,6,111,59,176
156,0.06,"(6, 16)","(7, 23)",5,105,80,190,4,141,103,248
157,0.02,"(16, 15)","(26, 18)",11,171,152,334,14,221,134,369
158,0.2,"(24, 6)","(22, 7)",10,37,17,64,12,71,49,132
159,0.12,"(25, 5)","(19, 9)",14,94,78,186,12,71,31,114
160,0.06,"(11, 17)","(17, 14)",10,111,91,212,5,121,90,216
161,0.16,"(2, 29)","(29, 25)",6,199,175,380,5,121,87,213
162,0.06,"(23, 11)","(1, 18)",3,103,76,182,3,141,88,232
163,0.04,"(28, 6)","(16, 4)",7,136,113,256,8,211,134,353
164,0.14,"(7, 2)","(7, 28)",4,121,95,220,3,111,70,184
165,0.02,"(24, 3)","(18, 25)",10,109,89,208,10,151,97,258
166,0.16,"(19, 6)","(4, 25)",5,89,64,158,6,101,79,186
167,0.02,"(10, 13)","(5, 19)",8,60,38,106,24,221,125,370
168,0.2,"(2, 27)","(11, 9)",8,126,104,238,6,111,65,182
169,0.06,"(5, 9)","(7, 26)",7,83,60,150,5,191,118,314
170,0.16,"(13, 13)","(23, 18)",4,121,95,220,4,111,83,198
171,0.02,"(15, 7)","(11, 10)",6,328,304,638,11,111,30,152
172,0.16,"(8, 29)","(14, 15)",4,86,60,150,3,91,52,146
173,0.14,"(18, 20)","(16, 6)",8,103,81,192,5,121,56,182
174,0.08,"(15, 13)","(15, 25)",25,134,129,288,10,131,86,227
175,0.2,"(27, 19)","(5, 8)",7,101,78,186,14,91,74,179
176,0.04,"(7, 18)","(10, 0)",15,144,129,288,5,91,66,162
177,0.08,"(0, 2)","(13, 9)",16,98,84,198,3,81,57,141
178,0.16,"(3, 24)","(12, 9)",6,89,65,160,6,121,85,212
179,0.16,"(6, 10)","(27, 0)",6,117,93,216,5,151,127,283
180,0.02,"(25, 28)","(15, 21)",24,92,86,202,4,91,41,136
181,0.08,"(19, 17)","(25, 24)",27,110,107,244,61,141,141,343
182,0.08,"(0, 9)","(22, 26)",9,68,47,124,5,121,84,210
183,0.08,"(27, 26)","(23, 5)",6,170,146,322,9,101,63,173
184,0.18,"(21, 5)","(24, 12)",5,76,51,132,5,111,76,192
185,0.16,"(17, 7)","(23, 14)",10,151,131,292,5,121,77,203
186,0.08,"(16, 19)","(22, 9)",26,102,98,226,7,131,67,205
187,0.04,"(9, 26)","(17, 26)",4,132,106,242,5,71,37,113
188,0.1,"(23, 19)","(0, 26)",8,143,121,272,15,91,60,166
189,0.16,"(1, 17)","(8, 19)",5,85,60,150,4,101,60,165
190,0.12,"(15, 20)","(11, 19)",10,54,34,98,7,61,34,102
191,0.06,"(0, 9)","(8, 20)",7,86,63,156,8,191,108,307
192,0.2,"(28, 13)","(9, 8)",7,56,33,96,8,141,96,245
193,0.18,"(13, 17)","(15, 28)",6,116,92,214,13,71,54,138
194,0.14,"(17, 19)","(7, 6)",5,74,49,128,5,101,55,161
195,0.06,"(7, 1)","(28, 4)",7,137,114,258,16,91,75,182
196,0.06,"(8, 6)","(23, 26)",7,93,70,170,6,81,53,140
197,0.04,"(19, 29)","(14, 13)",7,90,67,164,9,151,96,256
198,0.18,"(1, 10)","(11, 10)",3,116,89,208,6,81,55,142
199,0.04,"(29, 18)","(6, 7)",3,110,83,196,4,131,80,215
200,0.1,"(6, 24)","(0, 20)",7,44,21,72,13,61,27,101
201,0.06,"(10, 28)","(11, 27)",15,42,27,84,8,61,26,95
202,0.08,"(4, 12)","(16, 2)",9,122,101,232,6,81,52,139
203,0.08,"(18, 9)","(22, 23)",4,164,138,306,4,91,49,144
204,0.04,"(5, 29)","(15, 25)",7,104,81,192,12,91,59,162
205,0.14,"(20, 5)","(7, 17)",4,113,87,204,8,131,72,211
206,0.04,"(20, 10)","(0, 20)",12,132,114,258,7,111,56,174
207,0.18,"(0, 9)","(0, 10)",7,54,31,92,3,31,5,39
208,0.16,"(1, 5)","(29, 4)",4,127,101,232,10,101,84,195
209,0.12,"(29, 16)","(24, 16)",17,42,29,88,21,31,23,75
210,0.1,"(7, 29)","(20, 27)",4,87,61,152,6,111,65,182
211,0.06,"(3, 19)","(20, 0)",9,130,109,248,8,101,68,177
212,0.16,"(11, 6)","(26, 1)",4,100,74,178,11,131,89,231
213,0.12,"(1, 11)","(0, 10)",6,34,10,50,5,31,9,45
214,0.04,"(12, 0)","(22, 21)",6,97,73,176,5,121,80,206
215,0.12,"(6, 6)","(15, 14)",4,108,82,194,10,61,48,119
216,0.02,"(14, 10)","(16, 23)",7,202,179,388,10,151,116,277
217,0.06,"(0, 26)","(27, 17)",8,120,98,226,5,101,63,169
218,0.08,"(18, 13)","(8, 24)",5,106,81,192,4,141,115,260
219,0.06,"(0, 12)","(9, 10)",13,86,69,168,5,81,36,122
220,0.1,"(0, 22)","(16, 4)",9,77,56,142,8,141,90,239
221,0.08,"(27, 23)","(27, 12)",6,83,59,148,3,81,39,123
222,0.04,"(9, 22)","(7, 8)",7,269,246,522,4,91,51,146
223,0.02,"(29, 8)","(22, 2)",7,180,157,344,8,151,105,264
224,0.16,"(12, 29)","(27, 28)",7,90,67,164,11,91,65,167
225,0.12,"(16, 23)","(29, 29)",13,120,103,236,9,201,186,396
226,0.2,"(8, 29)","(18, 13)",9,103,82,194,3,71,40,114
227,0.16,"(9, 19)","(12, 17)",11,48,29,88,6,51,25,82
228,0.04,"(13, 21)","(7, 5)",10,193,173,376,7,191,127,325
229,0.12,"(18, 18)","(29, 13)",7,136,113,256,8,121,85,214
230,0.06,"(26, 0)","(1, 9)",8,122,100,230,3,111,84,198
231,0.14,"(2, 21)","(25, 3)",6,86,62,154,4,131,70,205
232,0.12,"(20, 5)","(11, 4)",6,42,18,66,33,51,47,131
233,0.12,"(16, 19)","(25, 19)",4,75,49,128,7,111,64,182
234,0.2,"(10, 19)","(0, 22)",5,45,20,70,9,161,137,307
235,0.2,"(11, 3)","(26, 27)",6,81,57,144,7,161,133,301
236,0.04,"(23, 4)","(11, 16)",10,86,66,162,3,61,43,107
237,0.08,"(7, 1)","(10, 23)",3,140,113,256,7,121,74,202
238,0.2,"(10, 26)","(4, 1)",5,109,84,198,8,141,103,252
239,0.14,"(5, 6)","(17, 12)",7,159,136,302,7,111,72,190
240,0.02,"(29, 8)","(24, 7)",6,70,46,122,4,191,97,292
241,0.02,"(24, 29)","(9, 29)",5,58,33,96,6,91,58,155
242,0.14,"(17, 27)","(11, 15)",5,73,48,126,6,61,32,99
243,0.12,"(13, 26)","(19, 7)",6,146,122,274,11,131,90,232
244,0.06,"(21, 21)","(27, 17)",11,82,63,156,18,91,66,175
245,0.12,"(16, 4)","(5, 6)",3,60,33,96,16,101,77,194
246,0.1,"(6, 29)","(20, 3)",5,98,73,176,5,131,76,212
247,0.02,"(27, 11)","(13, 6)",3,142,115,260,10,151,82,243
248,0.08,"(5, 2)","(0, 16)",7,52,29,88,4,81,64,149
249,0.12,"(2, 28)","(4, 15)",10,57,37,104,9,81,46,136
250,0.2,"(18, 16)","(29, 8)",5,144,119,268,11,141,111,263
251,0.18,"(1, 1)","(0, 18)",5,49,24,78,5,51,26,82
252,0.18,"(24, 17)","(3, 18)",5,106,81,192,7,121,93,221
253,0.16,"(26, 6)","(3, 27)",6,76,52,134,13,131,95,239
254,0.16,"(4, 0)","(21, 9)",6,128,104,238,10,131,105,246
255,0.12,"(0, 0)","(25, 1)",6,112,88,206,4,131,73,208
256,0.16,"(8, 2)","(4, 12)",17,51,38,106,25,71,49,145
257,0.16,"(24, 23)","(16, 11)",5,117,92,214,3,91,54,148
258,0.06,"(17, 24)","(27, 16)",9,173,152,334,9,141,101,251
259,0.12,"(17, 15)","(12, 29)",6,120,96,222,3,171,137,311
260,0.04,"(16, 0)","(22, 24)",13,216,199,428,4,81,48,133
261,0.08,"(9, 11)","(11, 11)",12,1,12,25,4,111,37,152
262,0.06,"(22, 10)","(29, 7)",9,187,166,362,7,101,64,172
263,0.06,"(4, 1)","(26, 23)",3,109,82,194,3,161,96,260
264,0.06,"(12, 25)","(2, 26)",10,63,43,116,5,71,28,104
265,0.02,"(9, 7)","(15, 17)",5,245,220,470,11,271,181,463
266,0.04,"(4, 11)","(13, 22)",16,165,151,332,8,121,68,197
267,0.04,"(10, 21)","(22, 1)",23,121,114,258,5,141,78,224
268,0.18,"(19, 7)","(28, 2)",6,123,99,228,6,91,62,159
269,0.04,"(27, 26)","(14, 13)",4,101,75,180,7,171,93,271
270,0.04,"(16, 14)","(24, 3)",4,101,75,180,18,71,64,153
271,0.14,"(1, 15)","(27, 0)",7,121,98,226,11,101,74,186
272,0.12,"(29, 12)","(6, 27)",5,116,91,212,24,71,69,164
273,0.18,"(23, 3)","(15, 18)",6,116,92,214,10,101,67,178
274,0.06,"(20, 24)","(8, 14)",9,102,81,192,5,141,81,227
275,0.1,"(16, 7)","(15, 19)",25,107,102,234,9,131,71,211
276,0.12,"(24, 20)","(8, 22)",9,74,53,136,7,91,72,170
277,0.2,"(20, 1)","(26, 15)",8,115,93,216,7,151,122,280
278,0.12,"(22, 1)","(21, 11)",3,113,86,202,4,51,31,86
279,0.14,"(26, 13)","(10, 2)",5,122,97,224,9,121,96,226
280,0.18,"(20, 10)","(2, 4)",4,116,90,210,4,151,101,256
281,0.06,"(2, 4)","(14, 27)",10,67,47,124,10,101,55,166
282,0.16,"(1, 26)","(24, 4)",3,102,75,180,12,121,87,220
283,0.02,"(1, 2)","(14, 29)",9,105,84,198,4,111,70,185
284,0.14,"(1, 18)","(9, 3)",8,74,52,134,5,101,68,174
285,0.08,"(0, 5)","(5, 6)",3,70,43,116,13,111,75,199
286,0.16,"(23, 12)","(7, 13)",21,68,59,148,9,121,83,213
287,0.08,"(23, 15)","(0, 28)",26,104,100,230,36,101,98,235
288,0.04,"(9, 26)","(17, 25)",6,86,62,154,6,141,91,238
289,0.18,"(5, 26)","(22, 28)",7,126,103,236,3,121,72,196
290,0.1,"(20, 1)","(0, 2)",5,58,33,96,7,161,92,260
291,0.2,"(23, 2)","(28, 19)",4,152,126,282,5,141,108,254
292,0.2,"(2, 7)","(23, 5)",5,203,178,386,10,131,101,242
293,0.18,"(16, 16)","(3, 8)",10,77,57,144,11,71,42,124
294,0.14,"(27, 2)","(26, 19)",5,120,95,220,5,141,107,253
295,0.1,"(17, 10)","(4, 26)",7,82,59,148,4,141,78,223
296,0.14,"(17, 7)","(6, 18)",7,74,51,132,10,91,48,149
297,0.1,"(3, 20)","(19, 23)",5,113,88,206,14,131,100,245
298,0.1,"(25, 16)","(24, 3)",5,125,100,230,8,131,73,212
299,0.12,"(10, 24)","(14, 14)",7,110,87,204,2,101,60,163
300,0.14,"(21, 3)","(18, 2)",6,37,13,56,6,61,32,99
301,0.08,"(5, 9)","(10, 5)",8,57,35,100,7,161,84,252
302,0.04,"(4, 21)","(14, 5)",3,69,42,114,3,91,64,158
303,0.16,"(25, 25)","(14, 6)",10,110,90,210,6,141,103,250
304,0.04,"(1, 5)","(20, 26)",3,145,118,266,5,91,66,162
305,0.04,"(29, 20)","(21, 19)",1,94,65,160,1,91,35,127
306,0.06,"(15, 16)","(12, 29)",11,153,134,298,5,161,109,275
307,0.14,"(1, 15)","(15, 19)",6,75,51,132,5,71,53,129
308,0.2,"(24, 2)","(29, 0)",11,73,54,138,12,171,152,335
309,0.14,"(18, 8)","(17, 0)",9,68,47,124,7,91,56,154
310,0.08,"(0, 20)","(18, 21)",12,118,100,230,75,111,138,324
311,0.2,"(24, 15)","(1, 25)",17,137,124,278,10,81,56,147
312,0.04,"(4, 21)","(7, 15)",8,99,77,184,2,151,86,239
313,0.18,"(3, 11)","(1, 6)",5,39,14,58,14,41,25,80
314,0.04,"(24, 26)","(15, 14)",7,198,175,380,7,141,103,251
315,0.04,"(28, 2)","(2, 5)",6,73,49,128,5,71,43,119
316,0.14,"(21, 11)","(13, 1)",7,83,60,150,5,81,39,125
317,0.14,"(3, 26)","(16, 16)",6,159,135,300,9,131,91,231
318,0.12,"(14, 6)","(5, 22)",6,75,51,132,6,161,105,272
319,0.12,"(15, 28)","(20, 27)",8,52,30,90,4,81,48,133
320,0.06,"(24, 20)","(23, 17)",7,88,65,160,14,51,28,93
321,0.14,"(12, 5)","(5, 13)",7,70,47,124,5,101,48,154
322,0.1,"(7, 29)","(4, 11)",10,75,55,140,10,81,45,136
323,0.12,"(7, 15)","(4, 2)",8,106,84,198,7,111,78,196
324,0.2,"(5, 8)","(29, 21)",14,86,70,170,9,121,95,225
325,0.1,"(5, 1)","(12, 14)",10,89,69,168,19,111,64,194
326,0.14,"(21, 8)","(29, 9)",6,83,59,148,11,111,73,195
327,0.18,"(25, 3)","(1, 21)",7,89,66,162,4,71,47,122
328,0.16,"(6, 18)","(18, 15)",16,151,137,304,6,111,72,189
329,0.08,"(25, 3)","(11, 16)",9,97,76,182,4,151,103,258
330,0.14,"(7, 20)","(11, 10)",74,75,119,268,9,131,106,246
331,0.2,"(8, 18)","(2, 28)",7,126,103,236,11,51,34,96
332,0.1,"(18, 12)","(21, 0)",16,125,111,252,7,71,41,119
333,0.12,"(22, 3)","(0, 26)",7,74,51,132,6,141,113,260
334,0.16,"(1, 10)","(2, 3)",14,37,21,72,10,71,27,108
335,0.02,"(18, 24)","(24, 21)",11,132,113,256,10,221,111,342
336,0.04,"(0, 16)","(19, 3)",3,93,66,162,3,141,81,225
337,0.06,"(9, 27)","(28, 15)",5,146,121,272,5,111,69,185
338,0.08,"(17, 5)","(7, 28)",8,118,96,222,8,71,49,128
339,0.12,"(15, 14)","(4, 13)",5,58,33,96,16,61,42,119
340,0.1,"(14, 27)","(20, 15)",18,119,107,244,7,111,70,188
341,0.18,"(29, 14)","(9, 20)",10,97,77,184,3,101,74,178
342,0.06,"(13, 2)","(1, 20)",25,121,116,262,10,81,50,141
343,0.12,"(13, 25)","(25, 25)",13,80,63,156,8,111,52,171
344,0.04,"(29, 23)","(22, 20)",9,77,56,142,5,121,39,165
345,0.14,"(11, 4)","(27, 4)",5,184,159,348,8,81,49,138
346,0.18,"(9, 25)","(17, 26)",13,81,64,158,6,71,44,121
347,0.1,"(10, 24)","(8, 17)",7,165,142,314,11,191,145,347
348,0.04,"(19, 10)","(2, 19)",14,77,61,152,14,71,64,149
349,0.06,"(6, 25)","(15, 20)",4,87,61,152,4,71,45,120
350,0.2,"(13, 29)","(7, 29)",31,38,39,108,9,81,36,126
351,0.06,"(22, 17)","(22, 29)",8,91,69,168,8,61,30,99
352,0.1,"(0, 9)","(8, 14)",8,79,57,144,7,131,73,211
353,0.08,"(13, 12)","(18, 27)",4,106,80,190,10,61,48,119
354,0.18,"(24, 11)","(1, 4)",9,120,99,228,4,101,71,176
355,0.16,"(11, 11)","(13, 12)",4,56,30,90,9,1,9,19
356,0.06,"(16, 12)","(11, 6)",6,89,65,160,5,71,39,115
357,0.2,"(5, 7)","(23, 18)",11,104,85,200,9,101,79,189
358,0.06,"(19, 21)","(27, 20)",5,83,58,146,11,111,71,193
359,0.08,"(1, 29)","(7, 13)",2,71,43,116,2,71,34,107
360,0.14,"(15, 26)","(23, 26)",5,90,65,160,6,111,64,181
361,0.1,"(3, 21)","(16, 27)",3,142,115,260,7,121,79,207
362,0.06,"(12, 25)","(9, 19)",9,99,78,186,7,131,53,191
363,0.16,"(6, 20)","(15, 1)",10,103,83,196,15,191,167,373
364,0.06,"(15, 29)","(15, 1)",4,173,147,324,6,161,68,235
365,0.18,"(14, 25)","(9, 5)",7,98,75,180,11,81,55,147
366,0.1,"(23, 5)","(11, 23)",6,116,92,214,24,141,110,275
367,0.2,"(28, 15)","(22, 15)",5,36,11,52,4,111,41,156
368,0.04,"(22, 5)","(22, 12)",5,128,103,236,4,81,37,122
369,0.2,"(22, 10)","(14, 5)",8,113,91,212,7,91,47,145
370,0.18,"(17, 12)","(22, 12)",5,111,86,202,6,61,45,112
371,0.08,"(7, 17)","(23, 27)",6,123,99,228,13,111,77,201
372,0.12,"(29, 5)","(3, 14)",3,96,69,168,5,111,71,187
373,0.02,"(24, 6)","(6, 16)",8,178,156,342,13,281,178,472
374,0.16,"(10, 27)","(26, 16)",10,129,109,248,10,151,128,289
375,0.1,"(1, 26)","(22, 27)",3,95,68,166,10,101,65,176
376,0.02,"(19, 17)","(20, 14)",8,38,16,62,18,201,106,325
377,0.2,"(12, 3)","(2, 29)",7,115,92,214,11,121,76,208
378,0.16,"(8, 22)","(22, 18)",29,120,119,268,5,111,79,195
379,0.18,"(17, 1)","(19, 24)",5,117,92,214,6,101,78,185
380,0.02,"(4, 10)","(14, 19)",4,71,45,120,7,161,68,236
381,0.18,"(1, 13)","(19, 9)",7,121,98,226,9,111,88,208
382,0.2,"(10, 23)","(12, 21)",8,76,54,138,14,71,40,125
383,0.14,"(8, 21)","(19, 14)",9,130,109,248,7,61,47,115
384,0.12,"(28, 4)","(4, 15)",7,90,67,164,4,81,50,135
385,0.1,"(17, 3)","(15, 7)",7,60,37,104,11,41,28,80
386,0.18,"(8, 20)","(0, 10)",5,114,89,208,18,61,42,121
387,0.12,"(5, 6)","(14, 7)",9,107,86,202,3,91,41,135
388,0.02,"(18, 29)","(3, 2)",4,87,61,152,7,101,60,168
389,0.04,"(22, 18)","(2, 5)",11,132,113,256,10,81,46,137
390,0.1,"(11, 8)","(14, 28)",8,167,145,320,9,131,89,229
391,0.06,"(17, 9)","(24, 28)",11,127,108,246,3,141,95,239
392,0.18,"(14, 12)","(12, 28)",15,122,107,244,6,161,125,292
393,0.14,"(11, 2)","(26, 14)",8,139,117,264,12,121,81,214
394,0.2,"(13, 0)","(14, 24)",2,155,127,284,9,151,91,251
395,0.2,"(8, 19)","(5, 15)",11,55,36,102,8,61,39,108
396,0.04,"(8, 17)","(18, 16)",7,97,74,178,6,111,57,174
397,0.06,"(4, 13)","(2, 29)",5,86,61,152,7,131,54,192
398,0.1,"(0, 26)","(11, 12)",15,103,88,206,4,121,87,212
399,0.12,"(10, 16)","(29, 7)",5,155,130,290,6,91,51,148
400,0.02,"(6, 2)","(1, 29)",5,135,110,250,10,121,76,207
401,0.06,"(17, 10)","(23, 14)",9,94,73,176,10,131,74,215
402,0.16,"(24, 0)","(7, 20)",6,65,41,112,8,81,46,135
403,0.14,"(4, 24)","(10, 4)",8,107,85,200,15,121,91,227
404,0.1,"(25, 11)","(13, 8)",6,43,19,68,7,61,32,100
405,0.04,"(7, 17)","(18, 4)",14,72,56,142,15,121,86,222
406,0.14,"(2, 4)","(18, 13)",4,119,93,216,7,61,41,109
407,0.1,"(4, 9)","(7, 24)",11,67,48,126,11,91,63,165
408,0.16,"(26, 10)","(19, 21)",8,91,69,168,8,141,102,251
409,0.02,"(6, 19)","(8, 23)",5,105,80,190,13,71,30,114
410,0.08,"(19, 1)","(13, 16)",8,77,55,140,7,151,116,274
411,0.06,"(9, 3)","(18, 11)",7,84,61,152,5,151,89,245
412,0.06,"(17, 25)","(29, 22)",4,115,89,208,6,141,109,256
413,0.12,"(17, 0)","(3, 29)",10,136,116,262,17,91,76,184
414,0.2,"(6, 0)","(1, 6)",14,41,25,80,5,41,18,64
415,0.18,"(10, 27)","(4, 9)",12,154,136,302,3,111,53,167
416,0.16,"(20, 21)","(13, 21)",13,39,22,74,7,61,22,90
417,0.08,"(21, 20)","(13, 7)",8,79,57,144,7,61,41,109
418,0.04,"(16, 9)","(22, 6)",9,90,69,168,4,81,46,131
419,0.08,"(5, 25)","(21, 13)",8,125,103,236,6,131,72,209
420,0.2,"(22, 25)","(5, 14)",9,109,88,206,7,141,92,240
421,0.14,"(9, 25)","(21, 23)",6,90,66,162,7,111,61,179
422,0.08,"(25, 0)","(7, 29)",8,107,85,200,5,91,62,158
423,0.12,"(17, 12)","(4, 12)",14,61,45,120,7,51,29,87
424,0.1,"(3, 22)","(10, 5)",3,54,27,84,8,61,44,113
425,0.06,"(3, 15)","(5, 26)",15,89,74,178,5,111,68,184
426,0.16,"(28, 8)","(23, 22)",5,100,75,180,7,131,69,207
427,0.14,"(12, 3)","(26, 27)",4,82,56,142,15,121,92,228
428,0.06,"(21, 26)","(22, 12)",10,102,82,194,5,161,101,267
429,0.06,"(29, 13)","(29, 20)",7,151,128,286,10,81,33,124
430,0.16,"(3, 14)","(1, 21)",6,92,68,166,7,91,62,160
431,0.04,"(13, 23)","(16, 17)",5,127,102,234,4,121,67,192
432,0.18,"(29, 20)","(17, 13)",3,78,51,132,3,121,83,207
433,0.16,"(14, 17)","(9, 19)",12,79,61,152,10,51,20,81
434,0.14,"(28, 8)","(26, 28)",7,101,78,186,4,101,56,161
435,0.02,"(20, 26)","(24, 9)",8,170,148,326,9,261,165,435
436,0.14,"(22, 3)","(1, 16)",16,129,115,260,9,121,101,231
437,0.14,"(7, 9)","(25, 2)",8,119,97,224,5,131,93,229
438,0.16,"(14, 11)","(25, 21)",4,121,95,220,8,131,80,219
439,0.08,"(19, 19)","(29, 5)",6,138,114,258,8,161,128,297
440,0.12,"(9, 2)","(3, 4)",4,39,13,56,10,131,71,212
441,0.14,"(1, 0)","(1, 22)",3,184,157,344,14,131,96,241
442,0.08,"(20, 7)","(3, 26)",3,83,56,142,4,151,86,241
443,0.04,"(0, 20)","(10, 22)",2,79,51,132,3,121,74,198
444,0.12,"(25, 22)","(22, 19)",4,40,14,58,11,71,34,116
445,0.04,"(22, 6)","(27, 25)",9,132,111,252,12,191,138,341
446,0.12,"(28, 13)","(7, 2)",9,64,43,116,3,171,124,298
447,0.14,"(4, 3)","(11, 8)",9,61,40,110,4,51,34,89
448,0.2,"(9, 27)","(13, 27)",6,69,45,120,4,81,40,125
449,0.16,"(24, 26)","(17, 21)",7,100,77,184,6,91,42,139
450,0.02,"(21, 9)","(12, 18)",12,125,107,244,8,151,90,249
451,0.12,"(15, 10)","(0, 7)",4,78,52,134,4,81,42,127
452,0.1,"(27, 14)","(22, 13)",17,60,47,124,11,61,28,100
453,0.12,"(27, 11)","(27, 15)",5,56,31,92,3,51,17,71
454,0.08,"(25, 13)","(17, 25)",7,111,88,206,10,111,91,212
455,0.16,"(23, 14)","(14, 11)",6,67,43,116,5,71,55,131
456,0.02,"(15, 25)","(10, 12)",5,167,142,314,4,291,188,483
457,0.16,"(17, 29)","(17, 0)",4,104,78,186,9,81,62,152
458,0.16,"(8, 0)","(12, 10)",8,98,76,182,7,91,60,158
459,0.12,"(16, 25)","(20, 7)",9,120,99,228,13,141,117,271
460,0.02,"(12, 7)","(27, 7)",7,107,84,198,6,101,68,175
461,0.12,"(29, 20)","(12, 22)",6,67,43,116,8,111,62,181
462,0.16,"(17, 4)","(1, 3)",14,80,64,158,6,71,40,117
463,0.2,"(18, 12)","(21, 10)",11,73,54,138,13,91,60,164
464,0.18,"(18, 14)","(27, 5)",5,185,160,350,6,171,115,292
465,0.04,"(23, 25)","(25, 21)",9,98,77,184,4,101,38,143
466,0.18,"(5, 28)","(2, 24)",6,41,17,64,4,31,14,49
467,0.1,"(26, 8)","(12, 15)",5,79,54,138,7,171,125,303
468,0.18,"(22, 23)","(4, 21)",4,111,85,200,6,111,76,193
469,0.06,"(29, 21)","(21, 24)",9,72,51,132,13,111,39,163
470,0.08,"(25, 9)","(27, 0)",7,122,99,228,7,121,58,186
471,0.06,"(24, 25)","(22, 21)",3,76,49,128,9,71,32,112
472,0.06,"(26, 2)","(7, 7)",7,74,51,132,10,101,62,173
473,0.16,"(0, 7)","(26, 1)",7,118,95,220,4,171,138,313
474,0.12,"(16, 20)","(3, 15)",11,50,31,92,10,61,48,119
475,0.08,"(1, 24)","(16, 17)",3,94,67,164,16,121,92,229
476,0.1,"(11, 8)","(11, 17)",3,103,76,182,7,191,141,339
477,0.16,"(2, 6)","(6, 15)",17,54,41,112,4,91,45,140
478,0.1,"(7, 7)","(20, 29)",7,173,150,330,7,91,59,157
479,0.08,"(4, 8)","(0, 22)",14,97,81,192,4,111,82,197
480,0.14,"(26, 15)","(10, 8)",14,99,83,196,23,111,85,219
481,0.18,"(5, 6)","(18, 6)",5,96,71,172,13,131,85,229
482,0.1,"(9, 18)","(15, 23)",12,122,104,238,11,111,60,182
483,0.12,"(10, 21)","(5, 24)",12,51,33,96,9,61,29,99
484,0.14,"(8, 3)","(12, 10)",10,132,112,254,5,111,77,193
485,0.04,"(24, 1)","(26, 29)",11,115,96,222,7,101,74,182
486,0.12,"(12, 5)","(19, 18)",10,90,70,170,5,151,82,238
487,0.16,"(16, 14)","(19, 14)",15,57,42,114,6,121,85,212
488,0.08,"(6, 3)","(20, 21)",4,115,89,208,8,91,60,159
489,0.16,"(0, 23)","(27, 16)",4,143,117,264,4,151,103,258
490,0.14,"(23, 25)","(24, 29)",13,65,48,126,5,61,29,95
491,0.08,"(10, 13)","(20, 28)",12,97,79,188,5,121,54,180
492,0.2,"(17, 15)","(23, 0)",15,142,127,284,6,111,75,192
493,0.18,"(19, 24)","(12, 28)",9,44,23,76,6,81,39,126
494,0.14,"(0, 17)","(14, 16)",6,121,97,224,12,91,59,162
495,0.02,"(20, 10)","(16, 25)",10,129,109,248,4,111,90,205
496,0.04,"(15, 14)","(27, 19)",7,121,98,226,7,151,92,250
497,0.06,"(3, 3)","(13, 26)",10,75,55,140,3,181,85,269
498,0.2,"(12, 6)","(29, 14)",4,95,69,168,13,101,75,189
499,0.18,"(4, 13)","(10, 22)",3,102,75,180,6,61,38,105
500,0.18,"(15, 12)","(24, 0)",4,146,120,270,8,151,123,282
501,0.08,"(7, 10)","(20, 10)",7,86,63,156,10,111,77,198
502,0.14,"(29, 16)","(21, 18)",10,63,43,116,3,51,26,80
503,0.06,"(18, 21)","(9, 29)",23,96,89,208,6,111,46,163
504,0.1,"(29, 22)","(3, 24)",6,98,74,178,5,81,46,132
505,0.18,"(17, 20)","(29, 20)",7,121,98,226,7,71,57,135
506,0.12,"(29, 9)","(2, 21)",22,104,96,222,10,101,78,189
507,0.2,"(27, 13)","(28, 29)",6,87,63,156,4,141,121,266
508,0.02,"(5, 21)","(23, 7)",4,76,50,130,9,121,81,211
509,0.2,"(2, 15)","(20, 1)",6,141,117,264,20,161,160,341
510,0.08,"(2, 5)","(28, 14)",6,100,76,182,5,171,117,293
511,0.18,"(20, 18)","(26, 12)",10,155,135,300,7,121,76,204
512,0.1,"(10, 8)","(22, 14)",6,124,100,230,5,161,113,279
513,0.18,"(15, 4)","(14, 1)",9,49,28,86,8,71,31,110
514,0.18,"(22, 3)","(21, 17)",9,109,88,206,4,101,52,157
515,0.02,"(17, 28)","(4, 9)",7,65,42,114,3,191,120,314
516,0.04,"(9, 8)","(14, 20)",4,129,103,236,8,171,110,289
517,0.16,"(17, 26)","(0, 20)",4,65,39,108,7,61,38,106
518,0.18,"(13, 28)","(26, 28)",5,90,65,160,5,81,49,135
519,0.2,"(29, 14)","(24, 0)",4,107,81,192,3,141,92,236
520,0.08,"(4, 12)","(0, 18)",5,84,59,148,9,151,120,280
521,0.12,"(3, 27)","(13, 22)",5,99,74,178,8,81,51,140
522,0.08,"(17, 0)","(22, 16)",7,101,78,186,7,121,66,194
523,0.04,"(22, 8)","(19, 18)",15,99,84,198,9,121,73,203
524,0.14,"(12, 1)","(14, 16)",5,93,68,166,4,151,97,252
525,0.16,"(13, 4)","(27, 24)",12,115,97,224,6,91,68,165
526,0.06,"(3, 2)","(15, 23)",5,102,77,184,19,141,109,269
527,0.1,"(26, 7)","(9, 3)",11,69,50,130,13,131,96,240
528,0.2,"(13, 9)","(0, 27)",4,112,86,202,4,131,102,237
529,0.02,"(24, 7)","(7, 1)",3,66,39,108,8,121,72,201
530,0.02,"(0, 4)","(22, 13)",4,147,121,272,3,161,96,260
531,0.06,"(11, 15)","(11, 17)",5,35,10,50,7,31,8,46
532,0.12,"(21, 23)","(23, 13)",7,84,61,152,14,81,49,144
533,0.12,"(28, 27)","(25, 10)",10,166,146,322,17,91,73,181
534,0.08,"(20, 4)","(1, 28)",5,98,73,176,4,91,50,145
535,0.1,"(23, 0)","(29, 22)",3,149,122,274,6,101,68,175
536,0.2,"(5, 29)","(10, 12)",15,61,46,122,6,81,54,141
537,0.16,"(6, 22)","(15, 21)",7,78,55,140,6,91,53,150
538,0.18,"(19, 8)","(19, 5)",5,59,34,98,4,71,31,106
539,0.14,"(28, 0)","(23, 1)",4,33,7,44,21,71,37,129
540,0.16,"(19, 4)","(27, 3)",9,84,63,156,6,131,101,238
541,0.02,"(7, 21)","(6, 2)",12,143,125,280,9,221,127,357
542,0.08,"(24, 12)","(28, 13)",12,83,65,160,12,111,83,206
543,0.02,"(21, 3)","(16, 16)",8,82,60,150,13,121,51,185
544,0.1,"(5, 21)","(19, 23)",6,137,113,256,13,91,80,184
545,0.2,"(11, 3)","(12, 4)",7,48,25,80,6,41,9,56
546,0.08,"(12, 20)","(12, 2)",14,158,142,314,5,101,66,172
547,0.12,"(19, 19)","(15, 26)",5,97,72,174,3,61,42,106
548,0.06,"(15, 10)","(27, 25)",9,146,125,280,5,101,59,165
549,0.12,"(16, 28)","(22, 15)",6,130,106,242,4,151,118,273
550,0.14,"(6, 26)","(12, 6)",6,103,79,188,4,131,89,224
551,0.06,"(19, 7)","(2, 24)",21,67,58,146,11,151,83,245
552,0.04,"(4, 12)","(26, 24)",10,104,84,198,7,161,109,277
553,0.18,"(7, 25)","(29, 13)",8,91,69,168,9,201,183,393
554,0.18,"(20, 24)","(8, 10)",8,101,79,188,8,101,86,195
555,0.1,"(21, 1)","(7, 18)",12,98,80,190,8,171,113,292
556,0.04,"(24, 6)","(15, 23)",7,111,88,206,4,141,94,239
557,0.02,"(2, 9)","(21, 29)",7,88,65,160,6,161,105,272
558,0.04,"(15, 25)","(14, 3)",4,80,54,138,12,111,81,204
559,0.18,"(27, 1)","(15, 17)",13,139,122,274,11,101,69,181
560,0.12,"(12, 25)","(6, 25)",3,49,22,74,7,61,19,87
561,0.18,"(15, 23)","(11, 22)",9,50,29,88,12,41,20,73
562,0.06,"(7, 14)","(15, 15)",3,116,89,208,7,101,53,161
563,0.16,"(25, 9)","(4, 9)",6,106,82,194,8,171,127,306
564,0.14,"(25, 11)","(1, 2)",4,87,61,152,6,71,56,133
565,0.14,"(15, 29)","(27, 19)",6,114,90,210,9,111,75,195
566,0.16,"(9, 4)","(14, 26)",5,125,100,230,3,101,75,179
567,0.04,"(10, 10)","(25, 13)",6,179,155,340,7,91,51,149
568,0.1,"(3, 1)","(4, 1)",3,32,5,40,5,51,10,66
569,0.1,"(13, 22)","(10, 7)",6,69,45,120,9,121,97,227
570,0.1,"(25, 15)","(22, 16)",10,42,22,74,5,51,14,70
571,0.2,"(17, 21)","(2, 9)",4,83,57,144,17,91,53,161
572,0.16,"(11, 1)","(29, 25)",7,128,105,240,4,91,54,149
573,0.08,"(17, 1)","(9, 20)",3,82,55,140,7,141,113,261
574,0.1,"(20, 27)","(25, 11)",8,131,109,248,5,161,117,283
575,0.06,"(7, 18)","(25, 21)",6,146,122,274,24,151,129,304
576,0.18,"(9, 27)","(10, 14)",8,111,89,208,11,81,63,155
577,0.12,"(25, 20)","(13, 8)",4,103,77,184,4,71,46,121
578,0.06,"(19, 7)","(23, 5)",11,86,67,164,13,131,56,200
579,0.08,"(1, 6)","(14, 13)",11,102,83,196,7,171,124,302
580,0.1,"(20, 15)","(24, 8)",12,138,120,270,5,61,32,98
581,0.16,"(28, 8)","(3, 27)",6,78,54,138,6,111,79,196
582,0.18,"(0, 1)","(29, 21)",9,99,78,186,8,151,122,281
583,0.02,"(14, 21)","(20, 17)",17,150,137,304,10,281,169,460
584,0.16,"(6, 0)","(6, 11)",12,65,47,124,7,41,25,73
585,0.02,"(21, 23)","(28, 23)",5,78,53,136,6,111,51,168
586,0.14,"(12, 19)","(1, 3)",8,103,81,192,6,131,91,228
587,0.02,"(6, 11)","(2, 5)",13,123,106,242,5,31,15,51
588,0.06,"(11, 1)","(5, 24)",5,83,58,146,4,211,133,348
589,0.2,"(8, 20)","(14, 9)",4,116,90,210,6,161,122,289
590,0.02,"(14, 7)","(9, 16)",14,116,100,230,7,241,176,424
591,0.2,"(15, 24)","(16, 8)",5,128,103,236,6,111,79,196
592,0.1,"(15, 11)","(26, 29)",9,112,91,212,3,101,75,179
593,0.1,"(15, 14)","(17, 17)",6,62,38,106,7,71,45,123
594,0.16,"(12, 11)","(10, 0)",5,114,89,208,4,151,94,249
595,0.12,"(28, 7)","(8, 9)",4,146,120,270,5,111,73,189
596,0.06,"(3, 8)","(27, 15)",13,131,114,258,14,121,81,216
597,0.16,"(15, 11)","(18, 6)",23,58,51,132,8,81,52,141
598,0.1,"(17, 13)","(4, 7)",14,88,72,174,3,61,26,90
599,0.12,"(6, 27)","(14, 20)",10,70,50,130,3,81,49,133
600,0.08,"(28, 9)","(14, 27)",11,120,101,232,8,101,57,166
601,0.14,"(6, 2)","(4, 3)",6,43,19,68,5,31,9,45
602,0.18,"(12, 24)","(13, 20)",5,82,57,144,8,81,49,138
603,0.02,"(5, 3)","(28, 23)",6,169,145,320,16,91,72,179
604,0.1,"(27, 1)","(16, 28)",7,139,116,262,9,101,69,179
605,0.06,"(17, 20)","(19, 6)",3,104,77,184,6,151,95,252
606,0.14,"(13, 20)","(29, 8)",3,73,46,122,5,151,108,264
607,0.14,"(23, 11)","(6, 15)",5,133,108,246,6,111,80,197
608,0.1,"(10, 21)","(9, 16)",6,81,57,144,3,101,40,144
609,0.16,"(13, 29)","(14, 23)",13,72,55,140,8,51,17,76
610,0.18,"(0, 6)","(17, 16)",3,110,83,196,10,171,125,306
611,0.1,"(9, 13)","(6, 7)",4,88,62,154,6,121,66,193
612,0.18,"(26, 1)","(18, 7)",15,56,41,112,8,71,43,122
613,0.06,"(20, 11)","(29, 20)",6,136,112,254,5,111,90,206
614,0.02,"(20, 4)","(9, 5)",11,85,66,162,8,171,82,261
615,0.02,"(18, 5)","(25, 3)",4,127,101,232,7,191,120,318
616,0.14,"(18, 27)","(24, 25)",6,103,79,188,7,71,42,120
617,0.1,"(7, 10)","(23, 26)",8,74,52,134,9,121,87,217
618,0.2,"(3, 29)","(6, 20)",21,49,40,110,34,61,61,156
619,0.2,"(3, 11)","(13, 5)",9,181,160,350,4,181,130,315
620,0.12,"(17, 8)","(17, 23)",6,143,119,268,30,191,149,370
621,0.18,"(9, 10)","(0, 0)",8,221,199,428,9,181,163,353
622,0.2,"(7, 0)","(8, 18)",11,141,122,274,8,121,94,223
623,0.12,"(25, 8)","(14, 8)",5,63,38,106,6,41,24,71
624,0.08,"(4, 21)","(7, 19)",11,100,81,192,4,81,41,126
625,0.12,"(22, 21)","(29, 27)",4,93,67,164,5,121,77,203
626,0.06,"(11, 9)","(28, 1)",23,148,141,312,14,191,122,327
627,0.16,"(22, 20)","(3, 28)",15,101,86,202,5,161,126,292
628,0.08,"(7, 11)","(1, 9)",7,45,22,74,4,81,38,123
629,0.18,"(15, 18)","(11, 4)",10,79,59,148,4,101,39,144
630,0.12,"(9, 2)","(7, 24)",4,137,111,252,9,91,73,173
631,0.04,"(6, 19)","(9, 1)",5,105,80,190,6,111,60,177
632,0.02,"(10, 0)","(7, 29)",7,213,190,410,4,141,104,249
633,0.02,"(28, 11)","(8, 16)",8,114,92,214,4,271,149,424
634,0.02,"(23, 17)","(21, 14)",7,39,16,62,4,141,43,188
635,0.1,"(1, 1)","(26, 25)",3,116,89,208,8,141,86,235
636,0.1,"(19, 3)","(25, 11)",6,126,102,234,11,111,60,182
637,0.02,"(0, 17)","(6, 12)",9,167,146,322,11,251,111,373
638,0.2,"(5, 10)","(24, 16)",20,107,97,224,6,211,170,387
639,0.06,"(3, 14)","(26, 14)",7,119,96,222,6,111,58,175
640,0.1,"(6, 27)","(16, 15)",5,114,89,208,2,101,66,169
641,0.1,"(20, 29)","(17, 28)",6,36,12,54,2,41,12,55
642,0.1,"(13, 2)","(9, 19)",8,73,51,132,12,151,92,255
643,0.08,"(21, 6)","(8, 7)",6,75,51,132,10,151,137,298
644,0.04,"(7, 10)","(20, 29)",7,63,40,110,10,181,150,341
645,0.02,"(25, 22)","(25, 16)",7,107,84,198,5,241,105,351
646,0.06,"(25, 16)","(9, 21)",3,123,96,222,4,91,58,153
647,0.1,"(10, 3)","(28, 17)",5,104,79,188,9,141,81,231
648,0.02,"(2, 24)","(2, 9)",4,113,87,204,3,141,51,195
649,0.18,"(3, 5)","(22, 6)",9,164,143,316,4,111,73,188
650,0.12,"(12, 13)","(19, 22)",12,91,73,176,7,101,59,167
651,0.08,"(16, 25)","(19, 24)",3,66,39,108,14,71,30,115
652,0.04,"(16, 21)","(6, 18)",5,132,107,244,2,91,42,135
653,0.02,"(21, 20)","(4, 17)",4,172,146,322,4,211,165,380
654,0.14,"(8, 27)","(15, 4)",5,154,129,288,16,171,125,312
655,0.12,"(3, 29)","(20, 17)",4,113,87,204,3,141,96,240
656,0.18,"(19, 4)","(4, 1)",4,72,46,122,7,71,42,120
657,0.18,"(9, 2)","(13, 6)",7,93,70,170,10,101,76,187
658,0.06,"(4, 24)","(22, 20)",6,95,71,172,10,151,90,251
659,0.18,"(13, 19)","(3, 7)",6,187,163,356,6,121,86,213
660,0.16,"(13, 11)","(6, 21)",7,86,63,156,8,71,45,124
661,0.2,"(6, 3)","(24, 11)",18,124,112,254,14,111,87,212
662,0.2,"(15, 5)","(20, 17)",4,48,22,74,5,121,89,215
663,0.06,"(11, 0)","(17, 18)",13,125,108,246,5,171,101,277
664,0.1,"(9, 16)","(2, 5)",7,105,82,194,9,81,37,127
665,0.08,"(24, 2)","(24, 26)",4,115,89,208,15,81,64,160
666,0.16,"(8, 2)","(24, 13)",7,218,195,420,9,121,73,203
667,0.16,"(20, 11)","(27, 7)",9,178,157,344,6,111,83,200
668,0.18,"(16, 2)","(1, 2)",24,91,85,200,4,71,28,103
669,0.18,"(26, 21)","(23, 9)",6,75,51,132,9,141,97,247
670,0.02,"(12, 17)","(5, 1)",4,212,186,402,12,81,41,134
671,0.18,"(13, 24)","(9, 26)",8,60,38,106,5,51,28,84
672,0.04,"(27, 29)","(20, 18)",5,82,57,144,8,161,84,253
673,0.1,"(7, 20)","(4, 9)",7,93,70,170,5,121,73,199
674,0.18,"(18, 20)","(24, 21)",9,73,52,134,7,71,45,123
675,0.1,"(15, 19)","(9, 12)",13,79,62,154,9,101,63,173
676,0.08,"(27, 10)","(17, 26)",16,108,94,218,8,161,100,269
677,0.14,"(12, 17)","(25, 25)",10,124,104,238,18,81,70,169
678,0.04,"(8, 3)","(25, 29)",11,92,73,176,9,101,67,177
679,0.06,"(26, 29)","(6, 13)",6,109,85,200,3,181,107,291
680,0.2,"(18, 8)","(19, 3)",9,73,52,134,6,91,61,158
681,0.02,"(19, 19)","(22, 13)",4,151,125,280,5,101,31,137
682,0.04,"(29, 15)","(0, 8)",5,79,54,138,6,111,57,174
683,0.1,"(2, 24)","(19, 7)",3,119,92,214,9,171,115,295
684,0.04,"(9, 26)","(7, 22)",13,39,22,74,21,61,48,130
685,0.02,"(5, 13)","(29, 28)",6,71,47,124,15,81,58,154
686,0.14,"(16, 10)","(7, 29)",5,96,71,172,8,111,59,178
687,0.16,"(20, 10)","(26, 5)",4,100,74,178,7,111,74,192
688,0.04,"(16, 20)","(4, 23)",6,90,66,162,5,121,63,189
689,0.06,"(1, 13)","(28, 27)",6,105,81,192,4,91,58,153
690,0.2,"(25, 13)","(18, 8)",15,39,24,78,5,101,52,158
691,0.14,"(7, 14)","(12, 3)",10,75,55,140,12,121,87,220
692,0.12,"(29, 29)","(5, 25)",5,91,66,162,5,191,122,318
693,0.14,"(22, 2)","(9, 24)",4,93,67,164,8,91,77,176
694,0.08,"(11, 21)","(13, 16)",6,66,42,114,3,81,41,125
695,0.12,"(20, 27)","(22, 13)",19,111,100,230,28,131,103,262
696,0.14,"(20, 9)","(20, 16)",15,77,62,154,14,101,80,195
697,0.02,"(17, 23)","(6, 2)",7,80,57,144,23,161,129,313
698,0.02,"(26, 22)","(11, 21)",4,97,71,172,4,131,80,215
699,0.18,"(14, 11)","(18, 14)",5,98,73,176,10,61,47,118
700,0.2,"(23, 23)","(8, 4)",4,89,63,156,8,81,52,141
701,0.06,"(20, 3)","(1, 14)",16,68,54,138,6,141,82,229
702,0.16,"(28, 7)","(16, 2)",5,75,50,130,9,111,71,191
703,0.02,"(15, 6)","(18, 22)",3,141,114,258,8,151,105,264
704,0.18,"(8, 29)","(19, 5)",4,92,66,162,7,91,65,163
705,0.02,"(28, 15)","(23, 3)",7,86,63,156,15,231,125,371
706,0.04,"(28, 17)","(18, 4)",5,79,54,138,5,221,111,337
707,0.06,"(21, 27)","(23, 4)",13,175,158,346,9,111,68,188
708,0.02,"(4, 2)","(8, 22)",12,176,158,346,7,191,108,306
709,0.18,"(28, 7)","(29, 13)",7,45,22,74,14,61,46,121
710,0.06,"(3, 17)","(19, 22)",4,149,123,276,9,111,62,182
711,0.18,"(29, 8)","(26, 17)",5,102,77,184,27,81,81,189
712,0.18,"(24, 4)","(20, 22)",5,118,93,216,3,111,76,190
713,0.04,"(25, 17)","(26, 6)",8,128,106,242,6,81,57,144
714,0.16,"(28, 2)","(24, 19)",10,103,83,196,6,161,122,289
715,0.1,"(19, 20)","(29, 0)",5,117,92,214,4,101,84,189
716,0.12,"(21, 4)","(19, 29)",7,109,86,202,4,161,121,286
717,0.18,"(20, 17)","(16, 15)",5,49,24,78,6,31,13,50
718,0.06,"(0, 6)","(27, 5)",9,132,111,252,10,131,85,226
719,0.08,"(8, 5)","(0, 6)",8,41,19,68,8,61,25,94
720,0.14,"(10, 2)","(9, 2)",7,31,8,46,4,71,18,93
721,0.16,"(27, 26)","(11, 5)",15,67,52,134,13,121,104,238
722,0.02,"(29, 26)","(11, 9)",3,105,78,186,6,331,178,515
723,0.04,"(19, 22)","(7, 18)",7,56,33,96,10,171,119,300
724,0.16,"(17, 19)","(5, 12)",4,46,20,70,4,81,48,133
725,0.06,"(1, 5)","(11, 10)",7,78,55,140,5,131,60,196
726,0.06,"(28, 7)","(4, 8)",12,87,69,168,6,121,89,216
727,0.08,"(3, 21)","(19, 4)",14,66,50,130,5,151,102,258
728,0.1,"(10, 16)","(23, 10)",10,85,65,160,5,131,89,225
729,0.2,"(5, 16)","(8, 3)",9,65,44,118,11,91,50,152
730,0.08,"(2, 19)","(15, 21)",6,101,77,184,7,131,74,212
731,0.06,"(18, 2)","(0, 8)",8,61,39,108,8,81,54,143
732,0.12,"(7, 6)","(8, 27)",6,163,139,308,6,141,110,257
733,0.02,"(13, 10)","(10, 4)",9,133,112,254,7,291,140,438
734,0.06,"(17, 4)","(1, 25)",4,106,80,190,7,131,100,238
735,0.04,"(24, 11)","(20, 19)",11,72,53,136,6,171,91,268
736,0.08,"(3, 27)","(14, 14)",9,146,125,280,4,101,64,169
737,0.14,"(21, 22)","(23, 6)",7,113,90,210,10,121,101,232
738,0.08,"(24, 16)","(12, 22)",10,64,44,118,4,101,65,170
739,0.2,"(17, 29)","(29, 10)",7,146,123,276,6,151,107,264
740,0.14,"(6, 2)","(17, 4)",4,93,67,164,5,71,40,116
741,0.02,"(4, 6)","(1, 12)",8,63,41,112,14,71,34,119
742,0.16,"(17, 4)","(22, 11)",5,122,97,224,6,91,46,143
743,0.2,"(24, 28)","(12, 12)",2,136,108,246,27,81,79,187
744,0.14,"(9, 17)","(23, 10)",5,51,26,82,8,151,115,274
745,0.2,"(0, 20)","(28, 27)",7,112,89,208,9,101,84,194
746,0.16,"(9, 20)","(3, 16)",8,81,59,148,12,91,38,141
747,0.04,"(5, 7)","(8, 14)",14,78,62,154,6,111,67,184
748,0.02,"(20, 27)","(2, 27)",5,122,97,224,8,321,210,539
749,0.16,"(13, 28)","(2, 22)",6,124,100,230,5,91,53,149
750,0.06,"(13, 12)","(10, 10)",4,43,17,64,5,141,63,209
751,0.1,"(27, 6)","(7, 14)",6,99,75,180,10,61,50,121
752,0.12,"(5, 17)","(29, 6)",53,79,102,234,29,91,91,211
753,0.2,"(28, 16)","(15, 1)",3,109,82,194,8,71,54,133
754,0.14,"(25, 18)","(25, 14)",6,68,44,118,8,51,28,87
755,0.14,"(18, 5)","(26, 18)",17,152,139,308,4,91,69,164
756,0.06,"(23, 0)","(6, 19)",4,146,120,270,13,181,135,329
757,0.2,"(2, 21)","(14, 6)",8,157,135,300,6,71,48,125
758,0.14,"(16, 6)","(10, 23)",18,101,89,208,10,101,70,181
759,0.14,"(17, 1)","(29, 13)",5,144,119,268,6,101,66,173
760,0.02,"(20, 25)","(22, 29)",4,120,94,218,2,161,58,221
761,0.14,"(24, 24)","(15, 19)",4,70,44,118,3,111,53,167
762,0.16,"(5, 13)","(22, 25)",5,84,59,148,6,111,84,201
763,0.06,"(15, 2)","(15, 10)",14,66,50,130,7,111,63,181
764,0.2,"(2, 20)","(2, 21)",22,36,28,86,5,1,5,11
765,0.16,"(21, 22)","(14, 11)",6,76,52,134,7,131,111,249
766,0.16,"(0, 2)","(10, 15)",6,153,129,288,8,131,76,215
767,0.14,"(25, 6)","(0, 18)",16,100,86,202,9,101,68,178
768,0.1,"(0, 27)","(12, 26)",7,77,54,138,6,71,39,116
769,0.14,"(20, 24)","(24, 8)",7,151,128,286,8,101,82,191
770,0.14,"(18, 6)","(4, 28)",5,84,59,148,8,141,83,232
771,0.18,"(3, 18)","(26, 11)",3,91,64,158,5,121,59,185
772,0.16,"(22, 23)","(9, 0)",4,111,85,200,5,111,78,194
773,0.04,"(0, 8)","(29, 10)",6,137,113,256,15,151,78,244
774,0.2,"(13, 21)","(26, 23)",21,119,110,250,19,91,73,183
775,0.16,"(19, 8)","(29, 13)",6,144,120,270,5,111,70,186
776,0.12,"(17, 26)","(11, 9)",9,173,152,334,12,131,63,206
777,0.1,"(23, 20)","(14, 16)",9,44,23,76,21,101,56,178
778,0.08,"(21, 0)","(27, 3)",20,82,72,174,6,91,60,157
779,0.18,"(16, 3)","(5, 14)",11,53,34,98,7,101,57,165
780,0.12,"(17, 6)","(6, 25)",10,75,55,140,7,121,65,193
781,0.16,"(25, 22)","(1, 4)",8,74,52,134,7,111,77,195
782,0.18,"(9, 24)","(11, 17)",10,109,89,208,7,91,48,146
783,0.12,"(18, 27)","(27, 3)",7,131,108,246,10,121,74,205
784,0.08,"(2, 29)","(12, 1)",8,102,80,190,6,131,91,228
785,0.12,"(8, 5)","(26, 8)",9,147,126,282,12,131,80,223
786,0.18,"(24, 29)","(4, 0)",15,100,85,200,15,101,85,201
787,0.2,"(4, 28)","(27, 1)",8,78,56,142,7,71,57,135
788,0.06,"(24, 9)","(1, 15)",5,97,72,174,8,211,149,368
789,0.18,"(28, 5)","(25, 10)",6,60,36,102,13,111,63,187
790,0.1,"(6, 7)","(26, 21)",17,118,105,240,11,101,64,176
791,0.12,"(4, 29)","(8, 10)",3,99,72,174,10,171,95,276
792,0.06,"(1, 9)","(16, 15)",6,110,86,202,4,91,41,136
793,0.06,"(14, 28)","(19, 14)",8,144,122,274,6,121,81,208
794,0.14,"(7, 23)","(15, 14)",12,162,144,318,12,61,51,124
795,0.2,"(29, 2)","(8, 4)",7,140,117,264,7,111,71,189
796,0.18,"(24, 22)","(22, 17)",12,70,52,134,9,91,50,150
797,0.1,"(11, 21)","(15, 10)",12,107,89,208,10,131,64,205
798,0.08,"(22, 8)","(17, 20)",6,75,51,132,9,121,61,191
799,0.04,"(1, 0)","(24, 23)",6,133,109,248,11,131,85,227
800,0.04,"(10, 1)","(2, 19)",8,55,33,96,7,81,38,126
801,0.1,"(25, 6)","(29, 1)",10,66,46,122,4,91,51,146
802,0.16,"(26, 10)","(11, 29)",5,87,62,154,6,131,78,215
803,0.16,"(6, 6)","(27, 20)",17,90,77,184,3,121,81,205
804,0.08,"(6, 27)","(17, 29)",3,74,47,124,5,91,44,140
805,0.2,"(16, 5)","(27, 16)",8,153,131,292,8,91,70,169
806,0.18,"(29, 26)","(4, 24)",5,139,114,258,6,111,81,198
807,0.14,"(2, 27)","(7, 12)",9,74,53,136,9,61,38,108
808,0.16,"(2, 9)","(5, 7)",5,97,72,174,7,111,54,172
809,0.12,"(17, 18)","(25, 3)",5,211,186,402,5,101,65,171
810,0.12,"(29, 8)","(8, 1)",4,95,69,168,5,131,80,216
811,0.04,"(21, 0)","(29, 9)",4,109,83,196,8,151,115,274
812,0.1,"(25, 29)","(9, 0)",15,121,106,242,9,91,69,169
813,0.08,"(16, 6)","(24, 10)",6,69,45,120,9,121,81,211
814,0.02,"(6, 21)","(2, 7)",4,48,22,74,4,141,87,232
815,0.02,"(14, 26)","(20, 1)",8,154,132,294,10,211,165,386
816,0.06,"(4, 24)","(19, 2)",8,141,119,268,12,91,51,154
817,0.04,"(1, 24)","(5, 0)",11,76,57,144,7,121,87,215
818,0.16,"(21, 14)","(18, 18)",11,101,82,194,4,91,37,132
819,0.06,"(18, 5)","(19, 17)",17,166,153,336,6,111,96,213
820,0.2,"(22, 25)","(17, 5)",5,151,126,282,6,181,143,330
821,0.02,"(3, 22)","(12, 27)",6,145,121,272,13,101,51,165
822,0.12,"(25, 10)","(22, 29)",11,136,117,264,5,91,65,161
823,0.1,"(20, 25)","(15, 8)",3,154,127,284,4,111,56,171
824,0.2,"(9, 27)","(12, 7)",29,109,108,246,8,141,111,260
825,0.12,"(11, 1)","(24, 12)",9,104,83,196,9,111,79,199
826,0.06,"(1, 20)","(25, 3)",9,81,60,150,4,101,58,163
827,0.16,"(26, 2)","(0, 27)",5,82,57,144,25,101,83,209
828,0.18,"(26, 19)","(10, 17)",15,79,64,158,7,81,38,126
829,0.1,"(15, 19)","(21, 27)",5,90,65,160,7,91,47,145
830,0.06,"(21, 21)","(20, 22)",7,33,10,50,4,51,11,66
831,0.16,"(19, 21)","(16, 28)",14,74,58,146,15,51,31,97
832,0.06,"(24, 3)","(1, 23)",7,88,65,160,14,71,55,140
833,0.02,"(13, 17)","(13, 13)",27,163,160,350,13,141,60,214
834,0.02,"(10, 7)","(13, 0)",5,247,222,474,24,161,77,262
835,0.18,"(26, 14)","(5, 16)",6,96,72,174,5,171,153,329
836,0.02,"(27, 23)","(20, 26)",14,179,163,356,9,51,34,94
837,0.06,"(8, 13)","(12, 23)",9,124,103,236,5,131,47,183
838,0.06,"(16, 22)","(12, 29)",8,78,56,142,4,61,35,100
839,0.08,"(23, 28)","(23, 16)",4,83,57,144,5,81,48,134
840,0.02,"(22, 24)","(3, 23)",6,82,58,146,6,221,109,336
841,0.2,"(24, 17)","(19, 24)",3,63,36,102,3,81,42,126
842,0.12,"(7, 10)","(23, 24)",12,104,86,202,7,81,56,144
843,0.2,"(28, 29)","(4, 11)",15,131,116,262,13,101,86,200
844,0.06,"(0, 23)","(14, 1)",14,88,72,174,21,131,86,238
845,0.16,"(5, 2)","(11, 24)",5,138,113,256,10,151,105,266
846,0.06,"(7, 23)","(11, 27)",15,79,64,158,10,201,128,339
847,0.08,"(16, 5)","(19, 0)",28,89,87,204,20,71,49,140
848,0.06,"(10, 26)","(6, 6)",16,137,123,276,6,191,133,330
849,0.1,"(19, 19)","(24, 27)",3,93,66,162,6,161,120,287
850,0.14,"(25, 7)","(5, 11)",5,72,47,124,10,81,66,157
851,0.1,"(19, 28)","(9, 5)",5,113,88,206,3,131,75,209
852,0.08,"(23, 0)","(19, 29)",7,104,81,192,5,111,69,185
853,0.06,"(23, 25)","(11, 0)",4,103,77,184,8,91,69,168
854,0.14,"(25, 25)","(9, 9)",7,107,84,198,8,161,104,273
855,0.04,"(12, 10)","(3, 17)",7,129,106,242,7,171,85,263
856,0.2,"(26, 9)","(14, 16)",12,93,75,180,5,111,80,196
857,0.06,"(20, 26)","(4, 18)",8,104,82,194,15,101,65,181
858,0.16,"(16, 20)","(4, 29)",9,137,116,262,5,131,108,244
859,0.1,"(12, 19)","(20, 10)",12,213,195,420,8,91,65,164
860,0.02,"(15, 22)","(23, 29)",5,180,155,340,3,251,142,396
861,0.18,"(19, 20)","(5, 23)",5,51,26,82,13,131,71,215
862,0.04,"(19, 6)","(27, 23)",4,197,171,372,4,181,97,282
863,0.08,"(29, 8)","(1, 20)",3,133,106,242,7,161,97,265
864,0.16,"(29, 26)","(18, 19)",3,67,40,110,9,81,49,139
865,0.02,"(13, 7)","(9, 21)",7,173,150,330,10,121,79,210
866,0.04,"(23, 14)","(3, 5)",4,84,58,146,7,151,78,236
867,0.1,"(26, 10)","(10, 8)",4,51,25,80,4,131,77,212
868,0.02,"(9, 16)","(23, 12)",9,105,84,198,18,181,85,284
869,0.18,"(8, 9)","(5, 3)",8,57,35,100,29,61,52,142
870,0.2,"(28, 16)","(16, 10)",7,70,47,124,17,101,61,179
871,0.12,"(26, 10)","(21, 9)",13,38,21,72,4,31,12,47
872,0.02,"(20, 3)","(20, 20)",7,111,88,206,9,81,66,156
873,0.18,"(23, 8)","(3, 4)",5,107,82,194,7,91,77,175
874,0.08,"(4, 9)","(27, 25)",9,81,60,150,10,131,72,213
875,0.04,"(16, 17)","(12, 6)",11,80,61,152,10,111,67,188
876,0.14,"(8, 1)","(1, 15)",8,70,48,126,3,41,23,67
877,0.12,"(8, 19)","(9, 10)",9,100,79,188,15,91,70,176
878,0.1,"(13, 0)","(17, 11)",9,83,62,154,8,101,49,158
879,0.04,"(24, 2)","(17, 8)",5,93,68,166,5,121,60,186
880,0.1,"(5, 4)","(22, 21)",12,155,137,304,9,101,72,182
881,0.12,"(24, 27)","(5, 4)",4,91,65,160,7,161,104,272
882,0.02,"(15, 24)","(22, 1)",9,206,185,400,4,141,74,219
883,0.04,"(17, 14)","(21, 15)",11,44,25,80,9,91,37,137
884,0.18,"(13, 26)","(0, 27)",5,55,30,90,9,51,22,82
885,0.16,"(25, 12)","(12, 6)",4,73,47,124,19,111,92,222
886,0.06,"(9, 14)","(25, 7)",7,115,92,214,3,101,69,173
887,0.2,"(19, 5)","(19, 12)",7,80,57,144,5,71,52,128
888,0.06,"(22, 3)","(21, 20)",8,126,104,238,4,141,99,244
889,0.18,"(3, 22)","(3, 12)",4,72,46,122,7,71,23,101
890,0.06,"(28, 22)","(7, 15)",4,80,54,138,6,91,68,165
891,0.12,"(5, 0)","(17, 25)",8,63,41,112,4,121,82,207
892,0.08,"(14, 21)","(6, 16)",5,153,128,286,7,121,54,182
893,0.06,"(28, 1)","(29, 16)",2,126,98,226,10,101,49,160
894,0.12,"(6, 7)","(8, 22)",7,88,65,160,8,201,136,345
895,0.04,"(20, 23)","(17, 9)",4,84,58,146,9,101,62,172
896,0.12,"(10, 5)","(9, 20)",6,77,53,136,10,81,45,136
897,0.18,"(19, 19)","(9, 26)",19,66,55,140,7,101,63,171
898,0.14,"(2, 21)","(18, 17)",5,90,65,160,8,91,53,152
899,0.16,"(1, 23)","(15, 2)",9,100,79,188,8,61,42,111
900,0.12,"(3, 5)","(8, 13)",12,110,92,214,7,111,65,183
901,0.04,"(2, 11)","(8, 14)",2,95,67,164,8,131,60,199
902,0.04,"(25, 0)","(9, 15)",16,96,82,194,6,141,95,242
903,0.02,"(1, 23)","(29, 5)",3,168,141,312,8,171,81,260
904,0.18,"(10, 8)","(9, 28)",9,138,117,264,7,91,52,150
905,0.04,"(3, 25)","(27, 13)",6,134,110,250,5,121,82,208
906,0.14,"(8, 29)","(10, 10)",6,116,92,214,4,91,65,160
907,0.18,"(8, 29)","(10, 23)",6,67,43,116,14,71,45,130
908,0.16,"(11, 0)","(19, 7)",9,104,83,196,8,91,55,154
909,0.12,"(19, 10)","(29, 16)",10,122,102,234,5,151,100,256
910,0.16,"(19, 10)","(0, 22)",8,111,89,208,4,71,36,111
911,0.06,"(20, 6)","(4, 22)",8,100,78,186,3,221,161,385
912,0.14,"(7, 11)","(18, 23)",20,104,94,218,28,91,77,196
913,0.06,"(12, 11)","(18, 9)",8,69,47,124,5,181,106,292
914,0.04,"(19, 9)","(11, 25)",11,82,63,156,5,201,147,353
915,0.06,"(18, 0)","(8, 14)",5,72,47,124,5,131,72,208
916,0.14,"(29, 19)","(9, 24)",13,174,157,344,18,81,53,152
917,0.16,"(22, 17)","(27, 28)",3,137,110,250,4,91,53,148
918,0.2,"(28, 23)","(1, 18)",6,121,97,224,6,141,95,242
919,0.16,"(6, 10)","(19, 5)",24,125,119,268,13,121,94,228
920,0.16,"(23, 27)","(29, 1)",26,170,166,362,9,121,93,223
921,0.18,"(16, 26)","(16, 4)",6,147,123,276,4,131,99,234
922,0.16,"(4, 28)","(11, 24)",8,88,66,162,9,81,61,151
923,0.04,"(19, 7)","(29, 14)",8,113,91,212,23,201,118,342
924,0.04,"(19, 29)","(25, 12)",4,134,108,246,6,71,55,132
925,0.2,"(26, 0)","(22, 17)",12,149,131,292,7,121,76,204
926,0.06,"(23, 7)","(17, 23)",9,158,137,304,10,161,102,273
927,0.16,"(7, 18)","(16, 18)",12,89,71,172,9,111,71,191
928,0.16,"(24, 7)","(3, 4)",6,132,108,246,7,111,71,189
929,0.08,"(24, 7)","(12, 13)",4,85,59,148,5,81,62,148
930,0.1,"(21, 27)","(24, 13)",6,143,119,268,8,221,181,410
931,0.18,"(2, 14)","(7, 29)",11,129,110,250,11,91,55,157
932,0.16,"(2, 1)","(5, 22)",5,143,118,266,5,101,57,163
933,0.14,"(10, 19)","(9, 0)",4,175,149,328,3,131,86,220
934,0.18,"(13, 19)","(24, 8)",5,83,58,146,8,181,134,323
935,0.04,"(15, 15)","(5, 26)",8,72,50,130,8,151,120,279
936,0.08,"(0, 25)","(10, 16)",7,135,112,254,5,121,67,193
937,0.14,"(11, 26)","(14, 20)",9,96,75,180,8,91,55,154
938,0.08,"(29, 20)","(14, 4)",5,145,120,270,4,111,81,196
939,0.2,"(24, 10)","(9, 29)",9,88,67,164,13,101,74,188
940,0.2,"(2, 3)","(0, 29)",3,99,72,174,8,121,92,221
941,0.12,"(17, 1)","(22, 2)",12,67,49,128,5,81,44,130
942,0.02,"(22, 4)","(29, 10)",6,148,124,278,7,321,229,557
943,0.14,"(29, 23)","(5, 12)",1,125,96,222,2,151,71,224
944,0.2,"(15, 4)","(7, 26)",5,103,78,186,6,151,109,266
945,0.14,"(12, 11)","(10, 8)",6,95,71,172,13,131,74,218
946,0.04,"(6, 21)","(22, 3)",4,84,58,146,2,121,44,167
947,0.02,"(7, 18)","(24, 27)",4,100,74,178,6,231,191,428
948,0.2,"(25, 23)","(8, 14)",24,100,94,218,10,91,61,162
949,0.04,"(6, 5)","(12, 9)",8,90,68,166,13,121,54,188
950,0.14,"(17, 29)","(1, 7)",7,91,68,166,2,211,169,382
951,0.14,"(16, 0)","(4, 25)",1,75,46,122,1,91,55,147
952,0.1,"(11, 1)","(3, 2)",7,38,15,60,7,71,35,113
953,0.18,"(19, 20)","(12, 5)",6,83,59,148,6,81,52,139
954,0.2,"(7, 14)","(0, 2)",14,56,40,110,16,191,179,386
955,0.06,"(24, 21)","(3, 23)",3,129,102,234,7,81,51,139
956,0.02,"(10, 29)","(10, 2)",5,167,142,314,11,131,90,232
957,0.2,"(5, 24)","(10, 1)",5,127,102,234,15,111,88,214
958,0.02,"(3, 15)","(23, 5)",4,184,158,346,10,111,78,199
959,0.08,"(6, 16)","(0, 22)",7,65,42,114,8,101,62,171
960,0.14,"(28, 13)","(23, 9)",3,58,31,92,8,61,43,112
961,0.12,"(0, 23)","(19, 26)",11,154,135,300,5,141,82,228
962,0.16,"(13, 24)","(7, 7)",8,162,140,310,10,141,80,231
963,0.2,"(26, 15)","(15, 26)",5,105,80,190,39,81,86,206
964,0.02,"(2, 2)","(7, 0)",3,139,112,254,10,141,68,219
965,0.04,"(18, 13)","(26, 19)",11,104,85,200,9,161,67,237
966,0.08,"(7, 8)","(9, 3)",9,49,28,86,6,71,29,106
967,0.14,"(19, 21)","(0, 21)",5,69,44,118,21,81,80,182
968,0.16,"(1, 26)","(10, 1)",5,181,156,342,9,141,100,250
969,0.06,"(11, 12)","(24, 25)",8,146,124,278,4,171,115,290
970,0.14,"(14, 12)","(18, 12)",5,98,73,176,8,71,38,117
971,0.06,"(12, 19)","(5, 24)",9,69,48,126,5,141,74,220
972,0.2,"(23, 16)","(17, 29)",3,138,111,252,4,71,49,124
973,0.14,"(17, 20)","(8, 21)",9,47,26,82,13,71,30,114
974,0.04,"(27, 25)","(28, 21)",9,39,18,66,9,91,35,135
975,0.06,"(9, 21)","(2, 19)",27,43,40,110,30,41,41,112
976,0.02,"(20, 15)","(24, 21)",10,156,136,302,22,151,91,264
977,0.02,"(0, 7)","(24, 8)",3,225,198,426,3,111,65,179
978,0.1,"(28, 16)","(19, 3)",12,133,115,260,7,161,84,252
979,0.16,"(25, 10)","(2, 10)",9,113,92,214,6,171,137,314
980,0.08,"(17, 21)","(3, 21)",3,80,53,136,3,211,162,376
981,0.08,"(5, 24)","(28, 21)",6,143,119,268,10,131,83,224
982,0.08,"(19, 29)","(27, 13)",8,175,153,336,7,81,58,146
983,0.14,"(26, 23)","(4, 11)",7,127,104,238,11,91,68,170
984,0.16,"(3, 15)","(24, 1)",17,84,71,172,8,111,89,208
985,0.12,"(20, 0)","(19, 12)",4,77,51,132,5,131,98,234
986,0.04,"(23, 1)","(12, 15)",4,136,110,250,9,241,173,423
987,0.06,"(22, 6)","(6, 24)",9,84,63,156,7,191,132,330
988,0.08,"(25, 22)","(0, 16)",6,93,69,168,12,101,75,188
989,0.2,"(18, 24)","(27, 19)",7,95,72,174,4,91,63,158
990,0.14,"(20, 5)","(25, 15)",10,117,97,224,5,211,186,402
991,0.02,"(28, 24)","(12, 8)",7,134,111,252,7,191,148,346
992,0.08,"(11, 16)","(28, 0)",3,65,38,106,5,81,64,150
993,0.1,"(27, 29)","(3, 0)",11,83,64,158,5,131,97,233
994,0.04,"(14, 24)","(6, 15)",9,125,104,238,4,81,36,121
995,0.04,"(24, 13)","(3, 17)",8,71,49,128,10,191,113,314
996,0.2,"(29, 17)","(2, 9)",4,94,68,166,7,71,49,127
997,0.1,"(1, 6)","(29, 7)",10,126,106,242,5,141,102,248
998,0.02,"(14, 27)","(28, 25)",15,185,170,370,9,111,73,193
999,0.14,"(4, 23)","(27, 15)",6,160,136,302,4,121,70,195
,,,,8.191,103.406,81.655,193.252,8.218,115.38,74.271,197.869
