0,0.2,"(10, 13)","(21, 23)",7,133,125,265,5,94,100,199
1,0.14,"(20, 5)","(11, 6)",8,151,142,301,8,64,48,120
2,0.16,"(9, 28)","(28, 0)",5,85,75,165,6,64,56,126
3,0.1,"(9, 28)","(8, 28)",9,22,14,45,3,1,3,7
4,0.02,"(23, 21)","(23, 24)",21,109,98,228,6,112,82,200
5,0.06,"(14, 12)","(25, 19)",16,157,155,328,6,94,149,249
6,0.18,"(9, 16)","(9, 3)",8,139,126,273,6,103,151,260
7,0.14,"(24, 4)","(2, 9)",5,79,68,152,3,76,103,182
8,0.12,"(26, 20)","(26, 29)",11,181,177,369,5,76,47,128
9,0.02,"(18, 3)","(18, 5)",7,139,104,250,13,151,150,314
10,0.18,"(23, 7)","(26, 18)",4,79,66,149,5,79,86,170
11,0.12,"(6, 22)","(28, 5)",12,103,99,214,9,88,191,288
12,0.04,"(22, 26)","(4, 10)",11,145,126,282,8,169,298,475
13,0.04,"(6, 4)","(1, 29)",6,67,52,125,5,70,95,170
14,0.2,"(10, 7)","(16, 24)",8,55,49,112,12,85,73,170
15,0.02,"(17, 25)","(9, 5)",15,145,138,298,6,115,174,295
16,0.18,"(12, 29)","(5, 17)",7,91,83,181,3,85,173,261
17,0.18,"(11, 6)","(29, 9)",6,115,104,225,6,85,129,220
18,0.02,"(19, 0)","(9, 12)",16,34,37,87,5,118,136,259
19,0.04,"(1, 15)","(2, 9)",6,43,29,78,7,124,158,289
20,0.18,"(24, 23)","(18, 6)",7,97,91,195,7,70,56,133
21,0.02,"(15, 11)","(3, 19)",8,79,59,146,7,112,116,235
22,0.18,"(17, 13)","(18, 18)",7,118,111,236,8,79,41,128
23,0.1,"(25, 14)","(14, 4)",7,58,50,115,5,73,52,130
24,0.18,"(1, 5)","(0, 26)",6,232,223,461,11,91,146,248
25,0.16,"(19, 16)","(10, 9)",5,43,30,78,3,85,45,133
26,0.16,"(2, 5)","(1, 8)",6,25,14,45,17,31,24,72
27,0.1,"(28, 27)","(19, 11)",10,121,116,247,7,97,110,214
28,0.02,"(24, 0)","(8, 22)",6,109,90,205,4,94,98,196
29,0.16,"(4, 2)","(12, 25)",9,94,81,184,9,103,179,291
30,0.18,"(19, 25)","(21, 3)",20,73,77,170,17,100,161,278
31,0.2,"(25, 3)","(27, 1)",4,25,14,43,7,61,13,81
32,0.2,"(19, 17)","(21, 2)",7,151,139,297,8,106,177,291
33,0.18,"(16, 25)","(28, 8)",9,187,178,374,4,88,128,220
34,0.16,"(5, 28)","(15, 2)",2,274,258,534,2,118,296,416
35,0.04,"(0, 11)","(29, 2)",13,178,173,364,4,97,132,233
36,0.16,"(23, 16)","(23, 23)",3,88,78,169,6,88,63,157
37,0.02,"(15, 10)","(5, 11)",7,166,137,310,7,130,97,234
38,0.04,"(10, 0)","(4, 0)",2,43,24,69,2,64,13,79
39,0.08,"(17, 4)","(24, 17)",6,91,77,174,8,94,92,194
40,0.08,"(25, 18)","(2, 4)",4,112,98,214,7,91,87,185
41,0.08,"(27, 6)","(22, 12)",11,46,44,101,13,70,39,122
42,0.1,"(26, 15)","(21, 13)",7,31,20,58,13,73,33,119
43,0.14,"(20, 29)","(16, 18)",3,64,50,117,10,67,30,107
44,0.06,"(21, 2)","(15, 12)",12,118,116,246,8,76,57,141
45,0.02,"(8, 10)","(22, 1)",7,160,149,316,5,76,52,133
46,0.04,"(21, 15)","(4, 0)",9,106,102,217,4,130,126,260
47,0.14,"(15, 11)","(6, 8)",10,85,78,173,4,64,22,90
48,0.1,"(0, 17)","(13, 1)",7,127,112,246,10,82,147,239
49,0.02,"(16, 8)","(23, 3)",10,115,93,218,12,112,190,314
50,0.02,"(27, 0)","(7, 26)",5,172,141,318,6,103,106,215
51,0.02,"(9, 20)","(5, 23)",7,151,122,280,12,157,148,317
52,0.14,"(14, 16)","(5, 7)",5,97,83,185,8,91,91,190
53,0.08,"(1, 25)","(6, 7)",3,73,62,138,9,85,110,204
54,0.12,"(8, 11)","(7, 3)",5,82,67,154,10,67,51,128
55,0.12,"(28, 6)","(21, 28)",6,103,88,197,8,70,99,177
56,0.18,"(0, 10)","(23, 10)",18,133,131,282,6,85,210,301
57,0.14,"(4, 25)","(0, 18)",8,79,72,159,4,79,33,116
58,0.04,"(7, 24)","(14, 13)",12,124,112,248,8,100,91,199
59,0.06,"(24, 12)","(9, 0)",6,64,52,122,17,97,135,249
60,0.04,"(1, 29)","(12, 12)",24,97,102,223,4,115,133,252
61,0.16,"(29, 15)","(8, 18)",8,73,64,145,12,106,335,453
62,0.14,"(0, 17)","(22, 9)",10,100,91,201,11,97,90,198
63,0.08,"(20, 22)","(15, 19)",10,175,159,344,8,82,57,147
64,0.16,"(0, 19)","(28, 4)",8,181,174,363,5,82,72,159
65,0.06,"(8, 3)","(14, 28)",17,70,70,157,7,76,112,195
66,0.04,"(14, 23)","(21, 6)",6,97,75,178,4,157,258,419
67,0.14,"(0, 4)","(10, 0)",10,52,46,108,18,61,43,122
68,0.2,"(25, 23)","(15, 24)",6,118,107,231,11,82,146,239
69,0.18,"(20, 18)","(18, 25)",26,40,49,115,22,82,91,195
70,0.08,"(16, 23)","(2, 27)",5,70,58,133,7,94,67,168
71,0.06,"(27, 9)","(14, 7)",8,85,71,164,12,91,104,207
72,0.16,"(22, 9)","(24, 19)",3,67,53,123,8,76,147,231
73,0.06,"(3, 15)","(3, 25)",4,67,54,125,7,73,45,125
74,0.08,"(6, 14)","(14, 28)",10,118,112,240,4,85,62,151
75,0.16,"(10, 21)","(5, 5)",5,130,113,248,11,82,72,165
76,0.08,"(22, 12)","(19, 14)",7,1,7,15,4,64,14,82
77,0.08,"(15, 23)","(0, 28)",18,133,136,287,12,70,141,223
78,0.06,"(2, 28)","(29, 25)",7,112,104,223,3,73,81,157
79,0.02,"(1, 8)","(10, 22)",2,178,128,308,2,136,272,410
80,0.02,"(22, 12)","(10, 9)",3,220,177,400,12,184,263,459
81,0.18,"(2, 7)","(17, 1)",6,103,93,202,12,67,49,128
82,0.2,"(9, 21)","(25, 2)",6,193,186,385,14,100,224,338
83,0.06,"(27, 29)","(7, 17)",6,193,178,377,5,118,233,356
84,0.14,"(12, 28)","(9, 12)",5,43,33,81,4,85,48,137
85,0.04,"(22, 8)","(27, 12)",3,67,50,120,15,106,123,244
86,0.1,"(17, 29)","(9, 14)",6,133,119,258,11,127,403,541
87,0.08,"(13, 5)","(2, 11)",12,79,68,159,15,85,66,166
88,0.06,"(24, 22)","(3, 16)",5,130,108,243,6,139,266,411
89,0.02,"(10, 13)","(9, 3)",10,91,78,179,7,100,64,171
90,0.14,"(6, 20)","(25, 15)",10,67,60,137,2,94,200,296
91,0.06,"(18, 4)","(19, 10)",6,46,35,87,5,70,31,106
92,0.16,"(7, 26)","(15, 26)",4,55,46,105,4,94,82,180
93,0.18,"(14, 15)","(21, 11)",8,103,96,207,17,82,91,190
94,0.14,"(7, 12)","(17, 11)",6,70,56,132,12,82,103,197
95,0.12,"(27, 17)","(22, 1)",4,85,72,161,4,82,90,176
96,0.04,"(3, 19)","(6, 18)",7,64,54,125,9,88,73,170
97,0.2,"(22, 17)","(10, 6)",10,82,71,163,9,88,163,260
98,0.12,"(21, 16)","(29, 20)",7,85,67,159,7,76,57,140
99,0.12,"(22, 18)","(20, 4)",8,154,138,300,10,100,120,230
100,0.04,"(13, 11)","(2, 25)",6,61,49,116,9,82,50,141
101,0.16,"(18, 25)","(23, 19)",9,37,31,77,6,79,129,214
102,0.06,"(19, 25)","(9, 29)",5,43,31,79,13,106,142,261
103,0.16,"(23, 11)","(19, 22)",12,52,46,110,4,73,64,141
104,0.02,"(5, 23)","(9, 24)",9,151,120,280,9,94,58,161
105,0.1,"(8, 24)","(2, 2)",12,64,61,137,6,103,104,213
106,0.12,"(18, 1)","(26, 21)",3,157,143,303,8,88,127,223
107,0.2,"(8, 11)","(22, 9)",6,52,39,97,14,100,436,550
108,0.14,"(6, 12)","(12, 27)",21,91,95,207,13,103,322,438
109,0.02,"(29, 7)","(17, 22)",6,136,118,260,4,73,97,174
110,0.16,"(15, 16)","(16, 20)",16,40,43,99,4,67,30,101
111,0.14,"(15, 19)","(0, 6)",20,160,163,343,10,82,68,160
112,0.1,"(1, 11)","(28, 0)",4,88,74,166,6,76,145,227
113,0.16,"(10, 13)","(3, 28)",6,184,176,366,9,76,97,182
114,0.08,"(3, 24)","(9, 23)",10,49,43,102,6,91,61,158
115,0.06,"(12, 28)","(9, 7)",6,64,53,123,4,76,61,141
116,0.06,"(22, 15)","(24, 27)",4,169,153,326,5,109,120,234
117,0.12,"(4, 26)","(1, 12)",9,28,24,61,6,109,169,284
118,0.14,"(25, 22)","(27, 29)",6,76,65,147,9,67,73,149
119,0.16,"(9, 15)","(1, 6)",6,142,130,278,9,73,49,131
120,0.16,"(21, 16)","(19, 23)",5,67,57,129,4,76,81,161
121,0.1,"(27, 7)","(1, 7)",16,139,140,295,9,85,96,190
122,0.06,"(21, 10)","(18, 6)",11,67,54,132,5,82,55,142
123,0.08,"(27, 2)","(11, 14)",4,85,75,164,6,103,185,294
124,0.12,"(29, 24)","(23, 8)",10,100,89,199,7,91,64,162
125,0.16,"(8, 9)","(2, 26)",34,76,94,204,3,70,34,107
126,0.12,"(24, 6)","(15, 19)",4,64,52,120,9,85,122,216
127,0.16,"(10, 22)","(28, 12)",5,91,78,174,7,112,176,295
128,0.2,"(29, 16)","(0, 1)",3,109,97,209,8,64,59,131
129,0.14,"(1, 4)","(18, 12)",7,58,48,113,4,73,82,159
130,0.12,"(22, 27)","(11, 24)",5,43,29,77,9,88,88,185
131,0.18,"(13, 5)","(16, 20)",8,97,89,194,4,94,191,289
132,0.02,"(20, 4)","(8, 25)",19,121,106,246,6,109,108,223
133,0.06,"(6, 9)","(7, 16)",6,58,49,113,10,82,48,140
134,0.14,"(7, 27)","(7, 3)",4,97,84,185,5,100,141,246
135,0.14,"(11, 12)","(2, 9)",6,31,20,57,15,67,38,120
136,0.18,"(0, 13)","(10, 25)",8,100,90,198,4,76,43,123
137,0.18,"(9, 3)","(21, 6)",9,217,208,434,4,100,101,205
138,0.04,"(5, 29)","(9, 27)",6,142,119,267,5,91,86,182
139,0.08,"(4, 10)","(1, 8)",8,31,20,59,14,64,23,101
140,0.08,"(6, 24)","(21, 18)",17,64,61,142,9,88,105,202
141,0.06,"(9, 8)","(11, 16)",4,85,74,163,3,91,109,203
142,0.12,"(11, 24)","(9, 9)",15,88,85,188,16,79,79,174
143,0.02,"(2, 28)","(25, 1)",4,85,69,158,4,259,493,756
144,0.04,"(4, 6)","(12, 16)",11,109,88,208,8,145,143,296
145,0.1,"(4, 3)","(0, 21)",5,169,158,332,5,79,186,270
146,0.16,"(20, 2)","(9, 27)",5,73,61,139,3,88,185,276
147,0.1,"(0, 27)","(13, 0)",8,94,88,190,4,73,67,144
148,0.1,"(1, 1)","(10, 6)",16,61,59,136,4,100,85,189
149,0.1,"(2, 22)","(20, 16)",4,91,76,171,12,73,162,247
150,0.08,"(22, 11)","(23, 19)",5,76,62,143,10,70,65,145
151,0.06,"(11, 10)","(6, 26)",10,58,48,116,11,112,133,256
152,0.08,"(2, 7)","(24, 13)",5,76,59,140,6,76,70,152
153,0.2,"(16, 25)","(20, 0)",4,97,88,189,5,100,357,462
154,0.12,"(22, 0)","(23, 20)",5,79,69,153,2,97,160,259
155,0.04,"(20, 10)","(10, 24)",10,184,156,350,2,160,381,543
156,0.14,"(4, 18)","(22, 5)",5,64,49,118,6,79,146,231
157,0.08,"(4, 4)","(21, 21)",8,97,88,193,10,97,121,228
158,0.16,"(27, 17)","(12, 14)",8,61,52,121,4,94,66,164
159,0.1,"(15, 24)","(5, 0)",9,145,132,286,11,73,78,162
160,0.18,"(13, 7)","(10, 14)",5,31,19,55,4,70,28,102
161,0.08,"(4, 11)","(12, 14)",12,52,49,113,5,85,141,231
162,0.18,"(11, 23)","(29, 10)",12,112,104,228,3,70,182,255
163,0.06,"(13, 3)","(27, 18)",11,118,112,241,5,67,83,155
164,0.14,"(21, 29)","(9, 12)",10,73,58,141,4,73,97,174
165,0.14,"(28, 17)","(15, 28)",7,55,46,108,11,79,105,195
166,0.14,"(25, 26)","(7, 5)",6,115,104,225,35,82,183,300
167,0.02,"(5, 14)","(8, 11)",10,130,114,254,5,76,37,118
168,0.14,"(26, 23)","(10, 6)",8,112,107,227,8,82,108,198
169,0.04,"(5, 4)","(3, 29)",8,160,140,308,4,91,193,288
170,0.08,"(29, 14)","(19, 8)",11,121,111,243,7,67,33,107
171,0.12,"(20, 19)","(8, 16)",11,136,130,277,9,79,51,139
172,0.06,"(23, 5)","(23, 24)",8,79,69,156,8,103,121,232
173,0.04,"(6, 11)","(9, 27)",22,88,87,197,7,73,74,154
174,0.12,"(1, 29)","(16, 6)",8,109,99,216,2,70,141,213
175,0.02,"(19, 7)","(15, 17)",8,58,51,117,11,139,243,393
176,0.18,"(3, 14)","(1, 29)",6,91,78,175,6,79,78,163
177,0.18,"(16, 22)","(16, 8)",11,55,47,113,19,76,52,147
178,0.06,"(15, 20)","(19, 24)",9,70,63,142,5,88,49,142
179,0.1,"(1, 27)","(20, 24)",8,100,92,200,13,97,106,216
180,0.14,"(23, 6)","(1, 9)",7,109,98,214,17,94,165,276
181,0.18,"(25, 12)","(1, 8)",9,136,128,273,6,94,235,335
182,0.16,"(23, 21)","(21, 24)",5,31,17,53,11,73,37,121
183,0.18,"(26, 4)","(28, 26)",17,103,105,225,17,79,65,161
184,0.1,"(26, 4)","(26, 19)",7,49,40,96,4,64,38,106
185,0.18,"(29, 28)","(24, 26)",8,34,25,67,15,64,25,104
186,0.2,"(12, 17)","(3, 22)",6,76,66,148,11,79,83,173
187,0.2,"(8, 24)","(9, 27)",25,28,40,93,5,64,10,79
188,0.18,"(20, 2)","(14, 5)",23,97,105,225,11,67,25,103
189,0.14,"(21, 0)","(19, 13)",3,58,47,108,12,82,62,156
190,0.06,"(6, 16)","(20, 22)",9,154,140,303,3,82,66,151
191,0.08,"(11, 28)","(27, 24)",8,115,104,227,9,100,123,232
192,0.12,"(0, 20)","(20, 1)",9,76,70,155,13,70,57,140
193,0.14,"(12, 19)","(28, 19)",7,112,96,215,9,79,131,219
194,0.14,"(11, 11)","(16, 7)",3,79,65,147,2,70,59,131
195,0.02,"(6, 25)","(0, 15)",4,109,89,202,5,223,836,1064
196,0.06,"(28, 3)","(10, 24)",11,154,146,311,9,73,103,185
197,0.14,"(1, 29)","(26, 25)",15,121,113,249,5,91,82,178
198,0.12,"(15, 14)","(19, 19)",14,118,109,241,4,79,69,152
199,0.1,"(21, 13)","(18, 21)",9,133,113,255,8,88,74,170
200,0.02,"(14, 15)","(29, 5)",5,268,246,519,21,190,219,430
201,0.14,"(6, 13)","(21, 10)",9,55,49,113,4,73,66,143
202,0.04,"(1, 0)","(11, 13)",3,43,29,75,5,70,55,130
203,0.14,"(15, 12)","(6, 26)",10,67,60,137,11,88,122,221
204,0.16,"(23, 11)","(22, 8)",4,19,10,33,5,67,17,89
205,0.18,"(23, 0)","(4, 6)",12,100,90,202,8,85,190,283
206,0.08,"(20, 4)","(3, 11)",22,190,191,403,6,130,248,384
207,0.04,"(10, 4)","(29, 19)",8,76,71,155,6,94,73,173
208,0.16,"(16, 10)","(1, 14)",9,73,67,149,3,82,48,133
209,0.04,"(25, 9)","(23, 27)",6,73,56,135,7,82,59,148
210,0.06,"(27, 24)","(20, 1)",4,112,90,206,11,100,119,230
211,0.1,"(25, 19)","(1, 13)",17,85,85,187,4,115,173,292
212,0.06,"(13, 20)","(15, 1)",4,85,76,165,6,70,50,126
213,0.02,"(26, 24)","(16, 14)",7,262,226,495,8,118,128,254
214,0.1,"(5, 6)","(7, 1)",6,46,33,85,4,76,43,123
215,0.04,"(28, 0)","(13, 1)",13,61,53,127,5,73,69,147
216,0.12,"(9, 13)","(11, 7)",14,58,59,131,16,73,55,144
217,0.16,"(3, 19)","(5, 6)",22,130,131,283,21,97,157,275
218,0.16,"(11, 11)","(4, 9)",6,73,58,137,10,88,52,150
219,0.16,"(0, 6)","(6, 18)",4,100,89,193,7,70,35,112
220,0.08,"(22, 0)","(24, 1)",6,79,57,142,6,61,12,79
221,0.16,"(19, 7)","(13, 4)",12,148,144,304,5,61,16,82
222,0.1,"(25, 9)","(12, 29)",3,64,52,119,7,70,67,144
223,0.08,"(29, 14)","(19, 15)",15,76,77,168,12,88,80,180
224,0.2,"(27, 19)","(25, 1)",10,88,78,176,11,88,119,218
225,0.04,"(10, 5)","(3, 20)",6,163,144,313,11,94,83,188
226,0.14,"(27, 1)","(5, 8)",8,109,101,218,6,67,62,135
227,0.1,"(28, 20)","(27, 0)",15,130,131,276,7,97,116,220
228,0.16,"(16, 3)","(11, 14)",8,76,64,148,7,85,165,257
229,0.14,"(19, 0)","(7, 2)",5,67,54,126,6,88,100,194
230,0.16,"(1, 29)","(17, 15)",3,115,98,216,3,76,122,201
231,0.04,"(25, 3)","(17, 12)",10,115,103,228,13,76,49,138
232,0.16,"(18, 6)","(21, 27)",8,85,77,170,6,94,121,221
233,0.14,"(14, 8)","(10, 27)",3,124,114,241,5,82,53,140
234,0.08,"(5, 11)","(29, 8)",6,79,70,155,10,82,252,344
235,0.12,"(19, 26)","(24, 15)",5,70,54,129,14,112,200,326
236,0.14,"(13, 18)","(25, 13)",19,127,133,279,5,79,115,199
237,0.1,"(15, 15)","(18, 22)",4,70,55,129,6,79,38,123
238,0.02,"(0, 6)","(15, 1)",6,151,140,297,12,103,175,290
239,0.2,"(28, 4)","(20, 27)",4,76,65,145,4,100,240,344
240,0.18,"(2, 2)","(17, 20)",10,73,68,151,3,121,273,397
241,0.18,"(14, 1)","(19, 11)",5,103,89,197,5,79,78,162
242,0.02,"(24, 19)","(24, 15)",8,61,40,109,4,67,27,98
243,0.02,"(5, 17)","(25, 16)",15,154,145,314,27,136,192,355
244,0.1,"(28, 18)","(15, 15)",3,124,108,235,4,70,48,122
245,0.08,"(7, 2)","(27, 15)",7,121,108,236,6,133,442,581
246,0.18,"(10, 20)","(25, 0)",15,52,54,121,5,73,48,126
247,0.08,"(6, 27)","(25, 16)",4,115,99,218,6,79,103,188
248,0.08,"(9, 9)","(8, 27)",7,163,151,321,4,76,53,133
249,0.2,"(11, 12)","(1, 8)",6,154,145,305,5,67,26,98
250,0.12,"(25, 28)","(13, 10)",9,61,57,127,9,103,134,246
251,0.1,"(28, 2)","(11, 15)",5,100,86,191,5,85,87,177
252,0.14,"(24, 29)","(0, 21)",11,142,137,290,4,64,98,166
253,0.08,"(13, 25)","(28, 16)",4,133,120,257,11,109,138,258
254,0.14,"(16, 21)","(23, 3)",5,82,65,152,11,82,63,156
255,0.14,"(27, 6)","(11, 0)",6,70,63,139,9,85,97,191
256,0.16,"(21, 16)","(29, 21)",5,112,103,220,9,76,94,179
257,0.14,"(6, 7)","(23, 1)",7,97,91,195,14,88,138,240
258,0.06,"(13, 14)","(9, 25)",6,106,95,207,8,64,33,105
259,0.12,"(24, 0)","(0, 16)",17,79,82,178,9,97,164,270
260,0.16,"(29, 14)","(6, 25)",2,82,67,151,5,136,357,498
261,0.14,"(23, 7)","(25, 28)",10,106,103,219,8,103,105,216
262,0.12,"(8, 21)","(0, 10)",6,82,63,151,5,70,133,208
263,0.18,"(24, 29)","(12, 24)",4,31,20,55,8,76,52,136
264,0.02,"(22, 9)","(20, 23)",6,238,216,460,4,175,255,434
265,0.08,"(28, 24)","(23, 16)",7,43,28,78,7,85,45,137
266,0.06,"(13, 29)","(26, 22)",13,97,85,195,4,94,182,280
267,0.2,"(24, 2)","(23, 10)",8,55,44,107,7,70,33,110
268,0.08,"(16, 1)","(21, 27)",13,76,74,163,5,106,325,436
269,0.08,"(7, 6)","(12, 23)",18,73,78,169,8,100,119,227
270,0.2,"(0, 4)","(24, 22)",13,79,79,171,35,76,139,250
271,0.12,"(1, 25)","(24, 9)",8,118,106,232,15,94,148,257
272,0.04,"(24, 18)","(18, 14)",3,55,34,92,4,61,12,77
273,0.2,"(24, 24)","(13, 11)",3,58,43,104,10,91,158,259
274,0.12,"(21, 19)","(29, 1)",6,139,132,277,7,85,75,167
275,0.12,"(11, 6)","(12, 7)",9,76,65,150,9,61,15,85
276,0.08,"(0, 17)","(14, 29)",19,91,93,203,8,61,44,113
277,0.18,"(13, 13)","(9, 6)",22,178,183,383,16,85,67,168
278,0.16,"(22, 16)","(19, 15)",4,31,22,57,9,64,29,102
279,0.04,"(21, 0)","(2, 9)",7,142,131,280,8,118,172,298
280,0.06,"(9, 2)","(23, 28)",5,139,126,270,4,94,82,180
281,0.08,"(4, 17)","(27, 25)",7,127,109,243,13,85,131,229
282,0.04,"(23, 23)","(10, 13)",6,49,40,95,5,112,140,257
283,0.12,"(29, 14)","(22, 17)",5,61,48,114,10,64,32,106
284,0.1,"(3, 11)","(9, 13)",6,61,46,113,8,85,50,143
285,0.14,"(28, 29)","(17, 29)",8,91,79,178,4,64,24,92
286,0.18,"(7, 16)","(18, 18)",4,40,28,72,3,85,159,247
287,0.08,"(3, 4)","(14, 10)",15,100,95,210,7,82,78,167
288,0.16,"(25, 9)","(2, 14)",5,70,60,135,4,103,211,318
289,0.2,"(5, 20)","(13, 20)",11,76,71,158,7,106,97,210
290,0.04,"(11, 21)","(21, 24)",9,139,118,266,4,91,102,197
291,0.16,"(9, 10)","(24, 10)",3,73,57,133,13,94,200,307
292,0.12,"(23, 2)","(14, 25)",4,97,85,186,4,82,130,216
293,0.16,"(14, 24)","(29, 6)",13,76,73,162,9,103,261,373
294,0.1,"(23, 15)","(2, 4)",12,112,111,235,6,76,96,178
295,0.18,"(27, 23)","(6, 17)",4,40,31,75,8,106,336,450
296,0.08,"(2, 1)","(12, 27)",11,151,144,306,7,82,76,165
297,0.12,"(9, 1)","(28, 29)",4,202,189,395,6,64,53,123
298,0.18,"(5, 2)","(1, 26)",4,136,120,260,5,70,104,179
299,0.08,"(24, 9)","(14, 5)",6,103,84,193,4,115,200,319
300,0.12,"(26, 25)","(4, 1)",7,121,108,236,4,76,72,152
301,0.06,"(8, 3)","(23, 19)",8,85,76,169,20,82,109,211
302,0.08,"(23, 7)","(13, 11)",2,76,63,141,6,73,35,114
303,0.14,"(22, 4)","(12, 24)",6,64,50,120,5,82,95,182
304,0.16,"(11, 6)","(10, 28)",12,121,115,248,5,88,110,203
305,0.02,"(6, 26)","(29, 18)",10,94,90,194,5,64,92,161
306,0.14,"(3, 0)","(16, 17)",4,70,61,135,6,97,242,345
307,0.04,"(2, 1)","(10, 15)",19,106,101,226,4,76,110,190
308,0.12,"(26, 10)","(24, 12)",18,52,50,120,8,88,49,145
309,0.12,"(4, 1)","(3, 26)",6,124,115,245,7,118,303,428
310,0.02,"(20, 1)","(21, 12)",3,289,232,524,2,100,84,186
311,0.1,"(22, 8)","(12, 9)",11,34,30,75,9,73,29,111
312,0.06,"(26, 0)","(18, 15)",5,118,102,225,8,97,91,196
313,0.2,"(26, 3)","(20, 5)",6,64,52,122,11,64,27,102
314,0.16,"(23, 11)","(26, 4)",12,49,44,105,15,88,114,217
315,0.16,"(13, 16)","(28, 26)",18,73,74,165,5,100,160,265
316,0.04,"(27, 14)","(7, 16)",7,100,87,194,5,97,70,172
317,0.02,"(20, 24)","(1, 16)",2,247,209,458,2,133,143,278
318,0.06,"(23, 6)","(0, 1)",3,97,87,187,3,82,57,142
319,0.18,"(3, 20)","(16, 27)",17,109,109,235,14,79,60,153
320,0.04,"(0, 7)","(0, 10)",7,46,31,84,5,91,51,147
321,0.1,"(26, 27)","(4, 24)",8,166,154,328,7,91,76,174
322,0.18,"(24, 2)","(2, 12)",9,76,64,149,21,91,165,277
323,0.14,"(28, 24)","(4, 1)",8,124,115,247,3,76,78,157
324,0.02,"(1, 24)","(8, 8)",8,139,113,260,5,154,211,370
325,0.12,"(24, 8)","(14, 7)",13,91,81,185,4,76,50,130
326,0.16,"(8, 2)","(13, 5)",9,58,51,118,15,85,57,157
327,0.16,"(9, 28)","(21, 7)",6,70,59,135,8,100,148,256
328,0.02,"(15, 0)","(0, 24)",5,88,79,172,18,82,83,183
329,0.04,"(29, 28)","(11, 13)",5,94,78,177,4,142,267,413
330,0.1,"(2, 16)","(20, 2)",5,103,90,198,7,88,67,162
331,0.2,"(7, 3)","(19, 26)",7,82,71,160,14,109,281,404
332,0.08,"(7, 16)","(9, 28)",4,100,91,195,7,73,49,129
333,0.04,"(14, 16)","(19, 19)",8,46,34,88,13,115,105,233
334,0.14,"(7, 10)","(14, 17)",5,34,24,63,12,70,57,139
335,0.08,"(8, 16)","(24, 8)",6,127,110,243,5,73,51,129
336,0.04,"(16, 5)","(17, 21)",8,109,104,221,16,73,91,180
337,0.12,"(15, 27)","(9, 18)",4,112,94,210,11,85,93,189
338,0.16,"(11, 7)","(17, 11)",5,82,71,158,3,76,47,126
339,0.12,"(6, 9)","(18, 6)",12,76,69,157,12,76,84,172
340,0.16,"(25, 15)","(10, 26)",5,100,89,194,4,97,200,301
341,0.14,"(4, 9)","(28, 1)",5,76,66,147,3,91,177,271
342,0.1,"(16, 19)","(2, 1)",6,52,44,102,10,79,54,143
343,0.1,"(11, 28)","(27, 28)",9,67,60,136,6,73,99,178
344,0.1,"(16, 6)","(25, 15)",7,70,61,138,6,148,364,518
345,0.2,"(28, 0)","(18, 23)",6,49,40,95,9,82,173,264
346,0.12,"(4, 12)","(9, 10)",4,64,47,115,5,67,40,112
347,0.2,"(23, 12)","(23, 15)",4,28,19,51,17,64,30,111
348,0.08,"(8, 6)","(18, 10)",9,85,72,166,7,82,79,168
349,0.16,"(4, 7)","(14, 16)",9,61,47,117,11,76,80,167
350,0.18,"(25, 19)","(26, 11)",8,61,48,117,13,85,69,167
351,0.16,"(16, 26)","(10, 23)",6,31,24,61,20,67,38,125
352,0.1,"(10, 6)","(14, 28)",3,136,118,257,14,130,366,510
353,0.18,"(26, 3)","(17, 13)",4,46,34,84,5,88,94,187
354,0.12,"(5, 19)","(12, 20)",7,100,86,193,9,88,96,193
355,0.12,"(15, 17)","(14, 20)",4,70,53,127,23,79,68,170
356,0.16,"(2, 22)","(10, 18)",13,94,86,193,6,61,24,91
357,0.14,"(25, 28)","(15, 29)",5,52,44,101,4,67,19,90
358,0.1,"(13, 28)","(25, 22)",25,58,67,150,7,70,71,148
359,0.02,"(28, 25)","(8, 16)",6,241,201,448,4,175,247,426
360,0.18,"(15, 5)","(5, 4)",9,97,89,195,4,82,68,154
361,0.2,"(18, 26)","(27, 15)",5,232,219,456,4,73,111,188
362,0.06,"(21, 15)","(6, 11)",7,97,87,191,8,91,70,169
363,0.16,"(19, 1)","(23, 15)",6,100,93,199,11,112,182,305
364,0.06,"(25, 9)","(6, 13)",16,151,147,314,31,139,351,521
365,0.04,"(12, 6)","(10, 14)",23,79,80,182,4,79,70,153
366,0.12,"(27, 10)","(12, 1)",6,127,118,251,4,109,214,327
367,0.04,"(12, 9)","(27, 24)",12,175,160,347,3,76,65,144
368,0.2,"(17, 18)","(28, 18)",5,133,125,263,6,85,100,191
369,0.06,"(29, 17)","(0, 21)",7,88,75,170,3,70,44,117
370,0.14,"(22, 19)","(7, 18)",6,79,72,157,9,70,105,184
371,0.06,"(12, 22)","(4, 19)",5,79,60,144,5,73,46,124
372,0.18,"(19, 17)","(25, 5)",5,97,75,177,7,88,165,260
373,0.08,"(20, 22)","(26, 1)",6,106,95,207,4,70,52,126
374,0.16,"(23, 28)","(8, 2)",3,64,51,118,3,85,97,185
375,0.12,"(4, 12)","(23, 22)",7,85,72,164,14,85,75,174
376,0.1,"(5, 16)","(14, 28)",15,124,120,259,6,85,188,279
377,0.06,"(5, 7)","(10, 0)",5,64,53,122,4,61,29,94
378,0.04,"(12, 29)","(13, 11)",10,127,108,245,3,73,56,132
379,0.08,"(21, 13)","(28, 21)",38,79,99,216,21,73,161,255
380,0.12,"(7, 21)","(28, 28)",17,169,165,351,6,79,57,142
381,0.18,"(27, 5)","(0, 29)",11,70,64,145,12,61,66,139
382,0.18,"(18, 1)","(3, 22)",6,259,248,513,8,118,327,453
383,0.14,"(28, 12)","(15, 29)",6,88,81,175,4,91,277,372
384,0.06,"(29, 20)","(17, 18)",9,184,170,363,5,82,86,173
385,0.08,"(24, 0)","(23, 20)",8,79,69,156,7,73,38,118
386,0.02,"(29, 27)","(23, 8)",9,91,77,177,4,124,145,273
387,0.06,"(13, 5)","(19, 16)",8,40,33,81,5,109,130,244
388,0.1,"(4, 26)","(17, 3)",8,148,137,293,5,94,97,196
389,0.16,"(18, 28)","(28, 18)",9,76,67,152,7,85,123,215
390,0.18,"(24, 16)","(7, 8)",20,49,55,124,6,94,264,364
391,0.16,"(2, 22)","(19, 13)",3,76,66,145,11,130,252,393
392,0.06,"(19, 2)","(17, 21)",6,157,139,302,6,130,183,319
393,0.02,"(26, 7)","(4, 9)",7,139,112,258,7,127,170,304
394,0.04,"(26, 16)","(11, 0)",15,121,119,255,6,85,167,258
395,0.04,"(0, 16)","(18, 20)",6,160,149,315,15,109,188,312
396,0.2,"(24, 8)","(14, 5)",12,49,43,104,4,73,69,146
397,0.1,"(8, 8)","(25, 11)",4,76,65,145,4,76,93,173
398,0.14,"(24, 4)","(21, 17)",15,94,91,200,9,70,44,123
399,0.06,"(2, 24)","(12, 7)",6,88,77,171,4,100,130,234
400,0.14,"(12, 2)","(9, 29)",5,91,77,173,8,85,135,228
401,0.08,"(7, 18)","(26, 2)",4,115,93,212,10,73,63,146
402,0.02,"(29, 7)","(10, 27)",7,106,85,198,8,142,184,334
403,0.1,"(12, 20)","(3, 0)",5,94,82,181,7,82,90,179
404,0.2,"(26, 10)","(14, 1)",12,316,312,640,10,76,122,208
405,0.1,"(29, 22)","(7, 3)",2,112,88,202,2,127,343,472
406,0.04,"(22, 2)","(20, 14)",8,28,23,59,11,76,42,129
407,0.2,"(9, 15)","(1, 26)",8,211,199,418,6,85,195,286
408,0.06,"(12, 7)","(15, 2)",7,82,57,146,12,73,71,156
409,0.12,"(9, 19)","(27, 0)",10,193,182,385,5,64,45,114
410,0.2,"(23, 24)","(4, 10)",8,100,91,199,10,97,167,274
411,0.18,"(27, 20)","(2, 2)",15,76,73,164,5,70,57,132
412,0.2,"(17, 21)","(5, 2)",10,61,54,125,13,82,83,178
413,0.1,"(10, 7)","(0, 4)",4,40,24,68,8,70,42,120
414,0.12,"(25, 3)","(3, 27)",15,82,79,176,6,85,100,191
415,0.06,"(20, 5)","(18, 7)",5,88,69,162,4,67,30,101
416,0.18,"(12, 18)","(21, 18)",4,49,38,91,3,112,181,296
417,0.16,"(12, 11)","(14, 1)",7,70,63,140,4,88,66,158
418,0.16,"(4, 11)","(7, 23)",13,73,67,153,8,67,61,136
419,0.12,"(26, 10)","(16, 18)",5,88,80,173,4,91,89,184
420,0.16,"(18, 9)","(29, 4)",3,127,114,244,3,82,280,365
421,0.16,"(13, 23)","(7, 9)",10,73,70,153,25,70,83,178
422,0.2,"(19, 14)","(18, 0)",5,226,217,448,3,85,66,154
423,0.1,"(24, 27)","(9, 4)",6,133,120,259,3,91,119,213
424,0.18,"(19, 3)","(15, 14)",6,139,126,271,6,97,134,237
425,0.16,"(17, 3)","(16, 12)",8,88,75,171,4,82,73,159
426,0.12,"(10, 10)","(9, 7)",6,43,31,80,16,67,34,117
427,0.18,"(0, 1)","(1, 15)",6,49,40,95,7,79,51,137
428,0.14,"(2, 28)","(23, 3)",4,76,62,142,4,79,98,181
429,0.02,"(20, 14)","(4, 17)",7,37,26,70,6,118,225,349
430,0.08,"(15, 14)","(1, 22)",7,85,68,160,20,76,64,160
431,0.18,"(2, 2)","(18, 23)",9,136,129,274,5,106,254,365
432,0.2,"(12, 16)","(0, 19)",5,34,24,63,5,106,387,498
433,0.2,"(23, 14)","(11, 22)",7,73,58,138,5,106,262,373
434,0.1,"(22, 29)","(10, 28)",4,115,100,219,5,97,87,189
435,0.16,"(20, 7)","(18, 25)",8,91,80,179,7,91,101,199
436,0.14,"(24, 15)","(0, 3)",14,76,69,159,5,121,205,331
437,0.1,"(21, 10)","(27, 29)",8,100,92,200,7,94,113,214
438,0.08,"(10, 27)","(3, 5)",4,175,151,330,9,151,355,515
439,0.08,"(1, 3)","(25, 19)",5,82,68,155,3,121,154,278
440,0.14,"(8, 28)","(15, 14)",11,49,45,105,10,76,106,192
441,0.2,"(8, 3)","(13, 24)",5,49,38,92,6,94,131,231
442,0.18,"(29, 24)","(17, 3)",5,148,138,291,4,76,123,203
443,0.18,"(4, 26)","(1, 21)",8,25,16,49,8,67,23,98
444,0.2,"(17, 4)","(24, 8)",4,85,74,163,6,70,42,118
445,0.16,"(23, 27)","(15, 4)",4,73,62,139,11,103,200,314
446,0.02,"(5, 14)","(21, 29)",4,160,131,295,9,70,84,163
447,0.04,"(17, 16)","(7, 19)",7,109,101,217,8,73,28,109
448,0.04,"(11, 22)","(24, 5)",15,193,190,398,5,91,83,179
449,0.14,"(8, 24)","(6, 0)",6,88,77,171,8,85,130,223
450,0.1,"(1, 2)","(16, 16)",9,67,58,134,14,118,289,421
451,0.06,"(3, 28)","(2, 21)",7,40,25,72,12,82,40,134
452,0.1,"(0, 23)","(2, 2)",5,133,121,259,5,106,176,287
453,0.02,"(7, 20)","(27, 27)",4,85,65,154,5,85,68,158
454,0.14,"(26, 1)","(27, 15)",3,64,49,116,9,112,342,463
455,0.08,"(15, 8)","(22, 18)",13,103,95,211,9,91,97,197
456,0.08,"(26, 9)","(13, 15)",14,79,79,172,11,100,103,214
457,0.1,"(10, 18)","(8, 19)",6,19,12,37,6,61,10,77
458,0.1,"(7, 4)","(16, 16)",5,79,68,152,5,91,137,233
459,0.04,"(6, 1)","(21, 1)",4,88,75,167,5,64,49,118
460,0.02,"(18, 25)","(12, 21)",6,37,25,68,4,319,802,1125
461,0.1,"(26, 28)","(26, 6)",5,148,136,289,6,85,71,162
462,0.06,"(22, 28)","(1, 16)",3,64,49,116,4,103,107,214
463,0.1,"(19, 27)","(15, 3)",16,106,90,212,3,112,161,276
464,0.06,"(22, 25)","(20, 16)",13,28,25,66,10,67,33,110
465,0.04,"(7, 10)","(27, 23)",6,229,213,448,7,103,100,210
466,0.18,"(4, 15)","(10, 23)",16,40,39,95,6,100,93,199
467,0.04,"(6, 7)","(4, 24)",6,52,37,95,10,82,155,247
468,0.06,"(1, 17)","(29, 1)",5,127,117,249,14,100,165,279
469,0.18,"(15, 25)","(27, 25)",10,115,112,237,6,85,89,180
470,0.12,"(9, 12)","(12, 7)",6,31,24,61,12,115,159,286
471,0.02,"(16, 21)","(10, 2)",11,286,269,566,8,106,117,231
472,0.02,"(15, 21)","(29, 22)",9,199,174,382,8,139,268,415
473,0.2,"(3, 28)","(2, 0)",6,196,188,390,12,91,260,363
474,0.08,"(3, 10)","(23, 4)",16,67,70,153,8,76,59,143
475,0.02,"(16, 1)","(25, 6)",12,133,108,253,11,127,156,294
476,0.08,"(10, 1)","(11, 20)",4,127,113,244,5,94,153,252
477,0.02,"(12, 10)","(18, 5)",8,94,82,184,7,97,110,214
478,0.04,"(27, 15)","(15, 4)",5,202,178,385,4,79,62,145
479,0.1,"(13, 7)","(19, 12)",4,49,36,89,13,91,135,239
480,0.04,"(8, 27)","(1, 11)",9,49,39,97,8,76,39,123
481,0.12,"(21, 21)","(6, 26)",7,133,124,264,4,76,59,139
482,0.2,"(8, 10)","(25, 2)",6,184,173,363,5,73,91,169
483,0.18,"(14, 27)","(8, 12)",7,112,101,220,10,79,69,158
484,0.02,"(20, 14)","(11, 5)",21,133,132,286,7,193,313,513
485,0.02,"(25, 29)","(9, 17)",1,157,127,285,1,82,147,230
486,0.18,"(2, 13)","(21, 20)",6,61,49,116,4,82,79,165
487,0.2,"(14, 21)","(21, 20)",8,106,99,213,15,79,157,251
488,0.08,"(7, 21)","(19, 7)",4,142,119,265,5,88,80,173
489,0.16,"(24, 12)","(25, 18)",10,67,58,135,13,79,71,163
490,0.06,"(19, 12)","(6, 23)",13,55,55,123,8,112,211,331
491,0.16,"(1, 27)","(4, 1)",6,79,70,155,6,88,217,311
492,0.08,"(6, 27)","(0, 14)",4,148,126,278,19,70,95,184
493,0.2,"(29, 28)","(27, 25)",9,28,22,59,5,31,7,43
494,0.16,"(28, 19)","(16, 10)",4,157,144,305,3,85,143,231
495,0.12,"(29, 9)","(13, 12)",14,49,50,113,8,100,199,307
496,0.2,"(16, 2)","(9, 28)",10,154,148,312,6,109,156,271
497,0.2,"(29, 10)","(28, 11)",4,22,12,38,9,1,9,19
498,0.02,"(20, 7)","(0, 15)",4,175,147,326,7,94,204,305
499,0.02,"(21, 29)","(26, 4)",6,109,86,201,5,106,82,193
500,0.12,"(1, 0)","(17, 1)",3,100,90,193,4,85,76,165
501,0.02,"(5, 11)","(16, 25)",6,76,61,143,6,100,127,233
502,0.12,"(0, 27)","(28, 28)",14,130,127,271,33,76,86,195
503,0.1,"(4, 21)","(6, 19)",15,49,43,107,7,70,29,106
504,0.18,"(20, 15)","(18, 12)",10,19,16,45,7,61,15,83
505,0.18,"(3, 29)","(4, 12)",7,85,75,167,4,82,48,134
506,0.06,"(6, 2)","(14, 12)",7,49,35,91,8,106,111,225
507,0.08,"(0, 20)","(29, 1)",3,139,125,267,6,97,78,181
508,0.12,"(13, 3)","(2, 21)",5,151,139,295,6,82,85,173
509,0.02,"(27, 1)","(29, 15)",5,283,252,540,9,94,89,192
510,0.16,"(9, 26)","(6, 23)",10,28,20,58,5,64,21,90
511,0.1,"(21, 16)","(0, 12)",27,76,83,186,10,97,103,210
512,0.18,"(6, 22)","(24, 10)",8,106,97,211,10,106,286,402
513,0.16,"(22, 26)","(11, 2)",5,97,85,187,9,100,216,325
514,0.12,"(16, 17)","(22, 25)",5,52,41,98,5,115,200,320
515,0.08,"(3, 24)","(22, 29)",6,133,124,263,5,88,101,194
516,0.12,"(13, 12)","(26, 19)",6,70,56,132,11,115,389,515
517,0.12,"(26, 9)","(12, 28)",11,133,126,270,6,76,75,157
518,0.02,"(19, 4)","(11, 20)",6,247,213,466,5,190,334,529
519,0.06,"(10, 26)","(26, 16)",4,55,42,101,9,73,97,179
520,0.18,"(9, 5)","(25, 26)",8,94,84,186,4,88,108,200
521,0.16,"(5, 2)","(10, 1)",6,31,22,59,5,67,38,110
522,0.1,"(6, 13)","(29, 10)",9,223,215,447,6,67,56,129
523,0.2,"(8, 15)","(20, 20)",4,88,75,167,9,94,216,319
524,0.06,"(3, 4)","(0, 9)",8,22,14,44,7,61,17,85
525,0.1,"(7, 15)","(11, 17)",5,67,55,127,7,73,49,129
526,0.2,"(18, 16)","(11, 4)",7,52,39,98,4,70,54,128
527,0.08,"(21, 10)","(20, 3)",5,79,66,150,8,61,16,85
528,0.12,"(2, 27)","(16, 22)",7,76,64,147,9,82,103,194
529,0.18,"(13, 4)","(10, 22)",9,52,48,109,4,97,256,357
530,0.12,"(19, 26)","(7, 24)",6,49,37,92,7,88,111,206
531,0.12,"(3, 25)","(1, 19)",4,31,20,55,8,67,22,97
532,0.14,"(26, 24)","(24, 2)",6,133,121,260,4,82,60,146
533,0.08,"(12, 25)","(22, 5)",11,130,117,258,12,76,78,166
534,0.12,"(23, 17)","(24, 26)",11,28,25,64,12,64,33,109
535,0.2,"(20, 13)","(9, 17)",15,40,35,90,7,79,63,149
536,0.06,"(10, 27)","(12, 25)",11,28,23,62,8,85,104,197
537,0.08,"(25, 24)","(17, 29)",6,64,50,120,11,76,38,125
538,0.16,"(19, 12)","(10, 28)",16,175,167,358,9,82,253,344
539,0.12,"(1, 18)","(1, 27)",6,55,44,105,4,67,33,104
540,0.04,"(29, 6)","(8, 18)",4,136,119,259,7,130,293,430
541,0.18,"(13, 18)","(16, 1)",4,67,56,127,3,94,329,426
542,0.06,"(27, 20)","(4, 28)",4,82,67,153,4,103,143,250
543,0.1,"(7, 18)","(19, 25)",6,70,60,136,4,88,112,204
544,0.08,"(28, 23)","(27, 6)",5,151,134,290,5,76,47,128
545,0.08,"(5, 0)","(26, 13)",2,85,68,155,7,85,110,202
546,0.02,"(20, 14)","(18, 29)",6,253,239,498,4,97,94,195
547,0.2,"(7, 13)","(15, 0)",5,181,170,356,12,64,48,124
548,0.08,"(3, 10)","(0, 17)",5,82,72,159,6,61,17,84
549,0.18,"(27, 3)","(22, 4)",6,40,27,73,6,64,18,88
550,0.02,"(17, 13)","(15, 0)",4,115,92,211,9,166,326,501
551,0.16,"(14, 10)","(7, 24)",7,76,64,147,4,94,194,292
552,0.12,"(25, 26)","(19, 29)",6,100,92,198,12,73,51,136
553,0.1,"(7, 11)","(2, 5)",6,64,49,119,6,73,35,114
554,0.18,"(17, 17)","(16, 18)",5,76,62,143,4,61,7,72
555,0.2,"(8, 11)","(23, 29)",9,427,419,855,18,64,74,156
556,0.1,"(15, 16)","(3, 27)",8,91,83,182,6,109,173,288
557,0.14,"(8, 24)","(28, 27)",7,142,132,281,7,88,74,169
558,0.2,"(25, 5)","(3, 14)",4,112,103,219,10,91,172,273
559,0.2,"(11, 2)","(20, 9)",5,64,52,121,10,79,98,187
560,0.18,"(3, 13)","(23, 2)",7,106,95,208,6,76,67,149
561,0.02,"(22, 18)","(26, 15)",5,88,57,150,6,112,63,181
562,0.12,"(14, 19)","(24, 3)",5,154,143,302,7,106,131,244
563,0.1,"(12, 23)","(27, 2)",4,73,64,141,5,85,80,170
564,0.1,"(23, 23)","(20, 23)",14,37,28,79,6,61,17,84
565,0.18,"(11, 11)","(27, 4)",6,76,65,147,3,94,137,234
566,0.02,"(18, 16)","(3, 2)",7,79,63,149,6,103,112,221
567,0.16,"(1, 4)","(9, 23)",5,88,75,168,3,88,72,163
568,0.12,"(26, 3)","(28, 22)",14,160,156,330,11,70,67,148
569,0.02,"(9, 14)","(22, 18)",7,151,136,294,8,133,288,429
570,0.18,"(4, 3)","(10, 22)",3,115,102,220,6,115,257,378
571,0.12,"(10, 24)","(0, 14)",23,58,66,147,14,67,38,119
572,0.02,"(29, 8)","(21, 21)",5,100,74,179,3,151,230,384
573,0.16,"(26, 4)","(17, 0)",6,151,142,299,5,85,42,132
574,0.1,"(19, 20)","(25, 6)",2,181,165,348,5,97,133,235
575,0.18,"(6, 19)","(19, 5)",11,100,97,208,9,82,66,157
576,0.04,"(0, 15)","(1, 29)",7,205,193,405,11,112,87,210
577,0.02,"(3, 10)","(24, 4)",8,262,227,497,9,193,287,489
578,0.08,"(6, 24)","(5, 19)",4,40,25,69,4,61,15,80
579,0.08,"(20, 15)","(2, 14)",19,115,107,241,15,100,98,213
580,0.06,"(17, 25)","(17, 3)",5,106,76,187,5,106,111,222
581,0.16,"(25, 11)","(0, 19)",5,58,50,113,4,94,301,399
582,0.14,"(2, 20)","(29, 15)",12,88,78,178,11,88,144,243
583,0.08,"(13, 4)","(18, 24)",7,100,82,189,8,109,184,301
584,0.2,"(9, 12)","(20, 3)",7,244,231,482,3,97,118,218
585,0.16,"(24, 2)","(21, 7)",5,40,26,71,6,82,37,125
586,0.2,"(12, 29)","(4, 0)",7,283,276,566,5,82,92,179
587,0.12,"(2, 14)","(20, 18)",7,127,113,247,6,82,105,193
588,0.16,"(15, 27)","(26, 10)",3,88,68,159,5,79,156,240
589,0.2,"(2, 22)","(27, 29)",14,214,211,439,15,76,113,204
590,0.16,"(25, 18)","(0, 26)",9,109,102,220,10,79,123,212
591,0.04,"(23, 0)","(13, 17)",3,76,53,132,3,88,97,188
592,0.04,"(22, 13)","(9, 3)",5,61,52,118,5,118,167,290
593,0.2,"(27, 18)","(19, 25)",4,118,106,228,11,82,101,194
594,0.2,"(16, 1)","(8, 20)",8,61,50,119,7,100,161,268
595,0.16,"(6, 18)","(21, 27)",10,97,90,197,9,112,196,317
596,0.06,"(15, 14)","(29, 15)",8,163,146,317,7,130,331,468
597,0.08,"(11, 14)","(26, 1)",5,103,84,192,4,73,55,132
598,0.02,"(10, 5)","(25, 23)",10,151,137,298,5,157,212,374
599,0.18,"(5, 28)","(27, 25)",4,109,96,209,12,118,240,370
600,0.1,"(1, 11)","(15, 24)",3,136,119,258,3,79,61,143
601,0.06,"(24, 29)","(26, 26)",13,64,62,139,12,103,72,187
602,0.12,"(1, 19)","(0, 27)",4,40,24,68,4,73,103,180
603,0.2,"(11, 21)","(19, 16)",4,88,76,168,4,85,76,165
604,0.18,"(13, 21)","(5, 1)",24,244,252,520,7,82,113,202
605,0.02,"(9, 6)","(1, 15)",3,100,74,177,13,163,215,391
606,0.1,"(10, 20)","(14, 17)",4,40,25,69,8,109,126,243
607,0.2,"(3, 4)","(2, 27)",6,145,134,285,5,82,212,299
608,0.16,"(7, 27)","(19, 4)",6,97,87,190,4,97,121,222
609,0.08,"(14, 25)","(8, 1)",5,103,91,199,13,109,131,253
610,0.06,"(9, 25)","(6, 19)",7,64,51,122,3,91,49,143
611,0.02,"(26, 20)","(17, 22)",8,115,97,220,9,169,197,375
612,0.02,"(20, 4)","(18, 18)",35,214,224,473,24,199,377,600
613,0.08,"(25, 0)","(9, 5)",13,85,78,176,8,64,47,119
614,0.2,"(24, 16)","(27, 7)",11,94,90,195,10,76,49,135
615,0.06,"(11, 17)","(27, 6)",7,76,67,150,12,115,131,258
616,0.1,"(10, 12)","(29, 16)",8,118,112,238,8,85,85,178
617,0.16,"(10, 29)","(12, 4)",21,133,138,292,9,97,78,184
618,0.1,"(15, 11)","(1, 7)",4,112,93,209,5,112,168,285
619,0.18,"(20, 6)","(25, 11)",14,64,60,138,5,64,30,99
620,0.04,"(0, 22)","(15, 19)",4,100,74,178,11,121,117,249
621,0.1,"(23, 25)","(16, 3)",6,130,119,255,24,103,391,518
622,0.12,"(13, 16)","(26, 0)",7,85,76,168,11,91,101,203
623,0.02,"(23, 23)","(28, 26)",4,172,119,295,4,106,72,182
624,0.06,"(9, 14)","(21, 29)",9,76,67,152,5,76,59,140
625,0.14,"(4, 21)","(4, 5)",7,121,108,236,12,97,134,243
626,0.1,"(3, 10)","(15, 13)",4,64,55,123,7,76,62,145
627,0.02,"(15, 25)","(19, 13)",5,166,132,303,6,109,145,260
628,0.2,"(19, 24)","(4, 25)",6,88,74,168,11,103,209,323
629,0.1,"(9, 13)","(27, 19)",4,106,93,203,4,70,118,192
630,0.14,"(11, 25)","(13, 24)",34,25,46,105,12,82,52,146
631,0.2,"(7, 9)","(16, 22)",12,43,39,94,7,91,96,194
632,0.08,"(13, 28)","(17, 12)",4,40,30,74,6,91,52,149
633,0.14,"(0, 25)","(13, 23)",8,76,67,151,6,91,100,197
634,0.02,"(18, 0)","(23, 11)",4,97,62,163,8,115,93,216
635,0.2,"(9, 28)","(26, 14)",4,94,80,178,4,79,150,233
636,0.12,"(9, 4)","(27, 5)",3,112,91,206,5,94,131,230
637,0.1,"(29, 19)","(15, 16)",3,94,83,180,8,70,63,141
638,0.1,"(17, 20)","(26, 14)",15,58,56,129,6,85,104,195
639,0.06,"(27, 2)","(10, 20)",6,118,102,226,17,127,162,306
640,0.12,"(26, 11)","(5, 23)",9,70,59,138,4,97,167,268
641,0.1,"(27, 6)","(14, 26)",5,136,121,262,6,73,93,172
642,0.14,"(13, 29)","(1, 29)",20,214,217,451,2,70,39,111
643,0.12,"(28, 17)","(24, 22)",8,55,38,101,5,64,31,100
644,0.14,"(28, 20)","(14, 9)",38,85,103,226,6,100,177,283
645,0.2,"(19, 16)","(16, 21)",3,49,34,86,7,76,45,128
646,0.14,"(25, 1)","(27, 19)",7,88,73,168,6,100,213,319
647,0.18,"(10, 24)","(22, 18)",10,73,68,151,4,100,256,360
648,0.12,"(5, 3)","(4, 22)",4,64,54,122,9,88,85,182
649,0.14,"(20, 11)","(0, 7)",8,64,57,129,9,73,140,222
650,0.18,"(16, 26)","(20, 18)",5,112,97,214,3,91,151,245
651,0.16,"(27, 6)","(27, 21)",6,118,108,232,5,79,82,166
652,0.2,"(25, 0)","(23, 16)",5,133,122,260,5,70,40,115
653,0.14,"(2, 11)","(10, 19)",4,46,35,85,6,79,87,172
654,0.06,"(28, 24)","(16, 24)",4,91,78,173,4,121,83,208
655,0.2,"(0, 7)","(18, 10)",7,73,62,142,4,121,335,460
656,0.06,"(5, 6)","(14, 26)",8,142,128,278,6,94,135,235
657,0.06,"(19, 2)","(8, 20)",4,118,101,223,6,130,261,397
658,0.06,"(5, 9)","(19, 1)",8,91,83,182,5,79,98,182
659,0.08,"(24, 16)","(28, 1)",6,91,79,176,16,88,121,225
660,0.14,"(1, 26)","(1, 8)",5,61,49,115,7,70,45,122
661,0.12,"(10, 15)","(0, 20)",14,106,105,225,5,85,107,197
662,0.16,"(0, 25)","(21, 16)",7,100,93,200,10,103,242,355
663,0.1,"(1, 7)","(21, 2)",4,85,76,165,11,88,102,201
664,0.18,"(24, 3)","(7, 20)",5,79,70,154,4,82,205,291
665,0.2,"(6, 24)","(29, 4)",6,232,220,458,6,82,87,175
666,0.06,"(19, 0)","(15, 15)",9,37,33,79,4,82,62,148
667,0.16,"(27, 6)","(4, 2)",9,94,83,186,7,76,74,157
668,0.14,"(16, 10)","(9, 0)",9,127,120,256,4,70,94,168
669,0.1,"(27, 16)","(2, 21)",6,103,94,203,6,94,128,228
670,0.04,"(17, 8)","(2, 13)",8,82,69,159,8,145,215,368
671,0.06,"(1, 25)","(1, 2)",5,91,75,171,6,73,93,172
672,0.18,"(26, 3)","(29, 29)",12,94,92,198,7,91,214,312
673,0.06,"(23, 4)","(3, 10)",6,109,95,210,5,82,132,219
674,0.04,"(12, 12)","(24, 23)",12,112,95,219,11,73,112,196
675,0.14,"(2, 24)","(8, 5)",5,121,107,233,11,100,151,262
676,0.16,"(17, 18)","(27, 8)",5,43,35,83,5,103,157,265
677,0.08,"(5, 12)","(6, 8)",11,40,36,87,7,64,27,98
678,0.12,"(8, 7)","(3, 0)",8,130,119,257,8,64,21,93
679,0.12,"(23, 16)","(29, 22)",7,154,144,305,7,70,68,145
680,0.06,"(1, 2)","(29, 3)",5,79,63,147,7,88,173,268
681,0.06,"(19, 9)","(26, 0)",17,61,59,137,17,85,152,254
682,0.18,"(4, 26)","(5, 17)",11,55,48,114,7,91,112,210
683,0.1,"(29, 26)","(5, 16)",8,121,105,234,2,118,182,302
684,0.18,"(4, 11)","(22, 2)",22,124,131,277,6,109,290,405
685,0.04,"(7, 17)","(21, 26)",6,94,86,186,4,142,217,363
686,0.04,"(1, 14)","(8, 8)",10,67,57,134,5,97,106,208
687,0.16,"(19, 20)","(24, 23)",7,67,59,133,10,79,95,184
688,0.02,"(27, 13)","(8, 13)",7,142,116,265,45,157,246,448
689,0.14,"(5, 27)","(29, 19)",35,184,203,422,15,91,138,244
690,0.06,"(1, 10)","(24, 0)",8,127,117,252,8,85,78,171
691,0.16,"(18, 24)","(8, 12)",12,70,67,149,16,76,75,167
692,0.06,"(2, 28)","(22, 7)",8,136,124,268,5,109,106,220
693,0.04,"(6, 0)","(17, 7)",9,67,54,130,12,82,91,185
694,0.14,"(5, 4)","(29, 0)",8,226,220,454,9,76,81,166
695,0.1,"(20, 29)","(24, 7)",8,124,112,244,7,103,104,214
696,0.06,"(3, 13)","(13, 0)",5,73,55,133,14,79,93,186
697,0.06,"(25, 29)","(29, 23)",5,34,21,60,8,109,91,208
698,0.18,"(8, 20)","(19, 5)",8,100,90,198,25,88,143,256
699,0.18,"(27, 9)","(2, 29)",14,163,164,341,8,76,60,144
700,0.12,"(14, 3)","(10, 4)",11,82,76,169,5,67,23,95
701,0.02,"(26, 29)","(23, 18)",5,106,96,207,8,88,123,219
702,0.18,"(4, 3)","(12, 22)",7,46,38,91,10,70,53,133
703,0.1,"(2, 2)","(6, 15)",3,46,33,82,4,76,50,130
704,0.02,"(28, 23)","(3, 4)",16,70,68,154,6,124,136,266
705,0.16,"(22, 6)","(22, 20)",5,112,104,221,13,79,68,160
706,0.1,"(15, 23)","(6, 1)",8,73,58,139,35,118,129,282
707,0.2,"(25, 25)","(0, 15)",3,115,98,216,7,76,154,237
708,0.1,"(3, 22)","(11, 26)",6,67,55,128,10,70,47,127
709,0.08,"(2, 2)","(0, 13)",16,37,38,91,5,106,178,289
710,0.16,"(29, 0)","(15, 26)",2,94,83,179,4,100,181,285
711,0.04,"(28, 22)","(6, 4)",5,181,166,352,6,127,173,306
712,0.18,"(15, 16)","(12, 29)",33,121,138,292,5,82,48,135
713,0.12,"(2, 4)","(5, 9)",10,58,51,119,16,70,57,143
714,0.08,"(29, 13)","(15, 11)",3,46,36,85,3,100,167,270
715,0.04,"(28, 3)","(21, 2)",8,28,19,55,5,106,74,185
716,0.1,"(21, 20)","(25, 23)",9,46,40,95,5,100,148,253
717,0.02,"(9, 12)","(7, 11)",16,22,22,60,11,67,19,97
718,0.12,"(5, 10)","(12, 23)",4,91,76,171,6,115,190,311
719,0.14,"(1, 17)","(15, 13)",3,124,112,239,4,73,57,134
720,0.12,"(2, 5)","(9, 2)",12,67,58,137,6,70,39,115
721,0.14,"(3, 26)","(19, 0)",10,142,137,289,4,88,173,265
722,0.1,"(14, 17)","(7, 26)",5,184,173,362,31,121,281,433
723,0.18,"(19, 15)","(16, 1)",12,124,121,257,7,82,85,174
724,0.18,"(13, 27)","(14, 11)",5,70,56,131,5,85,90,180
725,0.06,"(21, 18)","(20, 20)",7,52,34,93,8,1,8,17
726,0.08,"(8, 8)","(25, 29)",6,88,79,173,5,106,137,248
727,0.2,"(11, 29)","(19, 28)",12,43,38,93,6,67,43,116
728,0.16,"(0, 2)","(15, 27)",6,124,117,247,11,103,278,392
729,0.06,"(27, 15)","(17, 15)",7,22,16,45,7,61,16,84
730,0.12,"(23, 26)","(17, 13)",6,148,137,291,24,100,181,305
731,0.14,"(1, 13)","(19, 7)",5,115,97,217,11,100,191,302
732,0.12,"(21, 17)","(16, 25)",15,94,95,204,8,76,37,121
733,0.18,"(8, 8)","(29, 21)",10,217,211,438,6,73,104,183
734,0.06,"(29, 4)","(25, 9)",8,34,24,66,8,73,39,120
735,0.16,"(13, 20)","(13, 29)",6,52,43,101,13,76,62,151
736,0.12,"(26, 21)","(7, 6)",37,52,69,158,14,88,85,187
737,0.12,"(9, 21)","(29, 16)",5,91,80,176,6,100,173,279
738,0.06,"(23, 3)","(4, 13)",5,103,87,195,4,103,159,266
739,0.2,"(12, 8)","(26, 27)",14,118,115,247,13,91,103,207
740,0.12,"(9, 24)","(7, 3)",3,100,90,193,9,79,111,199
741,0.12,"(18, 20)","(23, 15)",6,58,47,111,8,100,167,275
742,0.14,"(25, 29)","(12, 24)",7,49,43,99,3,73,39,115
743,0.2,"(22, 16)","(26, 28)",5,46,36,87,6,70,125,201
744,0.2,"(15, 3)","(10, 9)",7,73,63,143,4,91,129,224
745,0.06,"(24, 8)","(17, 6)",36,37,52,125,14,61,22,97
746,0.18,"(26, 18)","(28, 7)",7,58,50,115,11,70,70,151
747,0.18,"(14, 23)","(22, 9)",6,115,105,226,6,88,111,205
748,0.1,"(20, 27)","(18, 22)",11,76,59,146,8,67,43,118
749,0.16,"(23, 14)","(12, 15)",10,43,38,91,8,73,30,111
750,0.16,"(23, 12)","(28, 14)",10,52,43,105,9,70,66,145
751,0.2,"(13, 6)","(0, 26)",3,157,136,296,7,67,95,169
752,0.06,"(18, 18)","(2, 9)",8,79,73,160,11,100,175,286
753,0.18,"(16, 20)","(14, 0)",5,130,119,254,5,88,97,190
754,0.02,"(25, 12)","(23, 5)",4,172,127,303,5,148,338,491
755,0.18,"(13, 8)","(14, 24)",12,82,80,174,5,106,148,259
756,0.1,"(0, 15)","(23, 24)",8,199,192,399,6,76,72,154
757,0.16,"(18, 6)","(11, 2)",8,133,121,262,6,82,87,175
758,0.16,"(29, 0)","(17, 24)",13,121,112,246,8,91,321,420
759,0.14,"(0, 3)","(24, 28)",5,94,84,183,8,91,113,212
760,0.04,"(23, 21)","(14, 20)",4,25,14,43,6,76,31,113
761,0.04,"(10, 2)","(23, 15)",9,124,111,244,3,88,96,187
762,0.14,"(17, 20)","(17, 9)",7,88,80,175,14,73,78,165
763,0.12,"(27, 28)","(27, 25)",3,40,22,65,8,82,47,137
764,0.14,"(3, 8)","(25, 16)",5,148,137,290,11,73,81,165
765,0.1,"(2, 19)","(27, 22)",9,148,134,291,5,97,150,252
766,0.02,"(26, 4)","(8, 20)",7,100,88,195,7,202,275,484
767,0.14,"(21, 23)","(0, 18)",7,100,87,194,16,64,51,131
768,0.18,"(7, 5)","(15, 26)",4,58,47,109,10,85,196,291
769,0.16,"(10, 5)","(14, 19)",6,46,35,87,4,82,128,214
770,0.08,"(8, 15)","(25, 19)",7,166,151,324,8,73,77,158
771,0.18,"(13, 3)","(29, 8)",6,61,47,114,3,70,104,177
772,0.04,"(17, 4)","(8, 7)",6,67,43,116,5,130,180,315
773,0.02,"(1, 3)","(8, 17)",8,202,175,385,4,112,110,226
774,0.18,"(9, 23)","(0, 27)",12,196,193,401,11,82,160,253
775,0.1,"(13, 1)","(10, 5)",5,34,22,61,3,76,34,113
776,0.1,"(25, 20)","(18, 16)",7,34,27,68,6,76,41,123
777,0.1,"(8, 9)","(23, 16)",44,52,81,177,92,106,377,575
778,0.16,"(24, 25)","(23, 5)",8,85,80,173,6,88,101,195
779,0.18,"(20, 17)","(5, 15)",9,76,65,150,4,88,94,186
780,0.18,"(13, 15)","(13, 13)",8,19,11,38,7,61,19,87
781,0.2,"(5, 4)","(21, 14)",2,85,67,154,4,115,237,356
782,0.06,"(9, 1)","(27, 16)",10,142,119,271,19,79,132,230
783,0.14,"(27, 22)","(18, 2)",8,55,48,111,3,85,188,276
784,0.16,"(7, 12)","(8, 0)",8,49,43,100,13,91,192,296
785,0.08,"(28, 26)","(25, 12)",5,52,40,97,4,91,57,152
786,0.08,"(9, 5)","(18, 28)",12,103,97,212,7,94,100,201
787,0.18,"(29, 26)","(16, 8)",8,82,72,162,7,85,201,293
788,0.2,"(28, 25)","(14, 21)",3,79,67,149,5,88,106,199
789,0.08,"(25, 25)","(18, 2)",6,73,62,141,8,85,91,184
790,0.04,"(11, 12)","(9, 14)",10,16,13,39,15,31,16,62
791,0.02,"(6, 22)","(7, 4)",8,130,121,259,11,103,151,265
792,0.06,"(13, 15)","(27, 11)",13,160,149,322,9,97,178,284
793,0.16,"(21, 0)","(13, 27)",7,103,94,204,6,88,117,211
794,0.18,"(25, 21)","(4, 7)",9,61,57,127,5,82,133,220
795,0.14,"(18, 14)","(2, 7)",9,85,76,170,7,76,68,151
796,0.02,"(23, 6)","(20, 17)",12,94,81,187,4,163,422,589
797,0.12,"(27, 19)","(19, 29)",17,175,177,369,11,88,145,244
798,0.1,"(14, 14)","(5, 14)",7,49,36,92,7,64,26,97
799,0.1,"(10, 27)","(25, 24)",4,70,56,130,8,109,186,303
800,0.14,"(26, 19)","(5, 2)",7,61,55,123,5,76,131,212
801,0.12,"(12, 16)","(7, 12)",7,40,31,78,18,73,49,140
802,0.14,"(16, 11)","(29, 19)",9,148,142,299,8,67,91,166
803,0.04,"(29, 28)","(21, 4)",4,106,89,199,5,82,101,188
804,0.1,"(3, 14)","(27, 24)",7,103,91,201,20,82,92,194
805,0.12,"(1, 29)","(27, 28)",5,184,169,358,5,94,125,224
806,0.1,"(9, 11)","(16, 19)",3,151,137,291,8,88,126,222
807,0.12,"(15, 18)","(17, 21)",5,85,69,159,5,79,53,137
808,0.12,"(4, 15)","(1, 27)",4,139,124,267,4,82,57,143
809,0.08,"(27, 6)","(18, 20)",6,124,109,239,7,109,187,303
810,0.14,"(18, 10)","(7, 28)",3,100,85,188,5,115,305,425
811,0.16,"(16, 3)","(11, 3)",9,52,46,107,5,61,14,80
812,0.14,"(25, 5)","(14, 7)",7,37,30,74,6,82,41,129
813,0.04,"(11, 24)","(10, 4)",20,52,56,128,29,94,103,226
814,0.02,"(25, 10)","(5, 29)",15,91,85,191,5,103,112,220
815,0.04,"(2, 12)","(10, 18)",6,130,116,252,8,139,275,422
816,0.02,"(10, 25)","(19, 27)",10,67,49,126,10,136,195,341
817,0.1,"(22, 27)","(0, 15)",7,73,58,138,8,94,150,252
818,0.14,"(1, 11)","(25, 9)",8,169,164,341,9,91,172,272
819,0.02,"(25, 9)","(23, 0)",7,85,60,152,10,115,125,250
820,0.14,"(23, 2)","(25, 23)",5,205,194,404,6,106,126,238
821,0.02,"(19, 0)","(25, 7)",9,148,109,266,18,139,176,333
822,0.06,"(11, 3)","(13, 10)",9,40,34,83,6,67,28,101
823,0.04,"(21, 21)","(3, 21)",8,139,113,260,32,97,103,232
824,0.08,"(14, 0)","(25, 12)",13,79,79,171,7,109,137,253
825,0.2,"(3, 11)","(18, 21)",7,49,41,97,9,100,150,259
826,0.14,"(14, 4)","(13, 23)",6,79,66,151,8,82,57,147
827,0.2,"(24, 29)","(27, 9)",6,121,112,239,5,73,115,193
828,0.14,"(12, 25)","(21, 7)",18,82,79,179,10,100,170,280
829,0.06,"(18, 27)","(25, 24)",9,85,65,159,14,79,51,144
830,0.08,"(15, 11)","(9, 10)",5,67,51,123,12,82,73,167
831,0.04,"(0, 24)","(11, 7)",13,106,86,205,11,127,264,402
832,0.08,"(10, 1)","(19, 19)",2,106,89,197,5,85,116,206
833,0.06,"(17, 11)","(15, 22)",4,127,103,234,8,97,128,233
834,0.08,"(21, 8)","(18, 0)",8,97,89,194,9,82,86,177
835,0.04,"(1, 20)","(25, 10)",6,67,57,130,5,127,163,295
836,0.18,"(8, 29)","(24, 7)",10,91,88,189,7,79,105,191
837,0.1,"(2, 14)","(25, 14)",7,181,163,351,5,70,68,143
838,0.18,"(13, 0)","(29, 18)",4,211,191,406,6,79,109,194
839,0.04,"(13, 0)","(15, 13)",11,79,75,165,3,73,49,125
840,0.16,"(5, 29)","(16, 7)",9,106,94,209,8,82,110,200
841,0.18,"(3, 29)","(1, 9)",7,154,147,308,4,79,119,202
842,0.14,"(20, 0)","(26, 24)",6,226,208,440,2,67,56,125
843,0.06,"(3, 0)","(21, 14)",3,73,58,134,3,82,138,223
844,0.12,"(12, 28)","(23, 20)",24,121,131,276,9,94,87,190
845,0.14,"(1, 12)","(26, 3)",22,112,119,253,11,97,148,256
846,0.12,"(6, 28)","(25, 1)",4,73,58,135,5,76,76,157
847,0.02,"(16, 29)","(7, 8)",11,202,187,400,5,136,225,366
848,0.02,"(12, 25)","(11, 14)",16,106,87,209,7,73,45,125
849,0.18,"(3, 7)","(4, 29)",6,70,57,133,5,73,49,127
850,0.12,"(14, 28)","(16, 11)",4,82,63,149,5,97,114,216
851,0.08,"(21, 27)","(10, 17)",4,100,78,182,6,100,88,194
852,0.02,"(18, 19)","(17, 5)",9,97,81,187,6,85,102,193
853,0.02,"(2, 0)","(19, 15)",12,115,109,236,3,88,76,167
854,0.08,"(4, 10)","(12, 7)",7,130,114,251,4,97,102,203
855,0.02,"(1, 26)","(8, 28)",3,73,60,136,7,130,126,263
856,0.18,"(26, 11)","(19, 24)",7,58,47,112,5,85,75,165
857,0.2,"(3, 12)","(21, 12)",6,115,107,228,9,79,93,181
858,0.04,"(3, 24)","(18, 14)",9,82,75,166,5,106,150,261
859,0.1,"(8, 5)","(13, 23)",6,85,70,161,8,103,153,264
860,0.16,"(16, 18)","(25, 19)",11,64,57,132,12,100,108,220
861,0.1,"(28, 25)","(2, 19)",6,70,57,133,4,94,195,293
862,0.16,"(28, 18)","(0, 16)",4,91,78,173,9,70,92,171
863,0.06,"(14, 10)","(22, 3)",8,58,53,119,7,136,154,297
864,0.04,"(8, 28)","(28, 14)",3,76,59,138,5,88,163,256
865,0.18,"(25, 29)","(13, 27)",8,31,26,65,30,85,131,246
866,0.2,"(28, 3)","(14, 25)",8,124,117,249,7,112,419,538
867,0.12,"(19, 15)","(14, 9)",15,31,28,74,25,76,46,147
868,0.1,"(17, 26)","(8, 22)",4,37,25,66,4,88,62,154
869,0.16,"(25, 24)","(17, 23)",5,49,37,91,13,61,23,97
870,0.1,"(9, 0)","(16, 26)",8,103,91,202,10,94,123,227
871,0.14,"(29, 10)","(26, 15)",15,46,43,104,15,61,39,115
872,0.06,"(4, 27)","(2, 13)",13,88,80,181,8,94,158,260
873,0.14,"(18, 24)","(21, 18)",14,22,21,57,6,79,32,117
874,0.1,"(21, 0)","(16, 1)",5,67,52,124,3,61,16,80
875,0.12,"(29, 9)","(23, 22)",15,61,63,139,3,88,128,219
876,0.06,"(8, 21)","(2, 9)",5,109,93,207,4,82,38,124
877,0.06,"(24, 8)","(28, 26)",17,112,116,245,11,88,128,227
878,0.14,"(22, 3)","(14, 0)",13,34,28,75,9,82,44,135
879,0.06,"(3, 25)","(5, 23)",4,43,28,75,3,70,15,88
880,0.12,"(15, 1)","(15, 11)",4,73,64,141,8,85,115,208
881,0.12,"(20, 19)","(14, 16)",13,19,19,51,9,70,44,123
882,0.1,"(21, 24)","(5, 19)",8,76,66,150,11,109,97,217
883,0.02,"(19, 1)","(25, 10)",7,235,211,453,8,79,51,138
884,0.14,"(24, 22)","(5, 12)",10,73,70,153,8,91,72,171
885,0.12,"(6, 9)","(10, 15)",5,40,26,71,4,67,35,106
886,0.14,"(19, 28)","(16, 27)",3,25,13,41,7,61,16,84
887,0.2,"(27, 9)","(12, 27)",6,118,105,229,8,76,122,206
888,0.02,"(3, 3)","(2, 13)",6,64,44,114,7,94,123,224
889,0.12,"(7, 13)","(15, 16)",9,76,69,154,6,91,70,167
890,0.08,"(0, 13)","(24, 19)",4,184,165,353,11,82,99,192
891,0.06,"(16, 12)","(23, 11)",6,79,70,155,12,118,202,332
892,0.1,"(17, 14)","(28, 7)",6,79,72,157,9,70,56,135
893,0.04,"(7, 23)","(4, 2)",19,97,89,205,11,115,178,304
894,0.16,"(10, 12)","(11, 0)",8,67,60,135,8,70,88,166
895,0.14,"(29, 6)","(3, 10)",7,160,140,307,6,94,138,238
896,0.08,"(4, 19)","(11, 3)",2,55,40,97,2,97,212,311
897,0.1,"(29, 2)","(1, 11)",3,64,52,119,3,112,135,250
898,0.02,"(22, 12)","(5, 1)",4,88,73,165,12,100,88,200
899,0.14,"(16, 12)","(19, 16)",7,43,33,83,5,79,35,119
900,0.1,"(29, 21)","(2, 14)",13,109,96,218,6,97,121,224
901,0.06,"(16, 24)","(10, 18)",5,91,71,167,7,91,77,175
902,0.08,"(14, 13)","(28, 13)",3,85,75,163,3,82,118,203
903,0.12,"(14, 14)","(25, 12)",5,55,41,101,4,67,63,134
904,0.2,"(15, 8)","(28, 6)",5,73,60,138,4,94,115,213
905,0.16,"(16, 16)","(8, 1)",12,97,91,200,13,70,99,182
906,0.02,"(8, 8)","(20, 20)",6,118,105,229,3,148,141,292
907,0.18,"(5, 19)","(4, 8)",8,148,137,293,16,76,116,208
908,0.14,"(13, 13)","(6, 20)",9,70,63,142,8,76,62,146
909,0.06,"(9, 18)","(22, 8)",9,106,102,217,6,124,238,368
910,0.14,"(20, 6)","(9, 23)",9,139,127,275,4,82,94,180
911,0.12,"(7, 17)","(4, 28)",4,49,37,90,9,61,38,108
912,0.02,"(17, 2)","(29, 27)",13,157,154,324,4,76,57,137
913,0.16,"(2, 6)","(21, 27)",6,85,71,162,3,88,125,216
914,0.04,"(29, 17)","(7, 24)",3,157,129,289,4,76,87,167
915,0.16,"(22, 1)","(16, 15)",4,37,26,67,7,115,274,396
916,0.18,"(14, 5)","(2, 13)",7,76,65,148,13,100,162,275
917,0.1,"(16, 19)","(17, 12)",6,145,134,285,9,82,42,133
918,0.04,"(1, 16)","(26, 9)",7,142,113,262,6,133,236,375
919,0.08,"(19, 22)","(29, 6)",6,103,87,196,6,70,68,144
920,0.06,"(9, 3)","(2, 26)",8,115,104,227,8,112,138,258
921,0.06,"(10, 11)","(12, 28)",11,139,120,270,5,97,101,203
922,0.06,"(2, 25)","(22, 8)",5,163,143,311,8,133,211,352
923,0.02,"(12, 14)","(2, 3)",10,223,209,442,7,88,202,297
924,0.2,"(1, 21)","(23, 16)",5,58,47,110,17,79,102,198
925,0.1,"(0, 14)","(19, 20)",4,130,111,245,6,76,126,208
926,0.14,"(1, 13)","(27, 29)",8,97,92,197,14,76,113,203
927,0.2,"(14, 0)","(24, 18)",3,103,86,192,3,82,149,234
928,0.06,"(8, 19)","(18, 4)",5,121,99,225,6,133,215,354
929,0.02,"(9, 21)","(5, 8)",7,40,34,81,7,100,73,180
930,0.16,"(15, 28)","(1, 25)",8,106,97,211,10,85,133,228
931,0.04,"(24, 21)","(28, 22)",5,76,52,133,6,73,16,95
932,0.04,"(19, 10)","(26, 21)",7,76,66,149,3,97,172,272
933,0.1,"(25, 2)","(16, 21)",9,97,81,187,9,103,132,244
934,0.2,"(29, 16)","(25, 26)",4,148,139,291,3,73,49,125
935,0.12,"(17, 13)","(15, 22)",8,142,131,281,13,64,73,150
936,0.02,"(3, 15)","(24, 3)",4,109,90,203,6,115,104,225
937,0.18,"(20, 16)","(7, 25)",4,79,64,147,8,85,119,212
938,0.06,"(6, 1)","(24, 10)",6,94,82,182,4,94,107,205
939,0.14,"(7, 24)","(13, 22)",19,31,30,80,4,70,62,136
940,0.12,"(4, 18)","(27, 16)",4,97,82,183,7,112,210,329
941,0.04,"(6, 9)","(12, 3)",4,88,65,157,5,91,92,188
942,0.08,"(28, 13)","(27, 16)",14,28,27,69,4,85,71,160
943,0.04,"(15, 13)","(26, 2)",5,136,123,264,10,109,150,269
944,0.02,"(16, 12)","(8, 6)",6,175,151,332,22,139,174,335
945,0.12,"(19, 12)","(6, 2)",14,118,102,234,13,82,195,290
946,0.16,"(0, 27)","(23, 3)",11,82,73,166,9,112,178,299
947,0.18,"(13, 2)","(16, 0)",13,40,39,92,7,67,38,112
948,0.16,"(21, 24)","(11, 15)",8,160,150,318,22,94,134,250
949,0.02,"(12, 5)","(25, 1)",7,76,60,143,9,148,275,432
950,0.12,"(22, 20)","(1, 10)",28,82,88,198,5,121,212,338
951,0.2,"(20, 13)","(15, 29)",7,88,82,177,11,97,76,184
952,0.14,"(2, 4)","(1, 26)",40,133,158,331,7,76,121,204
953,0.14,"(11, 6)","(4, 27)",12,112,108,232,3,85,101,189
954,0.2,"(20, 28)","(1, 3)",6,247,232,485,6,106,284,396
955,0.18,"(4, 10)","(21, 24)",6,196,185,387,11,82,115,208
956,0.1,"(26, 8)","(10, 29)",13,67,66,146,9,70,78,157
957,0.1,"(17, 6)","(17, 9)",7,34,26,67,5,70,38,113
958,0.14,"(25, 12)","(3, 11)",11,130,123,264,8,70,42,120
959,0.1,"(13, 20)","(18, 2)",12,184,173,369,4,88,122,214
960,0.02,"(0, 2)","(10, 9)",3,49,39,91,3,82,81,166
961,0.18,"(8, 11)","(16, 0)",4,157,138,299,11,79,123,213
962,0.02,"(12, 20)","(16, 27)",9,49,34,92,7,106,199,312
963,0.14,"(21, 7)","(26, 0)",6,85,77,168,4,67,61,132
964,0.08,"(0, 22)","(5, 14)",5,31,20,56,2,73,32,107
965,0.04,"(4, 0)","(5, 10)",7,148,132,287,8,109,70,187
966,0.16,"(5, 13)","(27, 6)",12,82,78,172,11,91,205,307
967,0.12,"(12, 2)","(4, 15)",4,124,110,238,4,100,167,271
968,0.02,"(4, 8)","(22, 15)",6,94,65,165,4,76,75,155
969,0.06,"(29, 5)","(14, 19)",2,109,89,200,5,139,216,360
970,0.18,"(17, 23)","(20, 19)",10,73,63,146,4,91,54,149
971,0.02,"(23, 6)","(8, 11)",6,160,136,302,8,103,105,216
972,0.14,"(22, 8)","(20, 22)",12,67,66,145,13,130,657,800
973,0.12,"(25, 21)","(4, 11)",11,88,85,184,11,82,168,261
974,0.08,"(27, 22)","(16, 28)",8,49,40,97,18,88,67,173
975,0.08,"(1, 11)","(3, 0)",3,88,75,166,4,70,117,191
976,0.2,"(5, 4)","(19, 13)",30,49,60,139,8,91,147,246
977,0.06,"(10, 3)","(23, 2)",9,82,72,163,6,85,93,184
978,0.02,"(23, 20)","(12, 20)",6,139,111,256,11,136,135,282
979,0.12,"(24, 8)","(6, 24)",10,103,95,208,10,103,205,318
980,0.14,"(5, 11)","(24, 8)",10,136,130,276,4,91,73,168
981,0.1,"(23, 18)","(4, 13)",8,286,275,569,12,118,239,369
982,0.12,"(25, 24)","(21, 20)",4,67,43,114,18,70,53,141
983,0.12,"(27, 8)","(22, 2)",6,82,69,157,13,67,32,112
984,0.12,"(13, 12)","(13, 16)",15,82,77,174,5,61,17,83
985,0.04,"(0, 16)","(16, 9)",7,97,78,182,7,139,158,304
986,0.06,"(27, 29)","(19, 4)",13,91,82,186,4,91,141,236
987,0.1,"(7, 23)","(20, 3)",5,190,176,371,10,106,209,325
988,0.16,"(15, 12)","(20, 29)",6,166,156,328,5,115,344,464
989,0.14,"(11, 10)","(9, 14)",6,88,76,170,4,67,23,94
990,0.2,"(10, 7)","(11, 3)",4,28,17,49,10,61,21,92
991,0.02,"(22, 14)","(6, 24)",6,115,90,211,6,157,457,620
992,0.18,"(6, 19)","(2, 20)",23,52,57,132,8,64,18,90
993,0.12,"(29, 0)","(11, 16)",13,163,161,337,6,94,175,275
994,0.06,"(21, 10)","(6, 3)",5,127,117,249,9,94,102,205
995,0.18,"(10, 8)","(12, 26)",7,94,81,182,5,82,112,199
996,0.1,"(16, 7)","(3, 5)",13,58,52,123,4,88,63,155
997,0.18,"(18, 3)","(11, 20)",5,109,93,207,5,121,156,282
998,0.02,"(21, 14)","(20, 23)",7,70,53,130,6,106,101,213
999,0.02,"(26, 0)","(0, 2)",4,109,86,199,6,85,100,191
,,,,8.257,99.142,88.278,195.677,7.971,90.577,120.121,218.669
