0,0.08,"(3, 17)","(15, 11)",9,161,78,248,5,241,145,391
1,0.1,"(15, 0)","(29, 8)",6,121,131,258,11,151,137,299
2,0.18,"(4, 9)","(25, 19)",7,121,99,227,12,211,117,340
3,0.08,"(11, 14)","(7, 10)",14,61,31,106,14,121,38,173
4,0.02,"(29, 1)","(8, 7)",17,321,167,505,2,241,114,357
5,0.12,"(14, 28)","(22, 9)",7,81,83,171,17,181,112,310
6,0.12,"(18, 0)","(1, 5)",6,101,159,266,6,61,32,99
7,0.08,"(26, 16)","(24, 9)",6,101,33,140,11,151,52,214
8,0.02,"(10, 18)","(28, 22)",4,161,132,297,4,181,122,307
9,0.18,"(24, 16)","(29, 17)",22,181,84,287,4,121,34,159
10,0.02,"(1, 29)","(1, 4)",8,81,58,147,9,151,67,227
11,0.2,"(25, 1)","(26, 6)",7,101,28,136,5,91,25,121
12,0.14,"(24, 17)","(23, 6)",6,121,59,186,32,121,77,230
13,0.14,"(14, 1)","(24, 17)",8,61,87,156,7,241,147,395
14,0.18,"(1, 14)","(26, 22)",6,101,107,214,7,241,132,380
15,0.1,"(12, 16)","(0, 2)",4,81,133,218,5,91,32,128
16,0.06,"(23, 16)","(3, 23)",9,81,74,164,14,151,74,239
17,0.16,"(29, 23)","(9, 12)",12,81,129,222,3,241,128,372
18,0.14,"(5, 11)","(24, 22)",32,141,112,285,7,121,59,187
19,0.02,"(2, 2)","(20, 7)",6,161,129,296,8,151,101,260
20,0.06,"(13, 3)","(3, 10)",8,101,55,164,8,211,73,292
21,0.12,"(15, 28)","(21, 9)",3,141,103,247,4,181,74,259
22,0.12,"(16, 14)","(5, 20)",10,141,79,230,6,181,77,264
23,0.04,"(18, 24)","(0, 15)",4,101,79,184,6,211,78,295
24,0.18,"(10, 29)","(28, 24)",5,81,158,244,3,181,133,317
25,0.08,"(12, 18)","(15, 1)",9,101,109,219,4,181,91,276
26,0.1,"(6, 23)","(3, 7)",17,101,69,187,8,151,61,220
27,0.14,"(7, 18)","(0, 14)",6,81,37,124,5,91,16,112
28,0.14,"(28, 23)","(0, 15)",6,101,94,201,4,271,122,397
29,0.08,"(24, 4)","(13, 13)",6,181,122,309,9,151,101,261
30,0.08,"(0, 15)","(29, 28)",10,61,58,129,4,121,87,212
31,0.02,"(23, 18)","(27, 3)",4,221,165,390,3,211,101,315
32,0.18,"(2, 13)","(18, 21)",8,181,167,356,13,181,101,295
33,0.2,"(9, 17)","(22, 29)",5,121,103,229,6,91,100,197
34,0.16,"(7, 26)","(12, 28)",14,81,96,191,9,151,89,249
35,0.12,"(21, 13)","(24, 28)",5,161,103,269,5,151,141,297
36,0.2,"(4, 0)","(19, 26)",6,121,100,227,4,151,90,245
37,0.08,"(21, 12)","(25, 10)",19,101,45,165,5,151,35,191
38,0.08,"(29, 0)","(14, 9)",4,101,43,148,7,121,58,186
39,0.1,"(10, 5)","(25, 8)",4,101,93,198,11,151,117,279
40,0.1,"(0, 23)","(6, 21)",4,121,35,160,12,91,34,137
41,0.16,"(0, 24)","(14, 2)",4,81,86,171,9,271,213,493
42,0.18,"(12, 5)","(14, 15)",35,121,88,244,8,211,73,292
43,0.12,"(21, 21)","(25, 10)",9,121,84,214,5,151,116,272
44,0.18,"(10, 7)","(11, 2)",10,101,40,151,5,121,35,161
45,0.14,"(16, 5)","(19, 5)",4,121,28,153,20,121,38,179
46,0.1,"(22, 2)","(25, 23)",9,241,178,428,5,91,79,175
47,0.14,"(22, 1)","(28, 25)",5,121,152,278,10,151,122,283
48,0.02,"(12, 10)","(9, 3)",6,261,76,343,3,211,55,269
49,0.18,"(5, 15)","(13, 0)",7,141,71,219,4,181,118,303
50,0.2,"(18, 24)","(6, 6)",5,101,93,199,5,211,87,303
51,0.14,"(1, 23)","(18, 26)",4,121,119,244,7,151,81,239
52,0.18,"(23, 24)","(14, 3)",9,201,240,450,22,121,144,287
53,0.2,"(21, 24)","(16, 21)",5,41,28,74,7,91,20,118
54,0.16,"(14, 4)","(0, 29)",3,121,130,254,6,151,135,292
55,0.18,"(1, 22)","(26, 12)",5,161,181,347,18,181,121,320
56,0.2,"(25, 24)","(1, 27)",9,81,102,192,5,151,101,257
57,0.08,"(7, 3)","(19, 10)",5,161,100,266,6,151,78,235
58,0.02,"(18, 7)","(10, 12)",4,281,182,467,14,331,85,430
59,0.08,"(29, 1)","(9, 5)",24,121,73,218,6,181,59,246
60,0.06,"(2, 15)","(27, 9)",17,221,148,386,9,241,82,332
61,0.18,"(16, 29)","(21, 25)",2,141,108,251,7,91,42,140
62,0.12,"(20, 15)","(21, 2)",3,141,117,261,3,181,113,297
63,0.1,"(23, 1)","(10, 17)",14,121,83,218,13,241,150,404
64,0.02,"(28, 12)","(27, 5)",8,141,53,202,3,181,47,231
65,0.18,"(8, 14)","(8, 29)",8,121,70,199,10,121,106,237
66,0.16,"(28, 6)","(23, 8)",4,121,63,188,10,121,28,159
67,0.12,"(6, 29)","(28, 18)",6,101,114,221,2,211,135,348
68,0.06,"(11, 12)","(19, 13)",13,201,109,323,6,121,35,162
69,0.1,"(2, 11)","(2, 27)",23,141,79,243,13,91,64,168
70,0.06,"(14, 0)","(11, 13)",20,81,58,159,12,181,101,294
71,0.12,"(7, 27)","(22, 8)",5,121,91,217,9,181,145,335
72,0.14,"(10, 26)","(15, 18)",12,121,111,244,8,121,87,216
73,0.12,"(1, 0)","(5, 0)",8,61,22,91,8,61,17,86
74,0.04,"(4, 23)","(21, 9)",8,221,100,329,5,241,116,362
75,0.04,"(17, 1)","(7, 25)",10,101,72,183,2,181,67,250
76,0.16,"(17, 8)","(27, 26)",10,81,93,184,5,121,94,220
77,0.1,"(10, 14)","(25, 16)",6,161,153,320,10,181,105,296
78,0.18,"(14, 13)","(19, 19)",7,161,130,298,4,211,79,294
79,0.1,"(24, 4)","(25, 10)",10,121,46,177,3,61,29,93
80,0.16,"(8, 24)","(20, 16)",4,101,92,197,5,211,113,329
81,0.16,"(4, 24)","(9, 17)",3,141,60,204,2,121,46,169
82,0.12,"(12, 17)","(28, 17)",3,181,118,302,9,181,91,281
83,0.2,"(16, 6)","(6, 20)",4,141,123,268,16,181,118,315
84,0.2,"(1, 19)","(6, 21)",8,81,60,149,4,91,26,121
85,0.08,"(0, 28)","(10, 27)",3,121,52,176,6,181,43,230
86,0.18,"(29, 16)","(14, 0)",11,61,98,170,6,151,109,266
87,0.06,"(0, 28)","(15, 6)",3,81,105,189,2,211,101,314
88,0.08,"(23, 8)","(13, 7)",8,61,34,103,21,91,41,153
89,0.14,"(14, 26)","(7, 20)",17,61,78,156,7,211,90,308
90,0.1,"(26, 28)","(4, 9)",7,161,104,272,3,151,82,236
91,0.14,"(4, 2)","(5, 23)",9,141,157,307,9,181,127,317
92,0.02,"(13, 15)","(16, 15)",8,201,98,307,4,91,29,124
93,0.08,"(21, 23)","(15, 27)",7,41,28,76,6,151,37,194
94,0.04,"(15, 1)","(5, 26)",8,121,114,243,14,211,81,306
95,0.04,"(13, 25)","(18, 22)",4,261,73,338,8,211,77,296
96,0.12,"(27, 8)","(13, 5)",3,41,20,64,3,271,82,356
97,0.2,"(29, 7)","(5, 12)",22,121,112,255,8,121,117,246
98,0.12,"(27, 7)","(27, 4)",3,101,40,144,5,91,35,131
99,0.2,"(0, 27)","(22, 20)",4,141,115,260,6,91,108,205
100,0.2,"(27, 7)","(22, 2)",4,81,47,132,19,151,91,261
101,0.18,"(5, 21)","(5, 1)",8,121,170,299,5,211,91,307
102,0.12,"(1, 20)","(28, 29)",4,201,168,373,14,151,116,281
103,0.18,"(14, 25)","(8, 25)",13,81,25,119,17,211,87,315
104,0.2,"(2, 28)","(27, 5)",3,61,75,139,10,121,91,222
105,0.14,"(13, 29)","(18, 26)",3,121,57,181,25,211,106,342
106,0.08,"(18, 10)","(13, 18)",7,161,186,354,17,121,62,200
107,0.14,"(28, 11)","(17, 20)",6,121,106,233,7,151,60,218
108,0.02,"(16, 7)","(15, 4)",5,141,33,179,16,181,45,242
109,0.1,"(10, 15)","(28, 10)",4,141,118,263,7,151,76,234
110,0.04,"(19, 20)","(26, 19)",5,61,23,89,12,241,88,341
111,0.1,"(14, 19)","(2, 25)",8,81,68,157,18,121,60,199
112,0.18,"(3, 1)","(8, 2)",28,81,60,169,7,91,27,125
113,0.16,"(22, 11)","(5, 27)",15,121,87,223,5,121,64,190
114,0.08,"(22, 21)","(17, 3)",6,181,139,326,10,181,115,306
115,0.1,"(26, 17)","(29, 20)",6,101,98,205,5,121,47,173
116,0.02,"(16, 26)","(5, 2)",12,101,91,204,7,121,62,190
117,0.2,"(4, 8)","(10, 15)",9,201,228,438,14,181,134,329
118,0.04,"(10, 16)","(26, 27)",13,241,129,383,12,151,103,266
119,0.08,"(9, 7)","(19, 3)",5,121,70,196,8,241,81,330
120,0.06,"(0, 9)","(6, 6)",9,161,40,210,6,151,42,199
121,0.16,"(4, 23)","(17, 22)",10,201,108,319,5,181,92,278
122,0.2,"(9, 11)","(11, 25)",4,101,94,199,5,121,78,204
123,0.12,"(13, 16)","(8, 24)",4,81,46,131,4,271,109,384
124,0.14,"(22, 27)","(20, 22)",6,81,35,122,9,181,37,227
125,0.04,"(15, 4)","(27, 22)",4,161,116,281,4,241,137,382
126,0.08,"(28, 10)","(3, 19)",26,181,149,356,10,61,96,167
127,0.08,"(22, 19)","(23, 9)",13,201,113,327,6,181,80,267
128,0.14,"(6, 26)","(10, 9)",16,201,173,390,8,121,55,184
129,0.04,"(12, 9)","(12, 3)",8,161,95,264,4,241,69,314
130,0.06,"(23, 4)","(15, 5)",7,101,53,161,14,151,58,223
131,0.18,"(15, 25)","(14, 14)",7,141,80,228,4,151,71,226
132,0.1,"(20, 15)","(25, 21)",6,141,75,222,4,331,152,487
133,0.14,"(19, 0)","(11, 14)",5,81,69,155,13,211,192,416
134,0.2,"(28, 15)","(0, 11)",11,101,94,206,8,121,110,239
135,0.02,"(14, 22)","(15, 26)",11,141,36,188,12,301,79,392
136,0.02,"(20, 3)","(29, 25)",7,141,100,248,3,361,116,480
137,0.14,"(5, 18)","(26, 6)",5,141,168,314,8,121,84,213
138,0.02,"(17, 6)","(10, 22)",11,121,69,201,14,211,105,330
139,0.04,"(23, 6)","(21, 23)",6,101,89,196,14,271,119,404
140,0.2,"(28, 27)","(24, 5)",4,141,180,325,7,211,177,395
141,0.18,"(27, 1)","(9, 17)",24,181,151,356,6,241,208,455
142,0.08,"(6, 29)","(15, 25)",4,81,55,140,5,121,59,185
143,0.08,"(24, 7)","(0, 9)",3,121,146,270,8,121,65,194
144,0.1,"(3, 29)","(17, 14)",5,61,148,214,4,181,89,274
145,0.04,"(24, 25)","(9, 18)",29,101,75,205,7,211,76,294
146,0.02,"(19, 25)","(26, 10)",4,201,163,368,5,391,160,556
147,0.02,"(5, 3)","(11, 24)",4,261,95,360,3,241,56,300
148,0.18,"(1, 3)","(24, 23)",7,101,90,198,14,121,126,261
149,0.1,"(1, 14)","(4, 23)",6,101,58,165,6,91,62,159
150,0.14,"(16, 27)","(0, 20)",4,21,28,53,12,151,62,225
151,0.16,"(16, 15)","(13, 1)",7,141,95,243,10,151,88,249
152,0.04,"(4, 22)","(5, 17)",6,101,40,147,11,61,35,107
153,0.1,"(5, 11)","(7, 26)",9,61,44,114,4,121,44,169
154,0.12,"(22, 25)","(22, 22)",8,101,64,173,5,61,47,113
155,0.12,"(24, 4)","(24, 0)",6,81,32,119,6,61,17,84
156,0.08,"(4, 17)","(4, 9)",9,81,62,152,10,91,50,151
157,0.04,"(4, 26)","(5, 17)",5,181,65,251,7,91,26,124
158,0.16,"(25, 16)","(25, 15)",18,41,29,88,5,61,9,75
159,0.06,"(26, 29)","(21, 26)",12,81,29,122,7,151,19,177
160,0.02,"(9, 8)","(20, 15)",8,281,117,406,10,451,137,598
161,0.14,"(15, 13)","(2, 23)",14,141,175,330,15,151,115,281
162,0.08,"(29, 4)","(12, 12)",4,141,71,216,2,151,80,233
163,0.08,"(16, 19)","(24, 20)",6,101,37,144,5,241,78,324
164,0.02,"(12, 4)","(10, 4)",18,261,118,397,10,181,24,215
165,0.14,"(22, 5)","(15, 27)",10,81,120,211,7,181,77,265
166,0.02,"(28, 20)","(0, 10)",15,241,164,420,4,61,46,111
167,0.14,"(26, 18)","(23, 25)",6,141,46,193,7,91,39,137
168,0.16,"(3, 20)","(6, 26)",11,121,35,167,6,211,46,263
169,0.08,"(28, 22)","(26, 2)",8,141,146,295,2,121,92,215
170,0.06,"(5, 5)","(16, 24)",10,141,93,244,6,181,83,270
171,0.04,"(14, 4)","(19, 21)",6,241,164,411,8,241,123,372
172,0.1,"(22, 19)","(18, 23)",6,141,66,213,3,121,16,140
173,0.04,"(25, 3)","(19, 23)",8,101,81,190,19,361,134,514
174,0.18,"(29, 20)","(24, 15)",10,101,102,213,4,151,44,199
175,0.02,"(17, 19)","(23, 6)",5,181,90,276,5,241,114,360
176,0.16,"(4, 23)","(11, 20)",16,101,62,179,4,121,41,166
177,0.12,"(22, 21)","(10, 29)",8,141,95,244,18,151,63,232
178,0.1,"(5, 26)","(17, 1)",3,81,76,160,5,151,52,208
179,0.1,"(3, 14)","(16, 29)",6,61,53,120,8,91,86,185
180,0.1,"(11, 11)","(23, 13)",10,141,123,274,14,211,114,339
181,0.1,"(20, 27)","(11, 1)",4,101,110,215,4,211,112,327
182,0.1,"(2, 16)","(1, 13)",5,41,14,60,3,31,5,39
183,0.12,"(14, 1)","(27, 23)",15,161,131,307,9,181,71,261
184,0.2,"(16, 2)","(23, 19)",12,141,98,251,7,211,127,345
185,0.18,"(22, 17)","(3, 5)",4,141,74,219,8,91,66,165
186,0.08,"(6, 23)","(29, 7)",8,101,88,197,6,61,62,129
187,0.02,"(4, 15)","(12, 26)",6,181,51,238,4,331,146,481
188,0.02,"(26, 8)","(16, 2)",14,421,121,556,6,241,56,303
189,0.02,"(22, 5)","(4, 14)",8,161,87,256,9,301,78,388
190,0.08,"(17, 29)","(21, 28)",7,121,40,168,10,121,45,176
191,0.16,"(10, 13)","(26, 19)",6,161,162,329,10,241,126,377
192,0.06,"(13, 22)","(22, 9)",6,121,90,217,4,211,108,323
193,0.2,"(10, 0)","(3, 19)",4,121,112,237,9,181,119,309
194,0.06,"(21, 17)","(23, 22)",6,61,29,96,6,301,74,381
195,0.1,"(24, 9)","(24, 26)",9,141,128,278,4,151,65,220
196,0.2,"(8, 24)","(7, 29)",17,101,60,178,7,91,41,139
197,0.06,"(10, 14)","(26, 5)",4,101,57,162,5,91,81,177
198,0.2,"(8, 3)","(1, 14)",5,181,135,321,5,151,47,203
199,0.14,"(17, 29)","(25, 23)",3,121,89,213,5,91,68,164
200,0.14,"(23, 27)","(4, 25)",10,81,49,140,4,151,45,200
201,0.04,"(26, 20)","(3, 8)",8,181,125,314,23,181,109,313
202,0.12,"(28, 13)","(8, 6)",5,101,100,206,10,181,94,285
203,0.04,"(7, 2)","(25, 27)",13,81,78,172,9,121,74,204
204,0.16,"(29, 3)","(21, 10)",6,121,112,239,11,91,51,153
205,0.18,"(14, 17)","(10, 22)",4,161,44,209,9,151,71,231
206,0.04,"(21, 5)","(26, 20)",11,121,91,223,8,151,91,250
207,0.08,"(0, 2)","(25, 24)",5,201,139,345,10,181,103,294
208,0.2,"(5, 9)","(1, 12)",12,101,28,141,8,121,20,149
209,0.12,"(28, 10)","(0, 21)",5,61,66,132,3,91,65,159
210,0.04,"(4, 1)","(2, 29)",14,181,153,348,15,181,71,267
211,0.2,"(25, 16)","(4, 17)",9,121,128,258,6,271,107,384
212,0.02,"(12, 6)","(12, 27)",7,201,92,300,6,421,136,563
213,0.08,"(9, 21)","(16, 21)",8,121,70,199,6,181,42,229
214,0.14,"(14, 29)","(26, 18)",4,121,103,228,7,181,146,334
215,0.02,"(23, 27)","(6, 24)",4,201,92,297,8,271,109,388
216,0.2,"(14, 2)","(7, 26)",4,121,94,219,10,241,156,407
217,0.14,"(21, 0)","(4, 24)",5,61,80,146,13,151,92,256
218,0.04,"(23, 19)","(15, 25)",7,141,142,290,16,271,115,402
219,0.06,"(4, 18)","(8, 24)",5,141,117,263,7,211,122,340
220,0.06,"(26, 10)","(11, 27)",18,121,155,294,8,271,94,373
221,0.2,"(2, 0)","(8, 2)",14,61,35,110,12,91,37,140
222,0.2,"(27, 16)","(9, 19)",10,101,55,166,6,211,121,338
223,0.08,"(24, 4)","(16, 15)",13,221,166,400,12,151,73,236
224,0.2,"(19, 23)","(13, 0)",5,61,64,130,8,91,63,162
225,0.02,"(25, 1)","(2, 20)",6,81,85,172,7,121,60,188
226,0.08,"(23, 23)","(4, 0)",12,161,120,293,18,211,101,330
227,0.08,"(3, 21)","(12, 26)",5,81,72,158,6,121,58,185
228,0.12,"(10, 16)","(3, 21)",5,81,53,139,15,61,38,114
229,0.2,"(0, 24)","(2, 5)",9,101,52,162,4,181,170,355
230,0.06,"(29, 24)","(22, 4)",25,41,89,155,56,151,141,348
231,0.18,"(22, 25)","(11, 25)",12,41,25,78,5,121,31,157
232,0.06,"(23, 18)","(19, 12)",7,101,47,155,3,121,55,179
233,0.1,"(11, 23)","(23, 0)",7,81,71,159,6,91,68,165
234,0.02,"(7, 27)","(8, 22)",7,221,79,307,5,91,18,114
235,0.08,"(0, 19)","(19, 3)",19,61,70,150,14,151,108,273
236,0.18,"(10, 4)","(17, 29)",6,61,69,136,8,211,146,365
237,0.06,"(10, 8)","(7, 23)",7,221,139,367,4,181,68,253
238,0.1,"(24, 0)","(10, 12)",7,201,94,302,4,271,95,370
239,0.2,"(16, 10)","(0, 21)",12,81,110,203,5,121,70,196
240,0.16,"(0, 8)","(27, 5)",5,121,123,249,12,181,106,299
241,0.1,"(29, 7)","(13, 2)",6,101,45,152,7,121,41,169
242,0.18,"(27, 1)","(9, 21)",4,141,219,364,4,211,158,373
243,0.18,"(25, 24)","(1, 3)",5,81,63,149,4,91,65,160
244,0.04,"(2, 11)","(22, 2)",6,261,297,564,12,211,120,343
245,0.02,"(23, 17)","(6, 8)",5,141,144,290,10,301,111,422
246,0.02,"(18, 15)","(5, 1)",4,101,76,181,13,271,128,412
247,0.08,"(11, 8)","(16, 3)",5,101,65,171,10,151,53,214
248,0.16,"(23, 28)","(17, 4)",5,121,99,225,12,181,139,332
249,0.02,"(21, 19)","(9, 3)",17,301,143,461,4,301,96,401
250,0.2,"(23, 19)","(16, 18)",5,61,30,96,11,151,39,201
251,0.06,"(27, 0)","(6, 24)",20,121,101,242,14,151,79,244
252,0.18,"(19, 19)","(3, 5)",11,161,224,396,10,151,101,262
253,0.02,"(28, 10)","(16, 4)",9,181,90,280,6,181,57,244
254,0.08,"(3, 13)","(15, 5)",17,121,59,197,8,211,167,386
255,0.14,"(22, 5)","(1, 1)",12,121,129,262,9,121,78,208
256,0.16,"(12, 13)","(20, 5)",12,161,119,292,14,211,147,372
257,0.12,"(16, 19)","(8, 12)",6,161,95,262,4,241,75,320
258,0.2,"(18, 19)","(9, 26)",8,181,197,386,7,151,69,227
259,0.14,"(0, 6)","(18, 25)",12,121,97,230,6,181,121,308
260,0.06,"(16, 16)","(29, 7)",17,61,83,161,4,151,106,261
261,0.12,"(8, 24)","(26, 5)",6,121,71,198,4,211,109,324
262,0.2,"(22, 0)","(5, 4)",6,181,184,371,7,151,170,328
263,0.12,"(22, 21)","(6, 8)",16,121,126,263,20,151,75,246
264,0.06,"(26, 4)","(12, 19)",10,41,76,127,3,91,70,164
265,0.12,"(1, 21)","(10, 0)",7,181,89,277,3,91,52,146
266,0.08,"(8, 27)","(3, 1)",7,261,177,445,5,151,95,251
267,0.16,"(21, 4)","(27, 2)",3,81,28,112,7,121,47,175
268,0.16,"(20, 5)","(8, 28)",4,101,88,193,10,151,96,257
269,0.1,"(29, 3)","(9, 19)",5,81,80,166,12,121,80,213
270,0.12,"(10, 25)","(22, 29)",6,121,123,250,9,61,62,132
271,0.2,"(24, 27)","(18, 25)",17,101,53,171,14,91,28,133
272,0.14,"(21, 0)","(20, 0)",3,41,6,50,5,121,24,150
273,0.04,"(28, 8)","(24, 7)",11,181,106,298,3,271,56,330
274,0.04,"(0, 21)","(4, 27)",4,141,76,221,3,181,61,245
275,0.2,"(19, 22)","(15, 18)",6,61,12,79,14,121,26,161
276,0.14,"(4, 17)","(19, 9)",10,161,244,415,5,181,127,313
277,0.02,"(24, 10)","(26, 13)",8,161,36,205,9,211,30,250
278,0.04,"(13, 5)","(5, 20)",7,121,56,184,12,211,68,291
279,0.12,"(5, 13)","(9, 28)",6,61,57,124,4,211,81,296
280,0.1,"(26, 29)","(0, 21)",7,81,63,151,12,61,52,125
281,0.12,"(2, 9)","(10, 0)",12,41,70,123,16,211,102,329
282,0.16,"(1, 11)","(26, 4)",3,221,144,368,17,151,123,291
283,0.18,"(17, 0)","(5, 1)",7,21,19,47,7,121,23,151
284,0.04,"(28, 16)","(8, 17)",12,121,78,211,8,181,77,266
285,0.14,"(4, 2)","(19, 22)",7,121,118,246,5,211,120,336
286,0.2,"(12, 16)","(18, 9)",12,141,239,392,10,151,109,270
287,0.16,"(11, 24)","(18, 17)",13,161,122,296,39,151,110,300
288,0.12,"(14, 27)","(13, 24)",5,61,15,81,4,31,6,41
289,0.02,"(16, 3)","(26, 6)",8,161,90,259,11,151,77,239
290,0.1,"(10, 8)","(0, 13)",7,81,33,121,12,151,45,208
291,0.14,"(29, 14)","(22, 28)",7,121,83,211,6,181,93,280
292,0.12,"(10, 15)","(19, 20)",6,141,102,249,13,211,120,344
293,0.12,"(14, 29)","(27, 16)",19,101,165,285,7,151,105,263
294,0.18,"(12, 19)","(9, 8)",7,101,53,161,9,181,72,262
295,0.1,"(22, 2)","(3, 13)",7,101,68,176,7,121,62,190
296,0.08,"(5, 23)","(6, 11)",7,141,35,183,3,211,49,263
297,0.16,"(20, 8)","(24, 8)",6,101,32,139,5,211,74,290
298,0.06,"(5, 10)","(16, 20)",7,121,85,213,4,301,100,405
299,0.18,"(13, 6)","(27, 9)",10,161,179,350,11,181,142,334
300,0.1,"(15, 27)","(21, 10)",11,181,121,313,7,211,119,337
301,0.06,"(27, 8)","(7, 13)",5,101,73,179,8,121,98,227
302,0.08,"(20, 28)","(23, 29)",7,61,25,93,6,121,22,149
303,0.18,"(14, 3)","(27, 5)",6,121,127,254,14,151,96,261
304,0.04,"(1, 10)","(17, 15)",6,121,58,185,3,181,76,260
305,0.16,"(2, 23)","(2, 4)",11,121,86,218,4,241,196,441
306,0.1,"(5, 25)","(29, 4)",5,81,68,154,16,211,88,315
307,0.18,"(27, 12)","(11, 0)",4,81,110,195,6,331,149,486
308,0.1,"(14, 5)","(9, 25)",7,121,69,197,7,241,103,351
309,0.12,"(24, 20)","(27, 16)",6,61,23,90,5,121,22,148
310,0.04,"(18, 14)","(23, 26)",6,301,173,480,11,331,136,478
311,0.06,"(24, 16)","(21, 29)",14,41,64,119,4,121,93,218
312,0.12,"(2, 3)","(18, 5)",8,101,94,203,23,241,179,443
313,0.06,"(23, 6)","(6, 25)",7,161,93,261,16,241,98,355
314,0.14,"(5, 0)","(1, 2)",8,121,87,216,8,61,20,89
315,0.08,"(20, 2)","(8, 7)",17,181,113,311,7,151,59,217
316,0.08,"(11, 28)","(29, 13)",8,61,73,142,3,181,88,272
317,0.2,"(29, 7)","(25, 5)",8,41,15,64,3,121,20,144
318,0.18,"(22, 26)","(12, 9)",5,141,207,353,6,181,75,262
319,0.08,"(3, 24)","(5, 25)",18,61,35,114,14,211,51,276
320,0.14,"(17, 14)","(13, 8)",6,101,43,150,41,181,91,313
321,0.1,"(12, 18)","(4, 27)",6,121,118,245,6,181,108,295
322,0.02,"(10, 12)","(11, 23)",6,181,88,275,7,271,74,352
323,0.1,"(4, 4)","(13, 11)",3,121,59,183,4,211,79,294
324,0.1,"(4, 15)","(8, 8)",10,121,46,177,9,91,42,142
325,0.2,"(16, 28)","(11, 18)",9,241,232,482,6,211,82,299
326,0.2,"(8, 6)","(3, 27)",5,101,100,206,5,211,101,317
327,0.18,"(26, 26)","(28, 0)",11,121,163,295,8,151,159,318
328,0.12,"(18, 28)","(14, 26)",4,141,60,205,5,31,12,48
329,0.2,"(18, 11)","(0, 25)",5,61,50,116,4,151,58,213
330,0.08,"(21, 8)","(27, 13)",11,201,103,315,10,181,75,266
331,0.02,"(29, 2)","(26, 9)",9,141,75,225,7,91,31,129
332,0.08,"(14, 12)","(22, 1)",6,141,129,276,8,151,98,257
333,0.04,"(6, 28)","(12, 18)",4,121,56,181,2,271,93,366
334,0.06,"(5, 11)","(1, 26)",8,81,27,116,15,301,83,399
335,0.18,"(15, 12)","(8, 10)",13,141,38,192,13,211,56,280
336,0.12,"(11, 17)","(8, 6)",10,141,88,239,9,211,106,326
337,0.04,"(26, 20)","(10, 15)",8,101,70,179,35,181,82,298
338,0.08,"(10, 12)","(12, 18)",5,121,53,179,4,91,49,144
339,0.04,"(24, 29)","(27, 27)",10,61,35,106,31,151,42,224
340,0.16,"(13, 7)","(5, 17)",14,101,84,199,10,181,78,269
341,0.18,"(17, 9)","(20, 22)",12,201,265,478,9,151,78,238
342,0.2,"(6, 26)","(13, 11)",10,221,172,403,9,211,140,360
343,0.06,"(6, 29)","(6, 12)",4,181,48,233,5,151,60,216
344,0.02,"(2, 10)","(27, 17)",6,201,81,288,10,271,107,388
345,0.1,"(16, 9)","(9, 2)",6,101,89,196,9,181,106,296
346,0.08,"(14, 13)","(2, 24)",7,81,46,134,6,91,49,146
347,0.18,"(13, 10)","(26, 11)",5,161,244,410,13,151,138,302
348,0.08,"(29, 8)","(23, 12)",9,121,49,179,31,61,42,134
349,0.04,"(7, 7)","(1, 6)",4,121,31,156,4,121,30,155
350,0.16,"(9, 19)","(4, 5)",8,61,39,108,11,151,58,220
351,0.1,"(12, 7)","(4, 25)",11,41,52,104,10,181,86,277
352,0.04,"(15, 20)","(8, 12)",10,81,45,136,8,271,62,341
353,0.1,"(20, 15)","(16, 4)",5,161,120,286,12,181,103,296
354,0.06,"(5, 12)","(9, 23)",10,161,92,263,16,121,63,200
355,0.14,"(20, 7)","(12, 12)",4,181,69,254,4,121,45,170
356,0.14,"(2, 2)","(10, 19)",3,121,61,185,8,151,67,226
357,0.08,"(10, 0)","(12, 3)",11,181,61,253,14,121,30,165
358,0.18,"(25, 23)","(7, 14)",12,101,84,197,14,211,104,329
359,0.1,"(19, 6)","(25, 17)",4,61,79,144,7,151,114,272
360,0.14,"(26, 2)","(1, 29)",6,61,66,133,5,91,65,161
361,0.02,"(6, 20)","(12, 10)",8,141,114,263,9,301,141,451
362,0.16,"(12, 7)","(0, 10)",13,101,64,178,5,211,38,254
363,0.16,"(24, 18)","(15, 7)",8,161,207,376,4,211,93,308
364,0.08,"(3, 20)","(13, 15)",6,101,83,190,5,151,54,210
365,0.02,"(10, 18)","(16, 5)",5,341,158,504,4,151,61,216
366,0.2,"(4, 16)","(0, 9)",4,81,71,156,2,91,25,118
367,0.16,"(23, 16)","(19, 8)",7,41,32,80,20,211,81,312
368,0.12,"(4, 17)","(0, 11)",9,81,41,131,12,181,70,263
369,0.16,"(25, 2)","(21, 15)",20,161,102,283,5,211,137,353
370,0.14,"(29, 6)","(3, 18)",4,161,185,350,15,91,89,195
371,0.02,"(21, 3)","(28, 28)",11,181,110,302,7,331,206,544
372,0.1,"(10, 11)","(7, 12)",13,61,21,95,6,151,56,213
373,0.08,"(1, 28)","(10, 28)",5,181,68,254,5,211,50,266
374,0.16,"(4, 9)","(8, 18)",11,121,80,212,10,151,66,227
375,0.1,"(9, 1)","(4, 13)",3,81,55,139,9,121,35,165
376,0.1,"(26, 4)","(1, 12)",24,81,126,231,5,121,109,235
377,0.18,"(11, 29)","(9, 27)",4,41,27,72,16,61,40,117
378,0.14,"(24, 15)","(24, 16)",8,121,36,165,12,31,14,57
379,0.12,"(5, 10)","(12, 1)",11,141,127,279,8,91,70,169
380,0.04,"(13, 16)","(12, 19)",12,21,13,46,9,181,32,222
381,0.06,"(10, 12)","(10, 6)",12,61,45,118,6,181,81,268
382,0.06,"(28, 25)","(19, 25)",8,141,97,246,4,91,46,141
383,0.06,"(11, 12)","(12, 14)",3,101,11,115,17,61,33,111
384,0.12,"(26, 16)","(0, 13)",8,61,70,139,9,121,71,201
385,0.18,"(6, 13)","(1, 7)",6,41,18,65,9,151,77,237
386,0.2,"(12, 7)","(28, 17)",5,181,269,455,8,241,120,369
387,0.1,"(15, 1)","(28, 3)",2,141,109,252,3,181,86,270
388,0.16,"(0, 9)","(22, 29)",3,81,71,155,2,91,68,161
389,0.1,"(17, 7)","(25, 8)",10,161,101,272,15,301,123,439
390,0.02,"(18, 8)","(16, 28)",17,81,128,226,16,361,225,602
391,0.2,"(4, 26)","(26, 21)",5,161,157,323,9,241,163,413
392,0.2,"(11, 25)","(27, 29)",12,81,149,242,14,241,104,359
393,0.12,"(3, 21)","(13, 22)",12,81,53,146,4,181,51,236
394,0.14,"(5, 7)","(29, 17)",12,161,146,319,12,181,121,314
395,0.04,"(22, 19)","(4, 9)",13,41,73,127,19,211,74,304
396,0.12,"(19, 6)","(10, 29)",3,121,98,222,9,211,127,347
397,0.08,"(16, 27)","(7, 25)",5,141,91,237,4,181,39,224
398,0.1,"(13, 0)","(16, 25)",12,161,185,358,26,151,122,299
399,0.18,"(18, 1)","(26, 26)",7,121,102,230,5,151,101,257
400,0.2,"(29, 23)","(11, 29)",4,141,147,292,30,151,88,269
401,0.2,"(6, 18)","(20, 19)",5,81,74,160,3,181,77,261
402,0.14,"(14, 23)","(27, 16)",5,81,81,167,9,121,98,228
403,0.1,"(14, 28)","(7, 24)",7,161,72,240,5,91,45,141
404,0.04,"(20, 4)","(0, 18)",4,61,71,136,5,331,132,468
405,0.08,"(17, 24)","(23, 17)",5,181,83,269,8,301,120,429
406,0.18,"(6, 14)","(12, 5)",3,101,49,153,9,181,54,244
407,0.12,"(22, 13)","(16, 16)",24,81,95,200,29,91,61,181
408,0.12,"(1, 3)","(5, 29)",7,121,134,262,10,91,76,177
409,0.12,"(23, 9)","(20, 29)",7,101,100,208,18,151,93,262
410,0.16,"(28, 9)","(9, 2)",12,121,105,238,20,121,139,280
411,0.16,"(17, 16)","(18, 20)",4,161,106,271,8,91,36,135
412,0.18,"(4, 29)","(15, 12)",13,101,199,313,21,211,216,448
413,0.08,"(9, 13)","(5, 19)",4,121,29,154,5,181,50,236
414,0.06,"(20, 15)","(28, 23)",21,241,146,408,17,211,141,369
415,0.08,"(8, 19)","(7, 10)",5,101,106,212,7,151,61,219
416,0.04,"(3, 3)","(8, 2)",14,181,48,243,9,91,28,128
417,0.02,"(4, 28)","(18, 26)",12,241,150,403,5,421,95,521
418,0.08,"(19, 6)","(25, 10)",11,121,134,266,11,241,61,313
419,0.14,"(17, 14)","(19, 15)",6,101,44,151,9,121,58,188
420,0.2,"(11, 21)","(21, 7)",6,241,275,522,10,271,124,405
421,0.18,"(25, 18)","(16, 2)",7,141,170,318,5,181,80,266
422,0.1,"(9, 5)","(25, 21)",15,81,79,175,3,151,112,266
423,0.06,"(0, 16)","(14, 12)",11,141,63,215,4,211,67,282
424,0.14,"(21, 12)","(10, 1)",2,121,105,228,21,181,150,352
425,0.04,"(6, 17)","(26, 6)",10,141,95,246,6,91,55,152
426,0.1,"(15, 1)","(14, 22)",5,161,131,297,6,61,55,122
427,0.1,"(21, 27)","(1, 6)",14,161,144,319,17,151,75,243
428,0.04,"(19, 12)","(1, 8)",3,101,60,164,5,61,32,98
429,0.02,"(13, 24)","(22, 1)",5,201,164,370,6,301,122,429
430,0.08,"(10, 29)","(22, 5)",5,101,63,169,5,121,76,202
431,0.02,"(4, 14)","(14, 29)",8,141,88,237,8,211,58,277
432,0.14,"(5, 0)","(22, 4)",9,121,89,219,4,121,59,184
433,0.04,"(12, 22)","(3, 28)",12,161,56,229,12,151,62,225
434,0.04,"(29, 23)","(10, 29)",9,161,93,263,6,121,91,218
435,0.04,"(26, 0)","(20, 22)",5,101,101,207,3,241,102,346
436,0.18,"(17, 25)","(1, 18)",5,101,110,216,14,121,128,263
437,0.14,"(15, 24)","(16, 19)",6,101,29,136,8,151,57,216
438,0.08,"(6, 3)","(26, 22)",17,101,116,234,10,151,74,235
439,0.02,"(3, 12)","(24, 29)",7,241,142,390,5,181,89,275
440,0.18,"(8, 0)","(27, 13)",8,161,188,357,4,121,109,234
441,0.06,"(26, 20)","(5, 11)",10,141,82,233,13,121,77,211
442,0.14,"(15, 0)","(1, 7)",11,101,163,275,5,151,62,218
443,0.06,"(29, 10)","(21, 11)",15,141,70,226,8,151,51,210
444,0.14,"(12, 0)","(21, 7)",3,181,133,317,4,181,67,252
445,0.02,"(13, 9)","(28, 16)",4,181,96,281,7,271,133,411
446,0.2,"(25, 19)","(2, 13)",4,141,103,248,2,181,130,313
447,0.16,"(19, 10)","(29, 15)",11,81,136,228,10,151,98,259
448,0.12,"(20, 8)","(24, 23)",7,121,106,234,9,181,72,262
449,0.08,"(25, 8)","(15, 8)",5,181,73,259,8,151,52,211
450,0.08,"(21, 26)","(2, 16)",3,141,64,208,5,271,100,376
451,0.14,"(18, 15)","(13, 27)",4,101,107,212,5,121,54,180
452,0.14,"(21, 22)","(9, 24)",18,81,53,152,12,91,42,145
453,0.06,"(21, 0)","(24, 21)",11,181,186,378,10,181,156,347
454,0.1,"(6, 2)","(17, 0)",24,141,197,362,8,181,84,273
455,0.08,"(4, 7)","(25, 21)",6,101,71,178,10,241,148,399
456,0.12,"(25, 11)","(27, 28)",6,121,87,214,7,121,91,219
457,0.08,"(5, 6)","(23, 7)",6,121,80,207,5,211,102,318
458,0.1,"(6, 19)","(3, 7)",8,121,107,236,4,301,144,449
459,0.14,"(15, 21)","(4, 12)",5,81,113,199,11,151,68,230
460,0.02,"(6, 0)","(17, 0)",7,81,28,116,3,121,53,177
461,0.16,"(24, 16)","(17, 23)",5,121,74,200,13,121,57,191
462,0.02,"(18, 29)","(21, 10)",14,321,182,517,4,331,98,433
463,0.1,"(5, 23)","(15, 3)",6,61,47,114,5,121,68,194
464,0.04,"(5, 26)","(3, 5)",14,161,78,253,13,121,112,246
465,0.18,"(11, 26)","(14, 13)",4,101,54,159,5,181,135,321
466,0.04,"(4, 11)","(6, 9)",3,121,26,150,10,91,17,118
467,0.16,"(3, 6)","(28, 25)",7,101,68,176,7,241,118,366
468,0.2,"(25, 23)","(9, 18)",4,141,131,276,5,211,59,275
469,0.14,"(14, 7)","(29, 23)",6,81,87,174,7,151,140,298
470,0.16,"(4, 0)","(3, 10)",3,81,25,109,15,151,49,215
471,0.04,"(10, 15)","(12, 17)",7,201,46,254,8,151,27,186
472,0.02,"(2, 3)","(10, 19)",5,301,110,416,4,301,77,382
473,0.14,"(5, 6)","(12, 22)",8,61,52,121,7,181,69,257
474,0.14,"(17, 11)","(19, 4)",5,141,80,226,9,91,42,142
475,0.04,"(4, 17)","(9, 16)",10,241,62,313,13,121,48,182
476,0.02,"(17, 25)","(16, 19)",7,261,166,434,6,61,26,93
477,0.14,"(21, 0)","(16, 10)",5,81,54,140,8,181,70,259
478,0.12,"(1, 18)","(19, 16)",4,141,107,252,5,211,107,323
479,0.08,"(16, 7)","(20, 29)",10,61,66,137,10,271,111,392
480,0.16,"(15, 9)","(18, 27)",7,61,78,146,8,181,128,317
481,0.18,"(6, 11)","(28, 20)",8,101,78,187,7,151,80,238
482,0.2,"(25, 8)","(29, 22)",9,81,162,252,5,181,160,346
483,0.16,"(29, 9)","(14, 5)",4,101,149,254,20,181,166,367
484,0.2,"(16, 19)","(18, 11)",16,141,77,234,3,181,71,255
485,0.12,"(19, 17)","(3, 24)",7,61,87,155,6,121,53,180
486,0.1,"(20, 15)","(7, 2)",9,141,81,231,7,91,75,173
487,0.2,"(21, 10)","(1, 0)",8,161,185,354,6,121,90,217
488,0.14,"(11, 25)","(23, 2)",6,101,63,170,5,151,72,228
489,0.18,"(28, 2)","(13, 26)",3,121,123,247,4,181,124,309
490,0.18,"(28, 8)","(22, 25)",4,121,145,270,11,121,91,223
491,0.04,"(19, 2)","(8, 18)",3,141,125,269,8,211,100,319
492,0.14,"(11, 19)","(17, 24)",5,121,78,204,16,181,73,270
493,0.02,"(3, 26)","(4, 26)",6,241,66,313,6,241,39,286
494,0.18,"(8, 15)","(6, 7)",7,81,34,122,17,91,42,150
495,0.18,"(17, 24)","(29, 3)",4,61,61,126,6,61,91,158
496,0.02,"(25, 9)","(20, 12)",4,21,10,35,10,151,49,210
497,0.08,"(13, 6)","(10, 21)",5,101,100,206,8,211,72,291
498,0.06,"(7, 5)","(7, 23)",4,81,62,147,18,211,87,316
499,0.14,"(16, 29)","(3, 26)",5,61,29,95,26,181,73,280
500,0.18,"(25, 11)","(7, 12)",5,81,45,131,6,181,138,325
501,0.2,"(15, 0)","(26, 29)",9,61,58,128,9,211,161,381
502,0.1,"(9, 21)","(5, 0)",8,61,99,168,5,151,84,240
503,0.06,"(15, 22)","(11, 21)",7,81,19,107,14,91,28,133
504,0.16,"(28, 1)","(13, 9)",8,221,237,466,5,211,126,342
505,0.1,"(15, 27)","(23, 14)",6,141,131,278,4,211,92,307
506,0.16,"(29, 5)","(9, 28)",17,61,96,174,6,241,126,373
507,0.1,"(3, 28)","(10, 0)",2,181,98,281,2,61,42,105
508,0.14,"(24, 1)","(3, 2)",11,121,144,276,4,181,166,351
509,0.16,"(10, 8)","(12, 6)",11,61,47,119,18,121,39,178
510,0.1,"(22, 18)","(20, 19)",13,81,36,130,6,1,6,13
511,0.2,"(12, 25)","(2, 24)",5,101,169,275,6,91,52,149
512,0.02,"(1, 3)","(15, 4)",12,361,158,531,4,421,104,529
513,0.02,"(7, 4)","(29, 13)",20,41,90,151,6,361,170,537
514,0.08,"(9, 20)","(28, 11)",4,181,114,299,3,211,72,286
515,0.2,"(4, 21)","(24, 26)",10,141,157,308,6,301,131,438
516,0.04,"(0, 12)","(21, 22)",12,181,120,313,13,331,101,445
517,0.1,"(13, 17)","(8, 1)",9,121,106,236,14,151,62,227
518,0.06,"(2, 25)","(8, 27)",6,101,60,167,8,211,53,272
519,0.18,"(26, 28)","(8, 25)",6,101,42,149,15,181,55,251
520,0.1,"(24, 13)","(25, 17)",14,141,67,222,6,91,35,132
521,0.16,"(11, 28)","(10, 6)",6,161,168,335,12,211,125,348
522,0.18,"(15, 12)","(9, 22)",7,141,82,230,11,121,52,184
523,0.12,"(8, 23)","(23, 8)",4,121,80,205,6,241,123,370
524,0.18,"(11, 5)","(4, 20)",10,81,62,153,9,121,108,238
525,0.14,"(1, 22)","(1, 27)",11,121,51,183,3,151,36,190
526,0.18,"(4, 5)","(28, 29)",9,41,65,115,5,61,55,121
527,0.18,"(18, 14)","(1, 15)",7,81,38,126,8,61,30,99
528,0.06,"(4, 5)","(0, 5)",9,81,30,120,10,31,12,53
529,0.1,"(22, 16)","(29, 4)",7,101,135,243,4,181,88,273
530,0.04,"(18, 27)","(20, 21)",5,141,73,219,5,301,70,376
531,0.12,"(22, 17)","(6, 16)",4,141,58,203,2,121,34,157
532,0.14,"(25, 27)","(27, 25)",5,101,43,149,16,121,28,165
533,0.12,"(21, 22)","(21, 13)",13,101,52,166,6,241,68,315
534,0.1,"(2, 8)","(0, 4)",9,21,18,48,5,121,22,148
535,0.04,"(17, 17)","(21, 23)",7,121,56,184,6,271,68,345
536,0.1,"(0, 9)","(3, 27)",4,81,40,125,5,181,104,290
537,0.06,"(24, 19)","(21, 0)",8,101,79,188,11,121,79,211
538,0.16,"(18, 28)","(12, 10)",3,181,124,308,8,211,108,327
539,0.14,"(8, 27)","(7, 17)",7,221,97,325,5,211,103,319
540,0.16,"(19, 5)","(0, 13)",4,61,49,114,7,121,80,208
541,0.2,"(16, 24)","(14, 3)",6,141,162,309,8,151,95,254
542,0.02,"(0, 2)","(25, 0)",5,241,169,415,3,301,110,414
543,0.16,"(14, 0)","(9, 16)",9,81,54,144,15,211,82,308
544,0.1,"(6, 29)","(6, 12)",7,161,86,254,6,151,64,221
545,0.14,"(25, 18)","(18, 19)",5,181,62,248,8,181,46,235
546,0.16,"(26, 6)","(14, 27)",4,161,130,295,4,181,88,273
547,0.1,"(25, 0)","(10, 29)",11,121,110,242,7,91,83,181
548,0.2,"(13, 3)","(15, 27)",11,121,124,256,15,91,83,189
549,0.04,"(5, 11)","(20, 21)",9,201,186,396,7,211,102,320
550,0.04,"(11, 24)","(29, 9)",5,81,111,197,15,151,88,254
551,0.04,"(6, 11)","(12, 17)",6,181,92,279,4,241,64,309
552,0.16,"(17, 23)","(19, 26)",5,141,82,228,7,181,50,238
553,0.14,"(20, 24)","(17, 27)",7,61,24,92,7,61,22,90
554,0.12,"(19, 18)","(18, 13)",3,121,42,166,9,91,28,128
555,0.18,"(16, 11)","(18, 24)",6,101,88,195,4,181,100,285
556,0.16,"(4, 23)","(26, 23)",13,141,129,283,12,271,115,398
557,0.1,"(11, 0)","(26, 22)",9,141,155,305,14,121,94,229
558,0.06,"(22, 12)","(10, 5)",6,181,80,267,8,181,61,250
559,0.04,"(24, 1)","(3, 26)",5,121,87,213,3,151,84,238
560,0.12,"(22, 22)","(1, 2)",8,61,57,126,6,91,57,154
561,0.06,"(26, 11)","(19, 10)",5,161,61,227,9,151,34,194
562,0.02,"(4, 16)","(22, 8)",10,281,212,503,5,121,89,215
563,0.2,"(8, 14)","(6, 9)",4,121,43,168,5,181,67,253
564,0.1,"(27, 18)","(29, 2)",4,61,67,132,7,151,111,269
565,0.14,"(21, 22)","(6, 3)",7,121,99,227,7,91,85,183
566,0.12,"(2, 1)","(18, 16)",5,121,77,203,5,151,119,275
567,0.16,"(21, 1)","(7, 25)",4,101,90,195,8,211,146,365
568,0.1,"(0, 1)","(25, 13)",26,61,115,202,14,121,105,240
569,0.02,"(0, 18)","(17, 14)",9,221,137,367,5,421,147,573
570,0.18,"(8, 22)","(4, 4)",10,81,126,217,5,181,63,249
571,0.06,"(19, 2)","(21, 10)",7,181,73,261,11,241,82,334
572,0.12,"(24, 23)","(17, 20)",6,101,47,154,4,121,24,149
573,0.14,"(19, 11)","(14, 23)",10,121,226,357,4,121,71,196
574,0.18,"(25, 17)","(13, 5)",6,121,90,217,12,151,89,252
575,0.06,"(11, 28)","(8, 18)",8,201,88,297,8,211,51,270
576,0.1,"(14, 19)","(23, 6)",6,161,92,259,5,181,92,278
577,0.14,"(29, 13)","(27, 13)",7,21,8,36,7,91,13,111
578,0.12,"(7, 16)","(29, 3)",9,61,67,137,8,151,59,218
579,0.08,"(0, 28)","(25, 8)",4,81,113,198,11,271,152,434
580,0.06,"(0, 27)","(4, 7)",18,181,91,290,9,181,57,247
581,0.02,"(3, 20)","(5, 15)",6,221,106,333,5,181,56,242
582,0.1,"(22, 26)","(24, 17)",6,61,50,117,5,151,77,233
583,0.08,"(8, 11)","(23, 22)",10,141,97,248,11,271,158,440
584,0.12,"(3, 1)","(11, 24)",7,161,140,308,5,151,57,213
585,0.16,"(22, 18)","(13, 25)",30,61,64,155,25,151,73,249
586,0.18,"(22, 25)","(16, 12)",10,241,183,434,9,241,111,361
587,0.14,"(15, 21)","(24, 15)",6,141,133,280,3,211,101,315
588,0.1,"(21, 21)","(10, 6)",7,141,100,248,3,121,74,198
589,0.06,"(29, 29)","(25, 18)",5,141,50,196,2,211,90,303
590,0.02,"(0, 26)","(7, 21)",3,221,58,282,4,271,96,371
591,0.16,"(27, 18)","(3, 18)",6,101,64,171,8,121,52,181
592,0.08,"(18, 20)","(17, 4)",3,141,93,237,5,181,76,262
593,0.14,"(7, 0)","(13, 14)",6,81,59,146,5,121,56,182
594,0.2,"(6, 26)","(9, 8)",5,141,101,247,4,151,89,244
595,0.12,"(7, 6)","(10, 16)",9,101,64,174,5,61,40,106
596,0.18,"(11, 19)","(27, 24)",15,141,177,333,7,211,188,406
597,0.04,"(27, 4)","(9, 1)",11,161,59,231,10,241,96,347
598,0.02,"(12, 9)","(6, 14)",6,241,72,319,7,361,84,452
599,0.02,"(6, 29)","(24, 11)",9,161,98,268,4,451,205,660
600,0.2,"(28, 25)","(14, 12)",2,181,192,375,8,211,115,334
601,0.02,"(9, 18)","(6, 3)",7,401,149,557,7,271,98,376
602,0.16,"(15, 13)","(9, 15)",9,101,56,166,10,61,20,91
603,0.16,"(0, 19)","(13, 28)",7,81,109,197,56,91,131,278
604,0.16,"(2, 3)","(22, 9)",23,181,243,447,5,181,129,315
605,0.1,"(13, 25)","(24, 26)",10,141,127,278,4,181,70,255
606,0.2,"(28, 5)","(13, 21)",7,141,196,344,7,181,142,330
607,0.1,"(4, 9)","(9, 18)",19,141,90,250,9,151,79,239
608,0.08,"(10, 3)","(4, 10)",16,81,41,138,10,151,48,209
609,0.12,"(1, 6)","(28, 24)",11,121,92,224,8,181,77,266
610,0.06,"(5, 6)","(19, 2)",5,141,80,226,6,151,70,227
611,0.02,"(2, 9)","(9, 2)",5,221,127,353,4,241,106,351
612,0.12,"(26, 20)","(18, 19)",6,61,26,93,7,91,25,123
613,0.06,"(22, 29)","(1, 22)",5,121,119,245,6,61,36,103
614,0.16,"(13, 9)","(4, 9)",16,81,58,155,10,31,31,72
615,0.2,"(20, 11)","(12, 25)",6,141,179,326,22,181,129,332
616,0.14,"(16, 28)","(13, 25)",16,101,48,165,4,151,37,192
617,0.14,"(10, 12)","(9, 4)",9,101,34,144,6,121,40,167
618,0.06,"(25, 9)","(17, 18)",6,121,72,199,4,241,84,329
619,0.04,"(16, 21)","(3, 17)",5,101,100,206,6,271,81,358
620,0.12,"(4, 16)","(17, 20)",19,161,144,324,8,151,60,219
621,0.2,"(14, 19)","(24, 15)",4,181,118,303,7,241,150,398
622,0.04,"(21, 23)","(2, 15)",4,121,113,238,3,211,76,290
623,0.16,"(10, 0)","(23, 15)",25,121,164,310,8,211,135,354
624,0.02,"(17, 4)","(21, 24)",12,221,135,368,8,181,90,279
625,0.04,"(5, 13)","(12, 16)",8,141,73,222,7,181,76,264
626,0.02,"(21, 17)","(27, 27)",7,101,61,169,4,271,142,417
627,0.16,"(28, 5)","(11, 1)",4,101,128,233,2,91,46,139
628,0.06,"(4, 3)","(8, 10)",11,101,69,181,5,91,28,124
629,0.18,"(4, 18)","(9, 3)",8,101,173,282,5,181,148,334
630,0.02,"(11, 22)","(27, 29)",5,281,125,411,11,211,125,347
631,0.2,"(4, 22)","(20, 15)",14,121,153,288,6,211,96,313
632,0.08,"(13, 27)","(21, 13)",6,141,128,275,20,271,127,418
633,0.06,"(0, 27)","(4, 25)",2,161,46,209,7,121,24,152
634,0.2,"(22, 4)","(26, 10)",9,141,217,367,5,121,49,175
635,0.1,"(2, 23)","(28, 19)",2,121,85,208,6,151,110,267
636,0.14,"(13, 26)","(2, 27)",9,81,43,133,6,91,22,119
637,0.12,"(3, 1)","(26, 15)",7,141,106,254,4,211,158,373
638,0.04,"(0, 23)","(17, 26)",4,161,153,318,3,211,72,286
639,0.12,"(23, 10)","(0, 15)",8,101,58,167,7,151,59,217
640,0.08,"(22, 28)","(8, 22)",14,101,70,185,3,271,106,380
641,0.06,"(16, 16)","(12, 25)",2,161,109,272,3,121,73,197
642,0.16,"(6, 9)","(10, 24)",12,141,195,348,5,211,60,276
643,0.06,"(11, 23)","(15, 19)",3,121,55,179,4,151,68,223
644,0.12,"(17, 26)","(18, 14)",9,81,61,151,6,121,41,168
645,0.12,"(17, 0)","(23, 24)",8,141,100,249,12,121,104,237
646,0.2,"(7, 28)","(24, 11)",8,201,258,467,8,271,146,425
647,0.12,"(19, 5)","(4, 5)",5,101,71,177,6,181,88,275
648,0.06,"(0, 13)","(16, 7)",13,201,127,341,5,211,119,335
649,0.16,"(25, 9)","(26, 20)",4,41,50,95,12,91,71,174
650,0.12,"(21, 9)","(16, 6)",5,61,23,89,12,151,47,210
651,0.04,"(8, 12)","(20, 15)",11,141,113,265,4,121,86,211
652,0.06,"(19, 16)","(7, 7)",6,121,73,200,20,181,94,295
653,0.16,"(11, 21)","(16, 8)",7,121,83,211,4,181,55,240
654,0.08,"(10, 15)","(15, 17)",4,181,80,265,5,121,38,164
655,0.08,"(8, 13)","(27, 1)",8,201,146,355,4,121,82,207
656,0.16,"(19, 6)","(5, 8)",6,121,99,226,7,151,88,246
657,0.14,"(3, 23)","(26, 19)",8,141,88,237,7,241,161,409
658,0.12,"(24, 0)","(18, 1)",8,81,26,115,6,211,57,274
659,0.12,"(20, 8)","(19, 11)",25,61,39,125,7,151,64,222
660,0.12,"(4, 3)","(1, 21)",16,101,80,197,4,61,33,98
661,0.04,"(0, 11)","(2, 17)",8,161,33,202,11,181,59,251
662,0.14,"(0, 1)","(17, 29)",5,41,89,135,4,61,87,152
663,0.1,"(27, 4)","(12, 9)",7,101,64,172,10,151,65,226
664,0.18,"(21, 29)","(2, 1)",8,61,62,131,4,91,58,153
665,0.18,"(16, 21)","(14, 4)",7,161,165,333,13,211,139,363
666,0.08,"(9, 10)","(28, 9)",11,81,77,169,8,211,82,301
667,0.14,"(25, 22)","(26, 1)",13,41,73,127,12,121,103,236
668,0.08,"(6, 11)","(15, 6)",4,81,41,126,5,241,109,355
669,0.02,"(24, 16)","(20, 11)",8,201,120,329,16,241,65,322
670,0.02,"(19, 10)","(27, 22)",10,361,158,529,11,361,127,499
671,0.12,"(27, 23)","(8, 22)",11,161,76,248,4,121,34,159
672,0.14,"(23, 19)","(10, 5)",6,81,101,188,5,151,102,258
673,0.16,"(21, 18)","(21, 15)",8,121,32,161,5,121,37,163
674,0.02,"(17, 13)","(1, 24)",3,301,225,529,4,151,96,251
675,0.02,"(18, 14)","(13, 11)",6,301,146,453,10,121,20,151
676,0.14,"(22, 1)","(7, 12)",8,141,138,287,11,211,200,422
677,0.14,"(4, 11)","(16, 20)",4,141,158,303,8,211,167,386
678,0.14,"(23, 24)","(17, 8)",7,181,133,321,5,151,114,270
679,0.16,"(2, 25)","(21, 19)",5,81,128,214,5,181,120,306
680,0.12,"(27, 24)","(28, 16)",4,101,21,126,12,121,37,170
681,0.06,"(8, 20)","(24, 5)",6,141,75,222,10,121,53,184
682,0.16,"(1, 13)","(9, 26)",3,141,152,296,8,151,62,221
683,0.02,"(17, 21)","(16, 23)",8,201,56,265,5,181,26,212
684,0.1,"(15, 4)","(9, 23)",6,221,126,353,8,211,84,303
685,0.06,"(7, 23)","(6, 10)",10,221,125,356,4,121,76,201
686,0.16,"(11, 7)","(10, 15)",16,81,51,148,4,91,39,134
687,0.06,"(24, 7)","(7, 29)",4,121,103,228,24,181,95,300
688,0.18,"(19, 13)","(19, 6)",6,141,86,233,6,61,36,103
689,0.04,"(11, 23)","(7, 5)",5,201,164,370,14,271,121,406
690,0.02,"(15, 9)","(29, 18)",11,141,140,292,6,181,96,283
691,0.08,"(3, 2)","(15, 19)",3,201,109,313,3,121,69,193
692,0.2,"(17, 14)","(15, 2)",10,121,142,273,8,151,98,257
693,0.16,"(23, 4)","(2, 22)",9,101,75,185,5,151,67,223
694,0.12,"(21, 5)","(11, 10)",6,121,65,192,3,151,57,211
695,0.04,"(13, 29)","(23, 5)",3,81,79,163,3,211,97,311
696,0.02,"(16, 7)","(7, 2)",8,141,154,303,4,331,146,481
697,0.2,"(15, 4)","(13, 28)",4,221,217,442,5,241,219,465
698,0.08,"(13, 28)","(21, 4)",7,181,124,312,5,91,92,188
699,0.1,"(20, 19)","(11, 6)",5,141,69,215,13,241,121,375
700,0.16,"(28, 9)","(18, 7)",9,81,60,150,4,121,29,154
701,0.02,"(21, 28)","(23, 12)",7,101,65,173,8,151,60,219
702,0.04,"(23, 9)","(27, 3)",13,81,45,139,45,151,139,335
703,0.08,"(0, 25)","(12, 27)",19,121,68,208,4,181,79,264
704,0.1,"(8, 4)","(21, 1)",4,141,67,212,3,121,60,184
705,0.16,"(22, 21)","(9, 22)",5,61,27,93,6,61,27,94
706,0.2,"(29, 25)","(21, 3)",3,221,234,458,5,271,208,484
707,0.14,"(18, 24)","(18, 0)",5,101,129,235,9,211,113,333
708,0.12,"(21, 24)","(7, 6)",9,181,146,336,11,151,79,241
709,0.12,"(16, 16)","(17, 15)",10,81,29,120,4,181,59,244
710,0.06,"(12, 19)","(12, 3)",10,61,77,148,7,211,109,327
711,0.18,"(18, 29)","(8, 15)",3,141,156,300,5,151,59,215
712,0.16,"(22, 19)","(21, 5)",5,121,73,199,11,61,65,137
713,0.18,"(22, 13)","(18, 20)",9,101,77,187,8,181,61,250
714,0.14,"(27, 23)","(18, 29)",20,101,76,197,13,151,52,216
715,0.06,"(24, 5)","(19, 22)",8,141,128,277,4,151,107,262
716,0.06,"(24, 15)","(26, 9)",20,121,71,212,9,121,38,168
717,0.02,"(11, 13)","(4, 5)",15,241,146,402,6,211,61,278
718,0.14,"(14, 11)","(13, 20)",5,101,68,174,4,151,62,217
719,0.12,"(8, 6)","(18, 21)",5,161,143,309,12,91,113,216
720,0.1,"(9, 7)","(17, 26)",5,121,56,182,12,91,86,189
721,0.08,"(8, 12)","(19, 7)",5,141,92,238,8,241,87,336
722,0.16,"(2, 4)","(11, 7)",5,241,141,387,8,151,45,204
723,0.08,"(2, 18)","(7, 1)",16,101,59,176,4,151,62,217
724,0.04,"(27, 20)","(8, 14)",4,161,89,254,4,181,82,267
725,0.04,"(6, 23)","(1, 17)",6,101,38,145,4,211,37,252
726,0.06,"(6, 26)","(11, 5)",7,161,91,259,9,181,123,313
727,0.08,"(28, 25)","(10, 12)",4,101,74,179,5,151,84,240
728,0.2,"(27, 9)","(20, 19)",5,181,176,362,7,181,49,237
729,0.18,"(0, 1)","(16, 23)",15,161,223,399,5,211,110,326
730,0.2,"(21, 27)","(10, 18)",4,221,198,423,17,121,61,199
731,0.02,"(9, 28)","(23, 6)",3,201,122,326,7,301,125,433
732,0.12,"(25, 1)","(20, 18)",5,101,85,191,15,151,94,260
733,0.18,"(2, 21)","(17, 19)",12,121,79,212,7,181,65,253
734,0.2,"(27, 17)","(5, 27)",19,101,113,233,10,151,104,265
735,0.14,"(14, 16)","(13, 12)",6,81,16,103,5,121,45,171
736,0.16,"(9, 26)","(3, 16)",7,61,23,91,10,181,43,234
737,0.04,"(12, 20)","(22, 9)",8,181,130,319,9,361,175,545
738,0.12,"(13, 28)","(0, 3)",5,81,95,181,3,121,126,250
739,0.06,"(18, 21)","(27, 25)",6,121,122,249,7,241,109,357
740,0.16,"(1, 27)","(27, 15)",4,141,167,312,6,211,132,349
741,0.08,"(8, 17)","(16, 15)",4,121,80,205,4,181,94,279
742,0.1,"(8, 25)","(16, 22)",10,181,93,284,7,151,54,212
743,0.18,"(5, 1)","(25, 3)",4,201,237,442,8,211,189,408
744,0.1,"(16, 5)","(10, 7)",4,81,28,113,6,151,26,183
745,0.14,"(8, 25)","(15, 23)",7,61,54,122,7,241,78,326
746,0.06,"(23, 22)","(10, 14)",14,81,52,147,10,181,100,291
747,0.06,"(3, 6)","(29, 15)",10,181,160,351,7,181,94,282
748,0.18,"(8, 7)","(7, 12)",7,61,34,102,9,211,64,284
749,0.08,"(9, 27)","(12, 17)",12,141,70,223,7,211,66,284
750,0.02,"(16, 21)","(22, 5)",7,381,184,572,11,391,108,510
751,0.08,"(25, 6)","(13, 14)",7,161,133,301,5,91,49,145
752,0.02,"(20, 5)","(29, 21)",8,301,227,536,4,241,121,366
753,0.2,"(5, 11)","(28, 17)",6,141,110,257,5,211,104,320
754,0.14,"(24, 7)","(14, 12)",3,101,49,153,6,121,64,191
755,0.18,"(26, 8)","(0, 18)",4,161,122,287,8,121,76,205
756,0.1,"(23, 24)","(21, 18)",7,81,25,113,4,121,22,147
757,0.18,"(16, 6)","(17, 13)",6,81,72,159,31,241,132,404
758,0.12,"(8, 25)","(8, 4)",5,141,114,260,10,121,56,187
759,0.04,"(13, 28)","(10, 11)",18,81,63,162,5,211,136,352
760,0.18,"(21, 2)","(6, 8)",7,181,120,308,13,151,65,229
761,0.2,"(11, 9)","(11, 23)",15,141,123,279,6,151,88,245
762,0.18,"(22, 15)","(12, 15)",8,41,26,75,4,121,33,158
763,0.06,"(19, 6)","(16, 15)",17,101,89,207,5,181,54,240
764,0.2,"(23, 25)","(6, 1)",8,101,77,186,21,121,93,235
765,0.18,"(17, 2)","(15, 25)",2,161,123,286,8,241,106,355
766,0.04,"(16, 18)","(6, 12)",3,241,125,369,3,151,51,205
767,0.04,"(28, 20)","(27, 5)",7,181,80,268,12,181,84,277
768,0.08,"(6, 19)","(24, 28)",6,181,121,308,14,151,109,274
769,0.2,"(6, 16)","(1, 25)",7,121,84,212,9,91,36,136
770,0.08,"(27, 1)","(0, 11)",8,41,49,98,9,151,68,228
771,0.1,"(2, 24)","(17, 11)",7,141,178,326,2,151,84,237
772,0.14,"(25, 9)","(18, 6)",4,121,44,169,4,151,37,192
773,0.2,"(11, 17)","(26, 8)",6,101,71,178,18,151,85,254
774,0.14,"(3, 26)","(5, 28)",8,81,14,103,5,91,10,106
775,0.16,"(12, 10)","(15, 10)",9,1,9,19,6,121,45,172
776,0.2,"(15, 4)","(10, 12)",9,161,203,373,7,181,86,274
777,0.08,"(29, 26)","(8, 9)",5,121,103,229,4,61,59,124
778,0.18,"(10, 5)","(27, 0)",9,61,145,215,12,91,144,247
779,0.08,"(12, 0)","(25, 6)",14,121,94,229,10,151,81,242
780,0.2,"(20, 13)","(16, 22)",5,121,87,213,2,151,74,227
781,0.02,"(13, 21)","(0, 6)",5,121,46,172,7,331,96,434
782,0.12,"(6, 24)","(23, 3)",4,101,97,202,10,181,127,318
783,0.06,"(24, 16)","(24, 7)",12,121,69,202,8,241,96,345
784,0.02,"(27, 2)","(21, 0)",13,121,77,211,5,61,12,78
785,0.04,"(9, 1)","(13, 22)",5,201,73,279,5,211,99,315
786,0.04,"(29, 11)","(10, 14)",11,141,71,223,9,241,110,360
787,0.06,"(19, 12)","(4, 25)",6,121,97,224,3,181,79,263
788,0.06,"(24, 18)","(9, 17)",4,181,82,267,4,271,70,345
789,0.16,"(20, 8)","(20, 12)",10,201,120,331,7,181,65,253
790,0.12,"(25, 7)","(2, 14)",7,81,71,159,7,151,77,235
791,0.08,"(12, 3)","(0, 18)",8,121,46,175,5,271,69,345
792,0.18,"(21, 15)","(29, 26)",3,81,81,165,6,181,118,305
793,0.06,"(4, 19)","(2, 7)",10,201,118,329,7,211,74,292
794,0.08,"(2, 16)","(25, 22)",3,221,175,399,3,151,106,260
795,0.18,"(8, 21)","(29, 2)",9,61,57,127,6,91,57,154
796,0.04,"(5, 24)","(28, 4)",14,121,86,221,14,91,68,173
797,0.12,"(17, 21)","(2, 6)",5,81,91,177,4,151,58,213
798,0.1,"(9, 17)","(0, 16)",9,41,23,73,5,61,21,87
799,0.04,"(22, 12)","(19, 0)",7,201,127,335,9,91,67,167
800,0.16,"(15, 1)","(18, 20)",4,101,66,171,2,181,66,249
801,0.12,"(15, 23)","(26, 19)",11,101,77,189,11,181,112,304
802,0.12,"(8, 2)","(12, 22)",7,161,144,312,19,181,111,311
803,0.16,"(3, 18)","(4, 17)",17,61,36,114,8,151,36,195
804,0.14,"(27, 17)","(25, 3)",10,101,73,184,8,121,89,218
805,0.08,"(20, 10)","(27, 7)",10,141,109,260,10,241,76,327
806,0.14,"(6, 14)","(4, 13)",16,21,17,54,19,61,34,114
807,0.18,"(8, 8)","(23, 23)",5,221,139,365,6,121,67,194
808,0.2,"(6, 20)","(18, 29)",4,81,59,144,6,151,101,258
809,0.14,"(0, 10)","(16, 5)",6,141,90,237,5,241,101,347
810,0.02,"(13, 14)","(27, 27)",4,161,104,269,5,151,90,246
811,0.08,"(0, 12)","(16, 0)",14,161,123,298,13,241,116,370
812,0.16,"(20, 12)","(3, 15)",8,181,142,331,9,121,42,172
813,0.16,"(16, 16)","(5, 12)",6,121,62,189,5,61,31,97
814,0.18,"(22, 15)","(14, 11)",8,221,256,485,3,121,34,158
815,0.2,"(4, 1)","(28, 8)",5,141,154,300,13,151,139,303
816,0.18,"(0, 19)","(29, 4)",5,81,62,148,7,91,66,164
817,0.14,"(8, 14)","(14, 12)",7,121,84,212,7,181,75,263
818,0.04,"(10, 12)","(2, 1)",10,141,42,193,7,121,37,165
819,0.06,"(9, 13)","(29, 29)",5,121,52,178,6,61,86,153
820,0.12,"(6, 4)","(12, 0)",5,141,55,201,7,121,37,165
821,0.12,"(10, 9)","(23, 27)",10,101,60,171,11,181,155,347
822,0.18,"(19, 4)","(19, 15)",8,81,53,142,7,181,77,265
823,0.12,"(14, 12)","(1, 14)",11,81,29,121,5,121,47,173
824,0.14,"(29, 10)","(28, 10)",9,61,21,91,7,121,32,160
825,0.14,"(23, 15)","(25, 14)",5,141,77,223,4,61,7,72
826,0.18,"(29, 8)","(21, 1)",2,121,209,332,11,151,111,273
827,0.14,"(2, 23)","(15, 13)",3,121,136,260,11,121,122,254
828,0.02,"(7, 20)","(4, 29)",12,301,167,480,5,331,149,485
829,0.16,"(0, 21)","(17, 3)",6,81,79,166,28,151,108,287
830,0.04,"(27, 4)","(24, 4)",3,21,7,31,5,61,12,78
831,0.06,"(24, 24)","(8, 8)",7,181,107,295,6,91,98,195
832,0.12,"(25, 0)","(29, 14)",6,201,155,362,6,121,53,180
833,0.06,"(2, 9)","(17, 19)",6,61,74,141,9,211,95,315
834,0.16,"(19, 29)","(2, 5)",3,121,72,196,11,91,68,170
835,0.2,"(25, 0)","(23, 24)",2,161,136,299,6,241,138,385
836,0.12,"(0, 23)","(8, 6)",6,121,80,207,13,331,189,533
837,0.2,"(6, 24)","(0, 16)",5,21,20,46,8,61,24,93
838,0.06,"(6, 9)","(29, 10)",7,121,110,238,13,151,115,279
839,0.08,"(0, 8)","(10, 0)",5,61,75,141,13,181,93,287
840,0.2,"(7, 25)","(4, 26)",5,101,25,131,5,91,15,111
841,0.18,"(22, 18)","(21, 15)",19,81,42,142,6,181,64,251
842,0.2,"(4, 10)","(18, 26)",46,201,244,491,17,121,85,223
843,0.04,"(7, 29)","(25, 0)",8,101,79,188,4,211,91,306
844,0.14,"(23, 17)","(15, 2)",6,161,114,281,11,181,86,278
845,0.08,"(9, 18)","(23, 4)",3,121,56,180,21,211,139,371
846,0.2,"(24, 18)","(28, 2)",13,81,152,246,16,121,155,292
847,0.12,"(12, 14)","(23, 14)",18,121,105,244,10,211,95,316
848,0.04,"(26, 13)","(8, 14)",7,41,41,89,6,121,63,190
849,0.08,"(26, 22)","(18, 3)",4,181,121,306,11,181,100,292
850,0.06,"(0, 25)","(0, 18)",3,21,19,43,18,121,41,180
851,0.16,"(10, 12)","(3, 21)",5,141,79,225,13,181,112,306
852,0.14,"(7, 9)","(26, 17)",25,101,87,213,8,151,72,231
853,0.06,"(21, 18)","(23, 8)",3,221,80,304,4,211,103,318
854,0.2,"(18, 18)","(24, 8)",10,101,65,176,16,211,182,409
855,0.18,"(5, 1)","(26, 3)",9,161,121,291,17,181,121,319
856,0.12,"(0, 25)","(29, 6)",10,121,85,216,12,211,89,312
857,0.08,"(12, 20)","(8, 23)",7,81,55,143,8,121,54,183
858,0.1,"(5, 29)","(10, 27)",14,121,62,197,3,151,37,191
859,0.16,"(6, 26)","(19, 29)",7,101,82,190,5,151,48,204
860,0.18,"(13, 20)","(18, 29)",8,121,84,213,6,181,90,277
861,0.2,"(2, 18)","(25, 13)",6,121,127,254,6,181,133,320
862,0.04,"(23, 16)","(23, 4)",7,141,98,246,9,271,71,351
863,0.2,"(5, 29)","(5, 25)",13,41,45,99,18,61,48,127
864,0.02,"(6, 21)","(3, 9)",7,241,97,345,5,151,36,192
865,0.18,"(0, 10)","(6, 14)",4,81,34,119,15,121,54,190
866,0.18,"(16, 15)","(12, 24)",11,61,60,132,8,181,96,285
867,0.08,"(19, 0)","(8, 13)",8,181,101,290,7,241,75,323
868,0.16,"(5, 22)","(1, 16)",19,81,42,142,6,61,38,105
869,0.02,"(24, 6)","(20, 13)",9,101,49,159,5,121,41,167
870,0.16,"(27, 23)","(4, 22)",6,161,125,292,8,61,40,109
871,0.18,"(3, 7)","(27, 6)",13,121,126,260,17,181,102,300
872,0.14,"(13, 13)","(15, 8)",7,61,19,87,10,151,59,220
873,0.1,"(26, 2)","(24, 14)",17,101,69,187,14,121,66,201
874,0.02,"(25, 2)","(17, 20)",10,261,109,380,7,211,110,328
875,0.14,"(17, 12)","(4, 26)",5,161,72,238,5,91,53,149
876,0.12,"(27, 26)","(16, 3)",9,161,132,302,18,211,139,368
877,0.08,"(23, 27)","(22, 18)",17,161,60,238,6,121,46,173
878,0.08,"(19, 16)","(11, 4)",5,141,94,240,16,181,90,287
879,0.04,"(27, 3)","(15, 15)",3,121,144,268,7,301,74,382
880,0.06,"(14, 26)","(29, 21)",9,141,96,246,9,241,95,345
881,0.08,"(4, 20)","(9, 24)",11,101,49,161,6,121,46,173
882,0.12,"(4, 24)","(19, 29)",15,81,119,215,6,61,81,148
883,0.12,"(2, 26)","(0, 0)",7,41,103,151,6,121,69,196
884,0.02,"(0, 26)","(18, 6)",3,361,140,504,4,331,105,440
885,0.14,"(14, 16)","(4, 10)",11,121,49,181,5,61,34,100
886,0.08,"(4, 29)","(19, 4)",5,161,124,290,4,181,109,294
887,0.14,"(4, 25)","(29, 4)",10,81,69,160,7,121,88,216
888,0.1,"(5, 17)","(12, 1)",6,101,59,166,6,211,96,313
889,0.02,"(25, 18)","(29, 4)",7,141,132,280,7,181,85,273
890,0.1,"(15, 9)","(5, 25)",8,81,50,139,6,271,120,397
891,0.02,"(9, 2)","(6, 16)",7,181,62,250,20,301,104,425
892,0.18,"(28, 1)","(26, 18)",6,141,201,348,6,241,187,434
893,0.12,"(28, 20)","(26, 18)",5,101,30,136,3,61,18,82
894,0.06,"(28, 27)","(28, 3)",3,121,117,241,2,151,88,241
895,0.04,"(28, 26)","(6, 16)",15,201,131,347,17,181,75,273
896,0.2,"(5, 9)","(19, 19)",6,141,163,310,4,181,188,373
897,0.1,"(0, 16)","(0, 9)",3,21,15,39,5,61,21,87
898,0.04,"(5, 14)","(1, 29)",4,101,77,182,8,121,72,201
899,0.2,"(4, 29)","(16, 19)",37,81,93,211,8,241,223,472
900,0.1,"(7, 12)","(19, 11)",8,161,95,264,6,271,121,398
901,0.02,"(22, 27)","(25, 16)",6,161,44,211,8,181,39,228
902,0.02,"(20, 25)","(20, 21)",7,261,95,363,12,121,34,167
903,0.18,"(4, 10)","(19, 21)",13,101,132,246,24,151,133,308
904,0.04,"(1, 13)","(25, 29)",8,41,62,111,10,61,60,131
905,0.14,"(16, 12)","(9, 24)",17,141,121,279,6,151,99,256
906,0.16,"(29, 7)","(19, 21)",4,161,71,236,4,151,62,217
907,0.18,"(12, 3)","(28, 9)",5,161,219,385,26,241,133,400
908,0.06,"(24, 8)","(19, 13)",8,141,57,206,24,241,100,365
909,0.08,"(27, 5)","(26, 7)",5,121,27,153,4,151,19,174
910,0.16,"(19, 15)","(29, 21)",6,121,137,264,12,181,86,279
911,0.1,"(20, 0)","(9, 10)",2,121,54,177,15,151,95,261
912,0.08,"(16, 20)","(8, 18)",7,81,38,126,5,331,117,453
913,0.2,"(5, 0)","(27, 2)",7,121,163,291,6,151,168,325
914,0.08,"(16, 26)","(6, 1)",2,121,62,185,5,151,66,222
915,0.12,"(24, 29)","(6, 15)",6,121,100,227,6,181,81,268
916,0.16,"(5, 16)","(27, 22)",9,181,121,311,12,211,127,350
917,0.04,"(1, 17)","(5, 0)",3,101,44,148,3,61,26,90
918,0.2,"(22, 26)","(20, 7)",10,121,108,239,14,211,137,362
919,0.2,"(15, 14)","(22, 12)",8,121,51,180,6,121,41,168
920,0.18,"(6, 8)","(9, 11)",13,81,36,130,6,121,37,164
921,0.1,"(20, 17)","(11, 13)",8,141,141,290,7,181,77,265
922,0.14,"(10, 12)","(25, 12)",7,161,112,280,6,211,108,325
923,0.06,"(26, 6)","(15, 20)",7,241,132,380,6,301,149,456
924,0.12,"(20, 26)","(17, 29)",4,61,28,93,11,91,29,131
925,0.12,"(15, 27)","(19, 17)",7,161,77,245,7,181,57,245
926,0.2,"(6, 29)","(19, 14)",6,121,204,331,19,151,207,377
927,0.18,"(3, 24)","(24, 24)",9,161,149,319,4,151,93,248
928,0.18,"(19, 29)","(5, 18)",3,181,135,319,6,271,156,433
929,0.2,"(17, 6)","(7, 20)",5,81,79,165,11,241,143,395
930,0.02,"(27, 6)","(6, 8)",6,281,138,425,6,181,44,231
931,0.12,"(8, 23)","(11, 12)",5,181,78,264,5,181,88,274
932,0.08,"(18, 9)","(24, 5)",8,81,63,152,10,121,43,174
933,0.12,"(27, 15)","(27, 14)",5,181,36,222,7,1,7,15
934,0.08,"(27, 20)","(16, 4)",6,141,107,254,10,91,69,170
935,0.02,"(26, 19)","(1, 8)",4,141,78,223,6,151,95,252
936,0.06,"(20, 8)","(2, 11)",5,161,108,274,13,61,34,108
937,0.04,"(20, 27)","(18, 2)",4,121,85,210,10,271,114,395
938,0.02,"(3, 2)","(5, 1)",5,101,50,156,7,241,52,300
939,0.08,"(21, 19)","(23, 7)",15,181,112,308,13,301,97,411
940,0.14,"(27, 18)","(4, 29)",4,61,103,168,12,91,116,219
941,0.2,"(0, 10)","(15, 8)",12,181,191,384,4,211,68,283
942,0.1,"(11, 6)","(19, 24)",5,121,80,206,11,181,106,298
943,0.08,"(12, 26)","(0, 8)",6,121,116,243,5,31,35,71
944,0.04,"(29, 21)","(12, 11)",12,281,117,410,4,241,104,349
945,0.14,"(13, 2)","(29, 17)",10,121,124,255,15,181,111,307
946,0.08,"(1, 20)","(1, 11)",3,41,19,63,5,151,66,222
947,0.16,"(16, 26)","(19, 4)",6,121,113,240,8,151,75,234
948,0.02,"(27, 29)","(10, 7)",4,241,128,373,3,211,97,311
949,0.18,"(20, 15)","(25, 24)",9,141,103,253,5,181,106,292
950,0.02,"(27, 17)","(14, 27)",5,101,78,184,8,211,115,334
951,0.2,"(20, 8)","(28, 4)",7,141,56,204,9,121,69,199
952,0.04,"(25, 24)","(6, 1)",6,101,78,185,17,151,86,254
953,0.04,"(10, 4)","(8, 22)",3,141,73,217,5,211,100,316
954,0.12,"(3, 4)","(15, 25)",5,81,102,188,5,151,90,246
955,0.16,"(29, 7)","(7, 6)",9,141,148,298,11,61,42,114
956,0.08,"(10, 5)","(8, 3)",6,61,22,89,36,271,108,415
957,0.2,"(0, 10)","(9, 0)",3,201,119,323,5,121,109,235
958,0.16,"(10, 12)","(10, 9)",3,101,29,133,7,91,20,118
959,0.06,"(24, 27)","(27, 15)",6,141,67,214,7,91,70,168
960,0.02,"(15, 18)","(8, 12)",8,221,228,457,11,211,87,309
961,0.04,"(20, 25)","(0, 4)",7,21,48,76,7,61,49,117
962,0.16,"(5, 2)","(17, 26)",6,101,95,202,4,121,105,230
963,0.18,"(2, 19)","(15, 10)",5,161,179,345,8,151,178,337
964,0.06,"(2, 8)","(8, 29)",3,81,67,151,3,241,63,307
965,0.06,"(19, 22)","(29, 3)",12,121,130,263,8,151,89,248
966,0.1,"(11, 0)","(3, 29)",16,121,98,235,7,121,54,182
967,0.18,"(15, 4)","(23, 26)",12,161,157,330,7,151,94,252
968,0.1,"(26, 27)","(28, 16)",7,61,79,147,6,151,71,228
969,0.04,"(22, 29)","(20, 1)",6,161,122,289,8,181,95,284
970,0.04,"(24, 18)","(23, 0)",5,221,116,342,4,151,103,258
971,0.04,"(28, 5)","(10, 25)",6,241,116,363,3,271,103,377
972,0.18,"(25, 11)","(3, 21)",7,61,69,137,5,91,67,163
973,0.08,"(26, 12)","(4, 19)",4,101,60,165,10,271,81,362
974,0.04,"(20, 9)","(14, 6)",5,121,87,213,4,301,93,398
975,0.1,"(22, 14)","(19, 5)",7,101,48,156,9,181,96,286
976,0.1,"(13, 13)","(16, 25)",7,61,57,125,6,181,79,266
977,0.2,"(6, 0)","(4, 3)",4,61,11,76,6,61,15,82
978,0.02,"(6, 24)","(21, 13)",3,181,108,292,3,271,94,368
979,0.08,"(18, 14)","(28, 14)",3,261,82,346,5,181,98,284
980,0.06,"(25, 5)","(24, 10)",6,241,98,345,9,91,38,138
981,0.16,"(27, 21)","(15, 7)",5,141,180,326,4,151,62,217
982,0.14,"(19, 18)","(18, 1)",5,101,67,173,6,181,114,301
983,0.06,"(10, 7)","(9, 6)",4,61,8,73,4,91,10,105
984,0.16,"(2, 23)","(20, 15)",9,181,161,351,3,211,121,335
985,0.1,"(28, 8)","(25, 22)",3,221,188,412,5,181,58,244
986,0.14,"(7, 10)","(28, 19)",36,141,164,341,3,151,97,251
987,0.18,"(3, 29)","(3, 15)",4,41,26,71,6,121,35,162
988,0.18,"(4, 25)","(0, 3)",8,61,103,172,20,91,114,225
989,0.1,"(29, 11)","(1, 9)",5,161,124,290,9,181,77,267
990,0.16,"(11, 8)","(29, 21)",5,61,75,141,11,121,75,207
991,0.18,"(21, 17)","(9, 10)",7,141,90,238,14,151,111,276
992,0.18,"(13, 27)","(13, 21)",6,61,26,93,7,241,45,293
993,0.12,"(9, 8)","(17, 23)",14,121,96,231,9,151,107,267
994,0.02,"(23, 20)","(7, 24)",9,121,57,187,4,511,122,637
995,0.14,"(0, 28)","(25, 17)",8,81,149,238,4,241,138,383
996,0.18,"(13, 2)","(8, 26)",10,101,93,204,9,181,110,300
997,0.16,"(17, 1)","(16, 21)",4,81,90,175,7,271,171,449
998,0.18,"(21, 4)","(8, 13)",8,181,184,373,7,211,77,295
999,0.18,"(9, 3)","(1, 23)",9,121,48,178,10,91,105,206
,,,,8.087,129,94.449,231.536,8.43,169.57,83.434,261.434
