0,0.12,"(2, 18)","(26, 21)",6,103,151,260,5,44,135,184
1,0.06,"(29, 25)","(3, 19)",10,100,90,200,4,74,237,315
2,0.02,"(13, 23)","(19, 17)",17,118,118,253,6,49,82,137
3,0.16,"(20, 0)","(5, 19)",5,88,102,195,4,69,522,595
4,0.16,"(14, 16)","(2, 18)",10,79,71,160,7,21,20,48
5,0.08,"(8, 7)","(15, 16)",7,82,68,157,4,89,701,794
6,0.06,"(6, 1)","(4, 29)",5,76,99,180,4,38,114,156
7,0.12,"(13, 20)","(2, 4)",5,91,86,182,4,49,412,465
8,0.18,"(19, 27)","(22, 7)",8,97,183,288,8,40,98,146
9,0.2,"(4, 28)","(17, 17)",6,73,116,195,4,36,68,108
10,0.16,"(26, 26)","(18, 24)",4,70,36,110,4,33,30,67
11,0.1,"(10, 24)","(0, 9)",4,85,112,201,7,35,119,161
12,0.02,"(17, 1)","(5, 25)",10,103,216,329,5,79,248,332
13,0.14,"(19, 5)","(29, 13)",10,70,149,229,5,37,74,116
14,0.08,"(12, 0)","(10, 10)",6,70,40,116,7,36,53,96
15,0.16,"(12, 27)","(18, 19)",10,112,159,281,7,50,277,334
16,0.2,"(11, 29)","(16, 16)",8,76,43,127,23,45,201,269
17,0.2,"(12, 3)","(18, 29)",6,88,64,158,20,47,378,445
18,0.1,"(21, 19)","(1, 12)",7,97,81,185,9,47,217,273
19,0.16,"(2, 17)","(29, 16)",15,91,198,304,8,37,173,218
20,0.02,"(0, 26)","(26, 23)",10,76,60,146,15,91,328,434
21,0.12,"(5, 22)","(11, 28)",17,76,47,140,9,38,123,170
22,0.12,"(17, 22)","(19, 19)",24,79,74,177,11,40,69,120
23,0.16,"(6, 16)","(7, 4)",5,67,37,109,5,46,274,325
24,0.2,"(28, 9)","(10, 25)",2,79,81,162,4,67,1005,1076
25,0.04,"(1, 10)","(5, 19)",2,61,32,95,2,37,52,91
26,0.06,"(24, 17)","(13, 27)",14,100,111,225,10,42,67,119
27,0.04,"(25, 20)","(2, 28)",4,109,135,248,5,38,143,186
28,0.06,"(28, 29)","(0, 28)",12,64,48,124,4,38,78,120
29,0.14,"(5, 6)","(24, 23)",11,79,77,167,10,35,95,140
30,0.04,"(5, 18)","(1, 27)",3,73,31,107,4,78,276,358
31,0.18,"(27, 18)","(9, 12)",4,73,132,209,8,46,216,270
32,0.12,"(5, 13)","(8, 15)",5,82,75,162,11,34,34,79
33,0.14,"(23, 2)","(13, 8)",12,73,51,136,8,37,45,90
34,0.06,"(27, 13)","(4, 29)",17,181,617,815,14,95,442,551
35,0.06,"(19, 6)","(2, 2)",6,88,105,199,5,43,97,145
36,0.16,"(0, 14)","(28, 22)",8,82,101,191,6,59,382,447
37,0.14,"(22, 25)","(9, 18)",8,70,42,120,4,55,306,365
38,0.06,"(4, 0)","(11, 27)",6,88,139,233,8,47,97,152
39,0.02,"(14, 19)","(27, 16)",25,100,135,260,22,58,163,243
40,0.02,"(8, 19)","(28, 12)",14,85,84,183,8,141,594,743
41,0.06,"(20, 23)","(23, 23)",11,91,54,156,4,53,83,140
42,0.02,"(10, 22)","(21, 14)",4,118,114,236,11,104,652,767
43,0.04,"(23, 29)","(29, 8)",2,88,94,184,12,63,174,249
44,0.12,"(4, 10)","(13, 24)",5,88,99,192,4,51,273,328
45,0.1,"(14, 5)","(0, 7)",6,112,190,308,6,49,99,154
46,0.06,"(14, 25)","(6, 17)",4,103,144,251,3,31,36,70
47,0.18,"(24, 11)","(18, 19)",16,70,41,127,10,42,156,208
48,0.12,"(4, 6)","(21, 26)",7,73,56,136,6,59,316,381
49,0.04,"(1, 26)","(18, 10)",4,82,117,203,4,42,95,141
50,0.1,"(11, 18)","(12, 13)",6,70,36,112,4,71,357,432
51,0.12,"(15, 15)","(25, 7)",5,76,165,246,9,34,115,158
52,0.14,"(9, 29)","(28, 0)",5,94,167,266,10,44,147,201
53,0.12,"(23, 28)","(28, 11)",3,76,77,156,8,44,90,142
54,0.04,"(18, 3)","(0, 21)",5,67,47,119,13,32,97,142
55,0.2,"(18, 25)","(18, 28)",5,76,45,126,8,33,27,68
56,0.2,"(18, 18)","(4, 17)",6,76,46,128,14,61,637,712
57,0.06,"(22, 6)","(8, 2)",3,94,130,227,5,53,122,180
58,0.2,"(22, 1)","(16, 4)",7,70,32,109,10,31,33,74
59,0.12,"(15, 8)","(21, 2)",12,85,121,218,8,56,256,320
60,0.06,"(14, 9)","(12, 27)",12,76,69,157,3,52,213,268
61,0.2,"(16, 11)","(19, 15)",9,85,75,169,5,39,97,141
62,0.06,"(1, 21)","(25, 5)",9,70,62,141,9,46,113,168
63,0.18,"(6, 21)","(13, 24)",9,70,56,135,9,45,140,194
64,0.1,"(11, 18)","(4, 22)",12,88,133,233,5,48,175,228
65,0.02,"(1, 24)","(5, 7)",4,121,124,249,5,58,142,205
66,0.2,"(28, 29)","(28, 20)",14,70,51,135,7,64,547,618
67,0.14,"(21, 22)","(9, 21)",6,88,82,176,4,36,67,107
68,0.2,"(5, 16)","(16, 25)",7,79,77,163,9,49,147,205
69,0.14,"(12, 26)","(25, 5)",8,94,170,272,18,51,253,322
70,0.18,"(5, 8)","(5, 2)",10,61,45,116,4,45,117,166
71,0.12,"(18, 19)","(13, 12)",17,88,89,194,7,43,110,160
72,0.14,"(15, 13)","(2, 0)",9,76,48,133,5,35,111,151
73,0.04,"(12, 14)","(28, 2)",19,85,112,216,6,37,89,132
74,0.1,"(16, 27)","(3, 9)",11,100,106,217,8,46,150,204
75,0.16,"(1, 6)","(25, 9)",3,109,177,289,6,54,183,243
76,0.16,"(9, 28)","(21, 6)",3,112,267,382,3,64,354,421
77,0.12,"(18, 10)","(7, 8)",5,67,34,106,5,34,35,74
78,0.14,"(6, 23)","(1, 4)",5,100,177,282,4,40,80,124
79,0.1,"(1, 16)","(22, 26)",6,91,78,175,3,51,124,178
80,0.12,"(4, 10)","(5, 23)",5,70,42,117,7,44,164,215
81,0.1,"(12, 1)","(10, 3)",4,21,7,32,10,42,51,103
82,0.1,"(26, 25)","(25, 23)",22,61,29,112,15,49,117,181
83,0.04,"(9, 14)","(19, 8)",19,106,207,332,5,96,503,604
84,0.06,"(21, 16)","(14, 16)",4,91,53,148,4,36,41,81
85,0.18,"(23, 28)","(8, 2)",9,73,84,166,6,47,170,223
86,0.1,"(12, 17)","(10, 0)",7,88,266,361,3,39,61,103
87,0.18,"(28, 20)","(15, 19)",7,67,36,110,4,38,42,84
88,0.14,"(27, 24)","(3, 3)",7,79,88,174,6,52,152,210
89,0.06,"(24, 10)","(21, 23)",7,70,47,124,14,73,430,517
90,0.06,"(21, 2)","(25, 7)",4,85,66,155,5,53,179,237
91,0.12,"(14, 23)","(20, 10)",6,82,108,196,6,47,190,243
92,0.16,"(4, 22)","(3, 7)",4,70,30,104,2,51,412,465
93,0.1,"(5, 18)","(6, 7)",17,82,58,157,37,60,156,253
94,0.16,"(1, 22)","(18, 15)",7,118,191,316,3,86,984,1073
95,0.04,"(10, 15)","(3, 12)",11,127,218,356,10,44,101,155
96,0.18,"(13, 29)","(6, 21)",28,82,86,196,11,47,153,211
97,0.06,"(22, 23)","(3, 5)",5,88,72,165,16,50,224,290
98,0.1,"(5, 6)","(3, 14)",7,73,40,120,7,35,69,111
99,0.02,"(21, 13)","(10, 13)",15,67,42,124,12,59,117,188
100,0.02,"(2, 3)","(9, 29)",10,67,82,159,8,50,183,241
101,0.12,"(7, 25)","(17, 10)",10,76,64,150,4,44,126,174
102,0.16,"(17, 0)","(15, 28)",3,97,144,244,14,41,138,193
103,0.12,"(22, 13)","(15, 23)",2,85,61,148,8,51,125,184
104,0.06,"(13, 12)","(23, 10)",5,106,109,220,14,46,110,170
105,0.12,"(4, 8)","(1, 9)",4,21,5,30,6,49,83,138
106,0.16,"(20, 26)","(23, 27)",4,67,20,91,13,33,35,81
107,0.14,"(2, 26)","(0, 12)",4,61,20,85,7,33,29,69
108,0.1,"(7, 11)","(11, 7)",26,73,77,176,8,61,209,278
109,0.2,"(19, 10)","(25, 22)",10,82,134,226,9,39,116,164
110,0.02,"(0, 28)","(7, 18)",4,157,146,307,4,64,110,178
111,0.02,"(16, 25)","(22, 20)",10,85,82,177,9,51,145,205
112,0.06,"(20, 6)","(11, 29)",5,79,66,150,7,50,130,187
113,0.1,"(27, 9)","(24, 20)",5,70,50,125,22,56,260,338
114,0.02,"(13, 14)","(17, 7)",6,157,212,375,6,71,390,467
115,0.12,"(18, 17)","(16, 19)",17,67,33,117,9,37,46,92
116,0.14,"(7, 26)","(14, 20)",9,88,71,168,13,46,89,148
117,0.06,"(28, 16)","(15, 9)",7,79,89,175,4,45,88,137
118,0.12,"(13, 0)","(24, 18)",8,82,114,204,7,74,711,792
119,0.2,"(4, 8)","(29, 16)",8,91,250,349,3,66,721,790
120,0.06,"(11, 7)","(6, 17)",5,94,83,182,6,76,621,703
121,0.14,"(5, 21)","(9, 8)",7,82,49,138,14,41,86,141
122,0.18,"(7, 7)","(28, 8)",5,91,178,274,7,65,271,343
123,0.08,"(17, 28)","(1, 7)",8,82,80,170,4,47,139,190
124,0.02,"(2, 26)","(25, 15)",4,103,159,266,18,81,291,390
125,0.1,"(16, 0)","(24, 19)",12,97,160,269,13,67,265,345
126,0.04,"(23, 16)","(25, 29)",5,85,115,205,10,31,55,96
127,0.2,"(9, 0)","(8, 18)",7,100,142,249,4,54,235,293
128,0.12,"(2, 8)","(5, 13)",5,64,24,93,7,44,63,114
129,0.14,"(29, 27)","(27, 0)",8,73,56,137,9,38,218,265
130,0.12,"(29, 24)","(24, 10)",8,88,65,161,10,45,86,141
131,0.1,"(1, 8)","(0, 26)",4,70,77,151,10,37,92,139
132,0.1,"(20, 8)","(25, 13)",9,94,70,173,8,35,69,112
133,0.12,"(28, 22)","(2, 0)",5,112,122,239,10,47,106,163
134,0.12,"(29, 27)","(25, 22)",5,21,13,39,15,36,70,121
135,0.02,"(8, 25)","(25, 12)",7,91,90,188,6,51,137,194
136,0.06,"(12, 14)","(22, 0)",4,82,52,138,26,36,144,206
137,0.18,"(27, 28)","(15, 14)",5,82,99,186,8,44,72,124
138,0.06,"(16, 9)","(13, 26)",8,94,116,218,8,59,415,482
139,0.04,"(21, 18)","(8, 2)",3,130,147,280,10,60,244,314
140,0.1,"(16, 21)","(0, 13)",15,67,77,159,11,32,50,93
141,0.08,"(22, 22)","(25, 19)",8,82,85,175,4,43,82,129
142,0.2,"(2, 25)","(25, 27)",7,88,244,339,10,38,113,161
143,0.02,"(18, 17)","(25, 21)",6,130,186,322,6,77,251,334
144,0.2,"(11, 13)","(26, 23)",7,73,65,145,6,35,85,126
145,0.04,"(24, 13)","(22, 21)",7,85,107,199,13,89,295,397
146,0.16,"(10, 18)","(22, 16)",5,103,171,279,5,42,95,142
147,0.04,"(11, 23)","(10, 23)",12,64,18,94,4,33,11,48
148,0.18,"(27, 11)","(14, 29)",8,82,140,230,3,66,692,761
149,0.18,"(18, 7)","(6, 18)",7,73,49,129,3,41,124,168
150,0.2,"(5, 7)","(8, 7)",9,73,54,136,13,36,76,125
151,0.06,"(0, 10)","(17, 21)",6,88,105,199,4,47,83,134
152,0.14,"(19, 1)","(12, 7)",12,73,50,135,6,43,54,103
153,0.06,"(9, 4)","(26, 10)",9,79,63,151,8,57,154,219
154,0.12,"(23, 18)","(10, 27)",6,88,114,208,8,56,327,391
155,0.02,"(29, 18)","(27, 13)",9,61,25,95,6,40,50,96
156,0.18,"(27, 20)","(19, 13)",6,97,206,309,7,33,52,92
157,0.08,"(24, 24)","(15, 18)",5,79,42,126,8,66,301,375
158,0.14,"(19, 3)","(4, 1)",5,64,35,104,10,37,147,194
159,0.16,"(21, 25)","(28, 13)",6,79,88,173,7,42,231,280
160,0.08,"(0, 21)","(5, 16)",8,61,35,104,7,49,81,137
161,0.14,"(9, 1)","(8, 28)",3,88,143,234,7,36,95,138
162,0.14,"(23, 5)","(8, 19)",5,106,123,234,8,53,128,189
163,0.14,"(2, 29)","(10, 24)",20,73,72,165,4,31,37,72
164,0.14,"(15, 28)","(23, 17)",33,64,82,179,8,33,50,91
165,0.04,"(5, 2)","(25, 0)",6,76,123,205,11,34,78,123
166,0.16,"(24, 27)","(9, 23)",8,100,141,249,18,36,93,147
167,0.14,"(23, 17)","(2, 5)",10,73,79,162,8,44,86,138
168,0.18,"(3, 1)","(21, 21)",5,70,95,170,8,53,165,226
169,0.12,"(5, 9)","(16, 26)",7,76,51,134,8,53,142,203
170,0.08,"(26, 0)","(25, 25)",6,88,135,229,4,51,303,358
171,0.06,"(7, 5)","(19, 8)",9,154,235,398,8,54,209,271
172,0.06,"(20, 8)","(11, 8)",13,94,114,221,5,35,40,80
173,0.2,"(24, 20)","(29, 1)",5,70,162,237,8,34,165,207
174,0.12,"(13, 13)","(10, 29)",6,88,200,294,23,40,329,392
175,0.1,"(5, 0)","(15, 0)",4,88,59,151,7,39,71,117
176,0.02,"(29, 10)","(11, 27)",4,82,86,172,2,55,173,230
177,0.14,"(18, 28)","(21, 18)",6,88,53,147,20,40,311,371
178,0.12,"(13, 24)","(6, 15)",7,85,102,194,4,46,145,195
179,0.2,"(28, 1)","(4, 2)",4,109,357,470,10,43,125,178
180,0.18,"(29, 6)","(26, 24)",11,88,151,250,6,40,78,124
181,0.2,"(15, 2)","(15, 4)",8,64,15,87,4,36,22,62
182,0.06,"(12, 24)","(25, 8)",20,97,161,278,11,60,144,215
183,0.08,"(29, 3)","(0, 3)",3,70,97,170,4,41,118,163
184,0.16,"(7, 0)","(28, 14)",5,76,80,161,8,45,166,219
185,0.14,"(15, 21)","(5, 16)",11,73,50,134,8,41,101,150
186,0.08,"(5, 29)","(20, 21)",13,103,163,279,11,49,103,163
187,0.1,"(2, 29)","(25, 1)",4,85,180,269,5,40,82,127
188,0.1,"(6, 22)","(20, 15)",6,64,59,129,8,41,285,334
189,0.18,"(20, 14)","(5, 17)",5,64,38,107,6,35,34,75
190,0.2,"(29, 13)","(19, 4)",6,76,80,162,10,61,621,692
191,0.08,"(23, 4)","(23, 1)",8,67,24,99,5,35,26,66
192,0.08,"(3, 22)","(21, 1)",8,76,68,152,8,49,103,160
193,0.1,"(19, 25)","(0, 17)",4,67,55,126,5,35,52,92
194,0.2,"(19, 14)","(6, 2)",19,139,334,492,6,66,337,409
195,0.2,"(14, 8)","(8, 27)",15,82,78,175,8,37,64,109
196,0.12,"(28, 21)","(17, 26)",2,85,68,155,3,37,58,98
197,0.14,"(23, 20)","(17, 2)",8,73,59,140,6,36,99,141
198,0.08,"(26, 2)","(7, 17)",7,82,93,182,6,61,176,243
199,0.02,"(12, 13)","(1, 20)",10,118,171,299,26,36,62,124
200,0.14,"(15, 8)","(18, 14)",5,100,170,275,6,75,639,720
201,0.16,"(3, 18)","(21, 4)",11,88,203,302,7,48,331,386
202,0.1,"(25, 18)","(4, 27)",6,91,85,182,5,45,144,194
203,0.12,"(12, 20)","(13, 23)",3,67,12,82,5,33,15,53
204,0.16,"(0, 26)","(2, 14)",7,73,34,114,4,31,21,56
205,0.08,"(29, 18)","(18, 21)",4,61,21,86,3,32,22,57
206,0.12,"(16, 27)","(24, 24)",14,70,86,170,5,40,162,207
207,0.2,"(29, 14)","(17, 16)",8,88,85,181,10,35,45,90
208,0.08,"(5, 0)","(29, 1)",2,64,57,123,6,37,138,181
209,0.12,"(13, 16)","(29, 24)",10,82,209,301,7,41,222,270
210,0.2,"(0, 26)","(23, 10)",6,76,173,255,5,40,174,219
211,0.02,"(24, 14)","(24, 28)",4,64,49,117,6,45,81,132
212,0.2,"(15, 23)","(5, 11)",11,106,179,296,7,47,188,242
213,0.08,"(3, 2)","(7, 27)",11,73,102,186,13,34,90,137
214,0.16,"(25, 11)","(17, 23)",7,79,128,214,7,21,23,51
215,0.02,"(19, 21)","(9, 17)",5,82,69,156,4,44,82,130
216,0.06,"(11, 21)","(22, 18)",8,130,274,412,6,33,80,119
217,0.1,"(9, 20)","(4, 6)",40,85,145,270,13,33,37,83
218,0.08,"(26, 3)","(14, 22)",6,115,155,276,5,50,139,194
219,0.08,"(18, 22)","(20, 1)",9,94,152,255,5,39,173,217
220,0.14,"(11, 4)","(16, 24)",11,82,157,250,10,40,157,207
221,0.14,"(13, 20)","(3, 28)",5,82,50,137,9,34,44,87
222,0.2,"(26, 19)","(17, 8)",6,94,82,182,12,35,68,115
223,0.06,"(10, 27)","(4, 9)",3,94,54,151,11,58,209,278
224,0.06,"(5, 13)","(8, 21)",5,79,50,134,8,46,129,183
225,0.12,"(28, 21)","(3, 23)",9,103,158,270,17,42,97,156
226,0.08,"(27, 28)","(19, 0)",4,76,86,166,8,53,137,198
227,0.12,"(5, 8)","(18, 27)",4,88,88,180,6,69,371,446
228,0.04,"(27, 22)","(25, 17)",10,79,59,148,6,53,175,234
229,0.08,"(26, 8)","(27, 29)",30,94,119,243,4,36,184,224
230,0.06,"(20, 24)","(18, 5)",3,139,233,375,5,50,117,172
231,0.02,"(6, 9)","(3, 2)",12,109,81,202,10,41,71,122
232,0.04,"(14, 27)","(11, 23)",4,79,36,119,11,31,26,68
233,0.02,"(11, 28)","(13, 5)",5,79,65,149,8,45,154,207
234,0.02,"(28, 28)","(9, 24)",8,82,84,174,9,61,195,265
235,0.06,"(0, 0)","(10, 20)",17,100,118,235,6,67,218,291
236,0.12,"(6, 10)","(10, 17)",7,82,69,158,6,46,133,185
237,0.2,"(21, 10)","(16, 24)",5,121,366,492,5,55,310,370
238,0.2,"(12, 16)","(4, 12)",11,67,37,115,8,41,103,152
239,0.16,"(1, 18)","(19, 14)",2,73,55,130,6,53,535,594
240,0.1,"(4, 21)","(3, 3)",11,61,38,110,4,31,30,65
241,0.02,"(2, 27)","(12, 20)",9,130,162,301,10,68,309,387
242,0.14,"(26, 22)","(16, 2)",9,79,73,161,5,79,447,531
243,0.18,"(26, 29)","(28, 27)",3,76,37,116,11,42,51,104
244,0.08,"(26, 24)","(27, 19)",7,82,57,146,10,39,67,116
245,0.02,"(19, 7)","(11, 25)",6,73,48,127,12,134,573,719
246,0.1,"(26, 29)","(19, 19)",6,85,52,143,5,44,91,140
247,0.2,"(16, 22)","(11, 9)",4,64,56,124,5,42,94,141
248,0.14,"(29, 12)","(2, 3)",2,76,66,144,18,41,129,188
249,0.16,"(28, 9)","(12, 19)",6,79,107,192,7,40,110,157
250,0.04,"(22, 29)","(8, 10)",4,118,137,259,4,49,101,154
251,0.12,"(13, 29)","(1, 29)",13,73,70,156,5,54,818,877
252,0.08,"(5, 16)","(9, 0)",12,73,72,157,4,51,95,150
253,0.08,"(20, 11)","(22, 27)",6,85,80,171,4,55,213,272
254,0.14,"(21, 5)","(11, 0)",4,76,59,139,4,31,27,62
255,0.16,"(0, 0)","(0, 29)",5,67,163,235,7,69,1161,1237
256,0.02,"(17, 3)","(8, 20)",23,85,75,183,6,80,588,674
257,0.02,"(24, 25)","(8, 12)",35,181,341,557,9,75,335,419
258,0.06,"(0, 8)","(27, 16)",3,88,102,193,5,37,105,147
259,0.16,"(3, 1)","(5, 2)",8,70,24,102,8,32,18,58
260,0.1,"(19, 20)","(4, 20)",7,85,87,179,11,41,55,107
261,0.06,"(2, 0)","(12, 13)",9,133,173,315,7,68,254,329
262,0.04,"(1, 9)","(8, 11)",5,142,296,443,9,43,61,113
263,0.2,"(8, 24)","(4, 15)",20,76,119,215,19,47,212,278
264,0.1,"(6, 7)","(22, 22)",12,109,225,346,5,49,264,318
265,0.2,"(0, 5)","(10, 26)",7,85,127,219,10,43,356,409
266,0.16,"(26, 29)","(19, 26)",8,64,24,96,15,35,45,95
267,0.2,"(3, 0)","(8, 21)",3,94,84,181,20,40,127,187
268,0.14,"(26, 21)","(25, 14)",4,73,41,118,30,37,71,138
269,0.06,"(13, 9)","(15, 25)",14,97,80,191,17,73,321,411
270,0.1,"(15, 15)","(23, 16)",5,85,109,199,9,48,206,263
271,0.06,"(0, 8)","(24, 23)",6,130,196,332,3,52,99,154
272,0.16,"(24, 20)","(10, 12)",7,85,106,198,14,34,44,92
273,0.02,"(7, 18)","(15, 8)",7,127,128,262,4,82,265,351
274,0.14,"(23, 19)","(0, 24)",3,94,167,264,4,39,290,333
275,0.16,"(27, 20)","(9, 1)",10,79,95,184,4,34,143,181
276,0.02,"(6, 6)","(6, 10)",14,127,188,329,7,46,88,141
277,0.1,"(9, 1)","(15, 8)",8,118,216,342,8,40,94,142
278,0.02,"(10, 15)","(14, 20)",18,109,176,303,5,83,293,381
279,0.12,"(17, 8)","(24, 19)",16,91,127,234,12,64,252,328
280,0.16,"(1, 14)","(9, 28)",4,79,83,166,7,45,156,208
281,0.18,"(0, 27)","(25, 15)",2,79,207,288,13,57,288,358
282,0.08,"(15, 10)","(17, 28)",6,106,92,204,19,37,89,145
283,0.1,"(16, 0)","(25, 13)",3,82,88,173,3,49,132,184
284,0.1,"(12, 8)","(1, 19)",12,76,60,148,11,49,255,315
285,0.1,"(25, 2)","(8, 28)",5,97,140,242,7,44,202,253
286,0.08,"(16, 15)","(29, 28)",4,70,152,226,6,70,253,329
287,0.2,"(0, 19)","(29, 11)",10,85,234,329,20,35,134,189
288,0.06,"(8, 5)","(22, 27)",5,112,138,255,8,40,59,107
289,0.18,"(29, 23)","(22, 17)",9,88,95,192,6,32,28,66
290,0.06,"(3, 29)","(9, 9)",12,79,58,149,6,69,260,335
291,0.1,"(23, 19)","(9, 10)",9,73,60,142,3,38,65,106
292,0.1,"(13, 20)","(7, 27)",5,79,51,135,6,55,123,184
293,0.14,"(28, 3)","(3, 12)",4,76,90,170,7,48,255,310
294,0.16,"(8, 26)","(13, 2)",22,70,77,169,8,43,175,226
295,0.02,"(24, 27)","(8, 6)",7,124,265,396,4,109,510,623
296,0.08,"(3, 4)","(23, 6)",9,73,94,176,12,42,116,170
297,0.08,"(9, 20)","(19, 2)",6,85,79,170,6,46,109,161
298,0.12,"(18, 26)","(27, 16)",6,85,98,189,10,57,466,533
299,0.14,"(14, 1)","(23, 22)",10,127,233,370,4,87,1067,1158
300,0.18,"(14, 3)","(4, 8)",11,61,33,105,10,57,269,336
301,0.2,"(8, 21)","(17, 13)",5,91,89,185,3,39,61,103
302,0.12,"(16, 23)","(19, 4)",4,73,69,146,6,64,293,363
303,0.08,"(5, 12)","(5, 17)",4,79,43,126,12,33,43,88
304,0.12,"(7, 6)","(15, 9)",9,64,56,129,6,43,104,153
305,0.16,"(29, 5)","(11, 11)",4,79,73,156,5,52,411,468
306,0.2,"(14, 0)","(6, 18)",3,85,68,156,7,44,96,147
307,0.14,"(20, 11)","(0, 13)",4,76,42,122,11,57,172,240
308,0.18,"(22, 14)","(7, 20)",8,67,48,123,14,70,1103,1187
309,0.16,"(12, 13)","(16, 19)",7,100,172,279,17,39,285,341
310,0.2,"(17, 11)","(21, 13)",5,73,110,188,8,36,86,130
311,0.18,"(27, 17)","(19, 24)",5,82,83,170,5,39,71,115
312,0.18,"(17, 7)","(12, 19)",6,82,76,164,5,37,57,99
313,0.02,"(15, 26)","(20, 14)",8,115,223,346,14,48,144,206
314,0.06,"(16, 15)","(11, 7)",5,76,91,172,5,31,33,69
315,0.2,"(13, 25)","(9, 22)",3,73,32,108,2,41,51,94
316,0.06,"(27, 21)","(5, 7)",12,115,184,311,10,38,246,294
317,0.16,"(9, 21)","(25, 14)",5,79,86,170,9,36,59,104
318,0.06,"(3, 13)","(17, 22)",11,76,69,156,16,68,357,441
319,0.02,"(29, 1)","(4, 20)",5,169,480,654,7,52,146,205
320,0.02,"(28, 3)","(6, 18)",9,196,382,587,26,60,158,244
321,0.06,"(9, 29)","(15, 6)",14,100,133,247,5,72,230,307
322,0.1,"(29, 3)","(22, 29)",5,82,112,199,6,58,257,321
323,0.12,"(8, 21)","(2, 1)",11,73,141,225,8,38,152,198
324,0.2,"(2, 21)","(29, 5)",8,79,98,185,5,47,397,449
325,0.12,"(10, 12)","(12, 18)",6,70,62,138,5,48,111,164
326,0.2,"(14, 8)","(12, 17)",19,61,60,140,20,42,188,250
327,0.2,"(12, 26)","(15, 24)",11,88,100,199,7,41,66,114
328,0.14,"(10, 19)","(8, 5)",5,73,62,140,7,47,150,204
329,0.18,"(19, 0)","(25, 23)",17,112,242,371,5,56,242,303
330,0.06,"(27, 24)","(19, 17)",11,73,47,131,11,31,37,79
331,0.16,"(16, 24)","(8, 7)",12,67,56,135,7,58,281,346
332,0.2,"(1, 19)","(24, 16)",5,85,75,165,3,59,758,820
333,0.2,"(25, 6)","(6, 28)",4,88,106,198,7,42,177,226
334,0.04,"(7, 14)","(25, 0)",7,133,334,474,11,47,351,409
335,0.02,"(22, 19)","(9, 17)",11,94,100,205,9,43,67,119
336,0.08,"(18, 6)","(7, 29)",5,79,101,185,11,32,61,104
337,0.12,"(27, 23)","(4, 22)",10,88,69,167,5,59,232,296
338,0.12,"(1, 0)","(23, 18)",8,73,132,213,19,49,219,287
339,0.06,"(16, 16)","(9, 19)",4,82,101,187,3,47,126,176
340,0.2,"(5, 19)","(25, 14)",5,76,64,145,5,42,93,140
341,0.2,"(21, 14)","(6, 26)",11,82,72,165,9,49,593,651
342,0.04,"(14, 23)","(11, 6)",7,124,304,435,10,45,80,135
343,0.2,"(17, 17)","(28, 23)",6,94,143,243,14,42,427,483
344,0.2,"(29, 16)","(21, 1)",9,64,48,121,9,67,913,989
345,0.08,"(1, 0)","(6, 27)",18,73,125,216,7,52,107,166
346,0.06,"(3, 21)","(22, 20)",4,70,56,130,13,66,200,279
347,0.2,"(14, 7)","(29, 0)",5,94,100,199,6,31,57,94
348,0.08,"(18, 2)","(0, 4)",11,70,43,124,10,31,41,82
349,0.04,"(3, 10)","(13, 25)",9,103,73,185,9,65,306,380
350,0.16,"(28, 0)","(9, 26)",7,85,157,249,3,48,613,664
351,0.06,"(0, 11)","(22, 18)",23,76,102,201,15,44,88,147
352,0.16,"(1, 26)","(0, 27)",5,21,6,32,10,31,15,56
353,0.08,"(27, 26)","(26, 23)",9,61,11,81,9,52,70,131
354,0.02,"(8, 0)","(15, 24)",10,85,83,178,4,59,208,271
355,0.2,"(2, 13)","(5, 12)",10,67,26,103,8,34,44,86
356,0.08,"(8, 1)","(16, 22)",12,94,126,232,6,68,254,328
357,0.2,"(10, 18)","(3, 12)",15,64,61,140,7,33,36,76
358,0.12,"(10, 26)","(21, 22)",7,70,72,149,6,43,104,153
359,0.04,"(15, 17)","(17, 23)",14,121,166,301,3,33,26,62
360,0.04,"(27, 14)","(29, 1)",27,70,117,214,5,33,52,90
361,0.02,"(9, 24)","(16, 8)",18,67,88,173,22,56,156,234
362,0.2,"(29, 6)","(8, 10)",6,82,83,171,3,43,117,163
363,0.14,"(14, 26)","(17, 26)",14,64,42,120,12,48,185,245
364,0.2,"(29, 21)","(13, 3)",6,91,156,253,8,42,161,211
365,0.14,"(15, 24)","(12, 17)",5,61,37,103,8,31,36,75
366,0.08,"(8, 14)","(15, 8)",6,82,93,181,2,41,63,106
367,0.02,"(7, 23)","(2, 21)",10,82,44,136,10,37,28,75
368,0.18,"(1, 26)","(22, 3)",4,91,205,300,13,42,171,226
369,0.06,"(29, 6)","(27, 15)",7,76,60,143,4,53,192,249
370,0.04,"(11, 0)","(13, 7)",5,115,142,262,10,54,156,220
371,0.04,"(8, 11)","(17, 23)",6,103,95,204,8,48,141,197
372,0.02,"(22, 8)","(13, 12)",5,79,38,122,6,41,53,100
373,0.08,"(13, 17)","(12, 23)",5,67,33,105,6,33,31,70
374,0.14,"(27, 1)","(28, 20)",8,85,126,219,7,52,140,199
375,0.16,"(10, 29)","(9, 12)",8,91,87,186,5,76,562,643
376,0.14,"(2, 18)","(17, 9)",8,73,46,127,6,73,372,451
377,0.12,"(14, 26)","(11, 8)",3,67,79,149,12,44,86,142
378,0.02,"(25, 12)","(23, 3)",9,64,36,109,11,54,111,176
379,0.2,"(25, 9)","(10, 27)",9,115,441,565,6,37,150,193
380,0.18,"(25, 21)","(10, 0)",17,79,115,211,10,42,241,293
381,0.2,"(29, 28)","(12, 23)",4,88,64,156,4,47,112,163
382,0.14,"(26, 16)","(4, 16)",8,85,147,240,23,67,469,559
383,0.16,"(18, 17)","(19, 15)",8,82,85,175,7,46,116,169
384,0.16,"(17, 7)","(27, 14)",9,82,134,225,12,51,222,285
385,0.08,"(1, 8)","(6, 22)",7,85,63,155,4,33,29,66
386,0.1,"(2, 4)","(21, 3)",4,67,49,120,10,50,413,473
387,0.1,"(11, 24)","(12, 17)",7,79,42,128,5,35,56,96
388,0.04,"(0, 9)","(1, 2)",3,61,36,100,15,32,43,90
389,0.04,"(28, 29)","(24, 15)",8,88,73,169,5,82,282,369
390,0.06,"(19, 23)","(0, 10)",6,64,38,108,5,44,64,113
391,0.1,"(13, 18)","(3, 14)",5,64,65,134,5,54,351,410
392,0.04,"(10, 8)","(4, 28)",12,103,89,204,8,46,86,140
393,0.2,"(13, 26)","(19, 13)",4,85,152,241,12,55,345,412
394,0.02,"(9, 27)","(23, 29)",5,61,55,121,12,36,72,120
395,0.16,"(26, 12)","(3, 3)",4,103,377,484,6,49,388,443
396,0.12,"(25, 3)","(5, 12)",26,67,67,160,10,92,660,762
397,0.08,"(20, 3)","(21, 3)",4,70,22,96,4,1,4,9
398,0.02,"(28, 7)","(24, 14)",4,115,141,260,3,60,128,191
399,0.04,"(20, 2)","(13, 8)",12,109,105,226,5,92,333,430
400,0.18,"(9, 27)","(26, 7)",12,115,361,488,5,42,159,206
401,0.08,"(28, 8)","(10, 4)",5,91,239,335,4,43,117,164
402,0.08,"(29, 8)","(21, 19)",9,91,87,187,5,68,435,508
403,0.2,"(6, 10)","(14, 16)",7,73,42,122,22,37,79,138
404,0.16,"(29, 9)","(22, 16)",5,97,157,259,8,80,573,661
405,0.08,"(17, 24)","(18, 17)",5,103,144,252,9,47,142,198
406,0.12,"(13, 11)","(23, 8)",4,94,111,209,4,40,92,136
407,0.14,"(22, 1)","(26, 26)",3,88,119,210,10,36,111,157
408,0.04,"(24, 10)","(6, 10)",9,136,166,311,6,81,409,496
409,0.06,"(29, 8)","(9, 14)",4,115,258,377,3,48,226,277
410,0.04,"(19, 9)","(25, 21)",11,130,175,316,3,52,153,208
411,0.18,"(19, 29)","(25, 15)",11,88,116,215,10,50,318,378
412,0.02,"(27, 0)","(4, 22)",6,103,90,199,4,68,286,358
413,0.08,"(29, 12)","(15, 5)",11,79,67,157,8,44,83,135
414,0.02,"(19, 7)","(3, 5)",6,82,114,202,4,116,566,686
415,0.16,"(2, 29)","(21, 26)",9,67,63,139,8,51,283,342
416,0.2,"(7, 17)","(6, 29)",5,76,93,174,8,37,81,126
417,0.2,"(29, 1)","(12, 1)",7,64,30,101,4,57,210,271
418,0.16,"(3, 17)","(8, 22)",14,73,95,182,4,52,454,510
419,0.18,"(1, 2)","(24, 25)",4,142,508,654,8,50,469,527
420,0.06,"(20, 4)","(4, 24)",7,133,241,381,8,53,217,278
421,0.14,"(22, 22)","(5, 19)",10,79,60,149,3,50,193,246
422,0.2,"(19, 2)","(7, 10)",5,70,35,110,10,31,34,75
423,0.16,"(13, 29)","(4, 24)",6,79,46,131,17,38,55,110
424,0.16,"(24, 9)","(29, 23)",13,67,89,169,4,42,101,147
425,0.12,"(14, 8)","(22, 17)",3,100,145,248,15,32,49,96
426,0.02,"(6, 15)","(26, 14)",7,79,99,185,9,136,907,1052
427,0.12,"(2, 13)","(3, 8)",10,91,58,159,13,36,56,105
428,0.12,"(15, 17)","(28, 3)",8,97,162,267,9,51,458,518
429,0.1,"(29, 11)","(20, 19)",6,82,132,220,2,44,87,133
430,0.18,"(25, 22)","(2, 10)",6,82,110,198,5,45,249,299
431,0.14,"(14, 29)","(19, 8)",3,112,231,346,12,56,254,322
432,0.04,"(22, 0)","(23, 23)",8,82,127,217,6,62,148,216
433,0.18,"(3, 23)","(17, 29)",7,82,122,211,8,36,137,181
434,0.04,"(21, 9)","(20, 26)",4,73,106,183,6,32,98,136
435,0.08,"(13, 27)","(6, 7)",9,106,227,342,4,69,301,374
436,0.16,"(7, 13)","(6, 5)",5,76,102,183,6,44,111,161
437,0.02,"(13, 5)","(0, 18)",10,124,207,341,8,72,222,302
438,0.08,"(27, 21)","(19, 0)",9,67,58,134,6,34,74,114
439,0.2,"(21, 3)","(6, 28)",12,97,156,265,6,49,284,339
440,0.1,"(0, 24)","(2, 0)",3,85,51,139,11,36,190,237
441,0.18,"(9, 14)","(19, 15)",3,70,63,136,6,36,179,221
442,0.06,"(26, 1)","(21, 3)",3,67,22,92,4,32,21,57
443,0.04,"(4, 24)","(24, 24)",5,97,103,205,6,46,272,324
444,0.14,"(29, 14)","(7, 14)",9,109,90,208,4,53,260,317
445,0.16,"(14, 3)","(11, 19)",4,100,210,314,5,39,93,137
446,0.16,"(5, 27)","(27, 16)",5,76,82,163,2,47,261,310
447,0.18,"(11, 27)","(16, 3)",6,73,70,149,4,72,475,551
448,0.1,"(22, 9)","(22, 29)",8,94,144,246,10,60,267,337
449,0.18,"(3, 10)","(10, 0)",7,70,42,119,10,46,187,243
450,0.1,"(13, 9)","(6, 3)",3,88,51,142,6,52,108,166
451,0.16,"(19, 21)","(23, 2)",6,91,135,232,14,54,192,260
452,0.1,"(5, 1)","(24, 14)",6,73,123,202,3,37,88,128
453,0.06,"(7, 22)","(29, 3)",8,73,62,143,8,41,70,119
454,0.14,"(10, 5)","(5, 7)",9,61,17,87,12,33,29,74
455,0.16,"(5, 23)","(12, 3)",10,94,68,172,10,39,57,106
456,0.02,"(13, 29)","(7, 1)",7,115,171,293,21,37,95,153
457,0.18,"(26, 17)","(11, 25)",6,73,57,136,6,42,167,215
458,0.12,"(6, 14)","(23, 21)",10,109,154,273,15,44,93,152
459,0.06,"(18, 4)","(5, 18)",3,88,51,142,6,41,196,243
460,0.02,"(13, 15)","(29, 3)",8,118,273,399,4,40,157,201
461,0.18,"(9, 23)","(24, 23)",6,79,106,191,10,54,285,349
462,0.16,"(7, 13)","(11, 11)",6,67,34,107,5,36,23,64
463,0.12,"(19, 11)","(29, 16)",6,76,126,208,5,32,67,104
464,0.18,"(22, 3)","(21, 24)",6,97,268,371,7,75,647,729
465,0.2,"(18, 13)","(26, 6)",9,85,127,221,4,51,153,208
466,0.06,"(23, 27)","(27, 12)",3,97,133,233,11,33,75,119
467,0.04,"(2, 6)","(16, 7)",3,82,79,164,8,59,152,219
468,0.06,"(16, 3)","(25, 25)",3,88,134,225,6,52,156,214
469,0.16,"(28, 10)","(23, 18)",6,85,130,221,9,41,52,102
470,0.06,"(20, 9)","(18, 9)",6,21,7,34,8,31,10,49
471,0.12,"(21, 26)","(22, 2)",10,64,59,133,4,52,152,208
472,0.02,"(14, 3)","(14, 14)",6,253,517,776,5,125,634,764
473,0.12,"(25, 4)","(14, 12)",8,76,43,127,5,53,205,263
474,0.04,"(4, 12)","(20, 22)",9,73,98,180,6,53,153,212
475,0.14,"(8, 16)","(29, 21)",18,88,163,269,8,38,78,124
476,0.14,"(26, 6)","(5, 10)",15,88,110,213,8,49,348,405
477,0.12,"(18, 7)","(8, 8)",7,82,96,185,5,35,29,69
478,0.12,"(23, 2)","(15, 19)",7,106,176,289,4,41,82,127
479,0.08,"(12, 5)","(29, 18)",7,64,68,139,5,50,194,249
480,0.02,"(28, 23)","(14, 29)",29,142,413,584,11,58,149,218
481,0.06,"(27, 20)","(17, 22)",6,61,17,84,7,31,21,59
482,0.16,"(29, 18)","(24, 0)",11,76,170,257,6,36,130,172
483,0.2,"(6, 25)","(25, 9)",7,91,162,260,18,51,185,254
484,0.1,"(6, 27)","(0, 9)",5,97,55,157,4,38,129,171
485,0.18,"(29, 18)","(6, 16)",4,73,45,122,6,56,266,328
486,0.06,"(0, 20)","(18, 13)",7,88,65,160,3,34,51,88
487,0.08,"(21, 10)","(23, 24)",4,100,108,212,2,44,76,122
488,0.08,"(5, 14)","(0, 0)",15,70,154,239,17,44,234,295
489,0.1,"(2, 10)","(8, 4)",11,97,99,207,16,34,50,100
490,0.18,"(1, 2)","(0, 26)",12,73,62,147,7,38,179,224
491,0.2,"(4, 20)","(10, 26)",5,91,87,183,5,40,67,112
492,0.16,"(23, 17)","(2, 24)",4,85,182,271,5,42,208,255
493,0.12,"(3, 4)","(7, 5)",15,67,46,128,15,53,142,210
494,0.06,"(21, 2)","(21, 6)",6,64,26,96,4,46,66,116
495,0.16,"(17, 15)","(27, 29)",8,100,379,487,30,45,154,229
496,0.1,"(10, 18)","(1, 9)",6,61,27,94,10,39,59,108
497,0.16,"(1, 14)","(15, 26)",17,91,77,185,7,51,283,341
498,0.06,"(8, 11)","(23, 25)",10,109,115,234,9,44,79,132
499,0.06,"(10, 29)","(2, 17)",21,88,64,173,7,97,548,652
500,0.04,"(12, 8)","(12, 7)",5,1,5,11,8,32,23,63
501,0.02,"(17, 16)","(13, 7)",10,142,171,323,9,82,277,368
502,0.06,"(8, 2)","(18, 15)",5,115,311,431,9,35,85,129
503,0.18,"(29, 4)","(10, 2)",4,79,137,220,11,38,253,302
504,0.12,"(23, 0)","(28, 1)",6,67,36,109,27,40,83,150
505,0.16,"(17, 1)","(18, 28)",7,106,311,424,7,38,114,159
506,0.12,"(18, 16)","(7, 8)",7,76,68,151,7,36,45,88
507,0.2,"(22, 9)","(0, 14)",7,73,77,157,11,34,49,94
508,0.18,"(20, 10)","(12, 25)",3,79,61,143,22,47,172,241
509,0.14,"(4, 5)","(17, 11)",3,85,108,196,5,76,367,448
510,0.08,"(11, 2)","(22, 25)",5,112,146,263,10,55,126,191
511,0.18,"(16, 19)","(20, 2)",4,115,218,337,10,50,303,363
512,0.08,"(13, 2)","(22, 18)",3,109,201,313,4,44,167,215
513,0.18,"(24, 21)","(6, 10)",15,106,387,508,6,37,47,90
514,0.04,"(27, 10)","(10, 25)",11,133,217,361,8,77,223,308
515,0.18,"(2, 26)","(8, 13)",37,61,60,158,7,42,74,123
516,0.2,"(10, 5)","(12, 12)",6,61,32,99,13,48,180,241
517,0.16,"(25, 25)","(1, 0)",7,70,72,149,6,55,665,726
518,0.02,"(15, 6)","(13, 4)",18,118,119,255,11,31,15,57
519,0.16,"(26, 17)","(12, 27)",6,70,86,162,6,55,420,481
520,0.1,"(14, 8)","(17, 21)",7,73,81,161,9,48,125,182
521,0.1,"(10, 2)","(6, 24)",8,112,209,329,7,48,206,261
522,0.2,"(1, 15)","(20, 8)",6,103,190,299,8,59,508,575
523,0.02,"(22, 21)","(13, 18)",7,139,115,261,6,47,95,148
524,0.04,"(20, 0)","(20, 15)",8,76,85,169,9,78,229,316
525,0.04,"(27, 13)","(15, 2)",3,106,153,262,6,55,211,272
526,0.16,"(29, 2)","(18, 18)",12,85,140,237,5,59,310,374
527,0.2,"(2, 1)","(15, 1)",3,76,61,140,4,45,140,189
528,0.2,"(23, 9)","(3, 1)",10,97,215,322,11,38,104,153
529,0.04,"(4, 22)","(23, 22)",4,157,277,438,4,64,269,337
530,0.16,"(8, 1)","(29, 5)",8,103,137,248,10,36,165,211
531,0.08,"(5, 11)","(1, 10)",10,64,24,98,4,36,41,81
532,0.18,"(24, 16)","(12, 17)",9,79,50,138,8,32,33,73
533,0.14,"(24, 6)","(3, 13)",9,79,81,169,5,65,726,796
534,0.2,"(20, 22)","(0, 9)",8,73,68,149,12,38,305,355
535,0.02,"(1, 5)","(27, 10)",5,142,219,366,5,71,285,361
536,0.08,"(11, 24)","(12, 6)",4,136,227,367,4,53,134,191
537,0.04,"(3, 11)","(4, 15)",10,79,78,167,15,57,174,246
538,0.2,"(2, 27)","(27, 5)",9,82,128,219,12,48,227,287
539,0.06,"(16, 27)","(10, 14)",11,79,60,150,7,40,71,118
540,0.02,"(0, 13)","(3, 19)",5,85,54,144,5,55,133,193
541,0.04,"(17, 9)","(13, 9)",8,109,63,180,6,61,122,189
542,0.12,"(11, 4)","(18, 12)",12,82,103,197,13,57,354,424
543,0.08,"(19, 12)","(20, 19)",4,82,87,173,15,51,125,191
544,0.1,"(3, 3)","(2, 12)",7,70,26,103,36,33,61,130
545,0.12,"(7, 7)","(29, 11)",4,61,44,109,3,71,244,318
546,0.04,"(12, 5)","(5, 10)",6,88,52,146,6,33,34,73
547,0.04,"(17, 6)","(0, 17)",6,64,44,114,8,32,49,89
548,0.04,"(10, 18)","(17, 10)",4,103,203,310,6,56,267,329
549,0.08,"(12, 25)","(0, 14)",8,91,141,240,33,45,314,392
550,0.16,"(7, 20)","(14, 27)",3,70,57,130,3,45,201,249
551,0.08,"(8, 8)","(20, 0)",20,88,217,325,7,47,246,300
552,0.02,"(18, 14)","(29, 28)",3,67,59,129,3,40,127,170
553,0.08,"(7, 10)","(26, 18)",6,91,100,197,7,76,339,422
554,0.1,"(25, 16)","(10, 10)",8,151,380,539,6,33,31,70
555,0.18,"(25, 21)","(7, 7)",8,91,149,248,13,65,335,413
556,0.16,"(15, 24)","(19, 1)",5,88,195,288,5,47,203,255
557,0.14,"(12, 0)","(19, 13)",7,94,101,202,19,44,148,211
558,0.08,"(5, 12)","(12, 29)",11,70,84,165,4,47,84,135
559,0.06,"(8, 15)","(21, 21)",15,151,208,374,13,96,764,873
560,0.2,"(24, 20)","(9, 23)",6,70,47,123,12,56,645,713
561,0.18,"(24, 12)","(22, 12)",6,21,9,36,4,1,4,9
562,0.2,"(12, 29)","(20, 24)",6,82,92,180,5,36,123,164
563,0.12,"(18, 3)","(14, 8)",8,79,42,129,17,32,45,94
564,0.2,"(17, 15)","(12, 3)",9,67,78,154,14,47,211,272
565,0.2,"(17, 13)","(12, 15)",5,70,34,109,11,39,50,100
566,0.14,"(4, 23)","(22, 27)",13,97,118,228,19,53,243,315
567,0.16,"(24, 2)","(15, 8)",19,82,82,183,6,54,155,215
568,0.18,"(0, 15)","(16, 26)",6,97,347,450,5,42,381,428
569,0.02,"(5, 29)","(1, 27)",6,112,135,253,16,33,40,89
570,0.08,"(24, 28)","(15, 13)",3,100,82,185,6,52,151,209
571,0.02,"(8, 23)","(29, 24)",3,109,110,222,12,40,116,168
572,0.08,"(14, 11)","(6, 25)",4,112,102,218,4,36,127,167
573,0.04,"(16, 9)","(3, 13)",5,97,67,169,4,37,40,81
574,0.04,"(19, 10)","(13, 14)",11,166,262,439,6,31,31,68
575,0.06,"(25, 27)","(8, 1)",3,94,191,288,12,41,95,148
576,0.16,"(19, 13)","(16, 2)",5,97,188,290,10,50,369,429
577,0.16,"(7, 1)","(17, 16)",2,82,74,158,15,58,254,327
578,0.14,"(6, 9)","(3, 1)",7,76,29,112,10,38,145,193
579,0.2,"(19, 0)","(12, 11)",7,73,50,130,6,39,51,96
580,0.04,"(28, 25)","(22, 25)",9,85,40,134,4,31,12,47
581,0.12,"(8, 5)","(21, 11)",8,100,208,316,5,40,75,120
582,0.06,"(18, 17)","(0, 9)",10,76,146,232,11,32,57,100
583,0.18,"(25, 16)","(29, 22)",7,79,92,178,12,37,167,216
584,0.12,"(12, 5)","(15, 14)",4,85,67,156,7,50,323,380
585,0.04,"(15, 11)","(11, 2)",5,130,159,294,8,36,83,127
586,0.06,"(25, 0)","(18, 6)",15,70,40,125,16,54,144,214
587,0.2,"(7, 16)","(25, 10)",22,91,107,220,12,37,144,193
588,0.2,"(20, 14)","(22, 29)",5,70,100,175,7,43,231,281
589,0.02,"(22, 25)","(16, 24)",9,97,89,195,12,42,65,119
590,0.16,"(9, 20)","(20, 6)",5,97,177,279,7,59,189,255
591,0.18,"(0, 18)","(23, 12)",6,112,281,399,8,41,119,168
592,0.12,"(5, 22)","(17, 14)",7,115,114,236,12,65,156,233
593,0.2,"(4, 12)","(21, 15)",10,94,166,270,9,57,444,510
594,0.06,"(27, 24)","(12, 1)",7,169,336,512,12,49,146,207
595,0.16,"(22, 18)","(2, 27)",7,100,210,317,7,41,103,151
596,0.12,"(0, 22)","(6, 4)",6,79,49,134,6,40,61,107
597,0.02,"(0, 14)","(12, 20)",4,124,134,262,41,87,323,451
598,0.14,"(16, 18)","(29, 13)",11,73,124,208,4,35,81,120
599,0.18,"(0, 8)","(29, 12)",9,73,139,221,6,40,287,333
600,0.18,"(10, 0)","(11, 17)",16,97,103,216,7,46,175,228
601,0.14,"(9, 26)","(28, 2)",5,76,61,142,9,56,243,308
602,0.02,"(1, 7)","(24, 23)",5,112,136,253,8,77,231,316
603,0.04,"(0, 10)","(19, 27)",4,121,130,255,11,43,115,169
604,0.12,"(18, 13)","(20, 29)",9,73,77,159,7,58,465,530
605,0.06,"(22, 19)","(19, 18)",4,76,50,130,9,37,36,82
606,0.14,"(9, 10)","(13, 28)",6,82,93,181,4,40,58,102
607,0.12,"(18, 16)","(0, 9)",7,67,44,118,9,41,61,111
608,0.12,"(28, 4)","(11, 28)",4,79,131,214,7,62,413,482
609,0.2,"(16, 14)","(28, 1)",7,85,98,190,5,33,66,104
610,0.08,"(18, 7)","(21, 20)",8,76,57,141,6,79,357,442
611,0.02,"(15, 23)","(26, 21)",6,121,98,225,10,57,162,229
612,0.14,"(16, 22)","(23, 5)",9,103,107,219,4,45,282,331
613,0.16,"(2, 18)","(4, 28)",8,73,72,153,10,39,58,107
614,0.18,"(15, 1)","(15, 17)",6,88,92,186,3,36,61,100
615,0.06,"(20, 14)","(23, 18)",6,100,118,224,6,45,98,149
616,0.1,"(3, 5)","(15, 22)",4,112,185,301,3,57,140,200
617,0.02,"(25, 1)","(24, 6)",5,106,90,201,10,37,81,128
618,0.16,"(21, 12)","(27, 10)",18,67,46,131,6,40,129,175
619,0.18,"(10, 15)","(9, 14)",6,1,6,13,3,1,3,7
620,0.06,"(15, 24)","(1, 19)",8,79,98,185,4,48,449,501
621,0.14,"(16, 10)","(3, 17)",5,91,93,189,6,44,237,287
622,0.06,"(12, 8)","(18, 27)",7,100,243,350,5,61,181,247
623,0.12,"(21, 27)","(1, 10)",11,73,55,139,13,34,58,105
624,0.14,"(29, 26)","(6, 1)",2,91,77,170,5,55,160,220
625,0.18,"(22, 3)","(18, 11)",5,82,63,150,4,49,148,201
626,0.08,"(23, 22)","(9, 6)",8,103,126,237,5,52,275,332
627,0.02,"(20, 18)","(1, 29)",19,172,432,623,7,33,45,85
628,0.12,"(26, 23)","(13, 19)",9,70,36,115,33,31,50,114
629,0.18,"(28, 26)","(1, 7)",6,79,100,185,5,56,523,584
630,0.2,"(23, 4)","(29, 10)",4,91,168,263,3,47,84,134
631,0.02,"(21, 11)","(24, 24)",8,118,152,278,8,52,173,233
632,0.08,"(1, 7)","(13, 28)",24,79,101,204,11,46,156,213
633,0.08,"(24, 6)","(26, 15)",5,85,78,168,6,34,89,129
634,0.02,"(16, 26)","(28, 13)",5,97,103,205,12,80,273,365
635,0.08,"(13, 21)","(1, 12)",21,76,158,255,9,44,135,188
636,0.16,"(26, 1)","(13, 27)",8,88,182,278,5,49,308,362
637,0.02,"(24, 8)","(14, 6)",3,151,130,284,11,47,97,155
638,0.18,"(6, 9)","(2, 6)",6,67,32,105,7,31,16,54
639,0.1,"(6, 8)","(20, 15)",5,100,111,216,13,59,361,433
640,0.14,"(16, 9)","(20, 24)",8,88,180,276,17,38,154,209
641,0.1,"(3, 0)","(4, 0)",2,61,28,91,3,32,31,66
642,0.16,"(17, 11)","(6, 23)",6,85,82,173,5,33,41,79
643,0.14,"(11, 13)","(16, 3)",11,94,96,201,5,76,622,703
644,0.04,"(25, 5)","(22, 4)",7,85,54,146,5,36,35,76
645,0.06,"(13, 26)","(5, 26)",8,88,63,159,11,38,50,99
646,0.12,"(25, 25)","(16, 2)",10,82,84,176,9,51,265,325
647,0.14,"(6, 12)","(8, 21)",11,94,100,205,11,37,51,99
648,0.18,"(0, 27)","(18, 3)",8,91,112,211,9,50,232,291
649,0.02,"(17, 17)","(23, 29)",6,148,154,308,8,79,393,480
650,0.12,"(21, 22)","(12, 10)",6,82,97,185,4,60,208,272
651,0.06,"(27, 10)","(26, 3)",10,106,189,305,9,59,96,164
652,0.16,"(18, 28)","(20, 27)",5,73,34,112,10,45,96,151
653,0.14,"(28, 10)","(10, 16)",6,91,110,207,4,78,471,553
654,0.02,"(1, 24)","(12, 4)",6,79,56,141,10,97,368,475
655,0.06,"(19, 9)","(8, 2)",4,91,79,174,9,46,122,177
656,0.18,"(15, 3)","(19, 9)",11,94,175,280,7,44,146,197
657,0.02,"(17, 2)","(2, 7)",3,85,42,130,6,63,146,215
658,0.14,"(23, 17)","(20, 16)",4,61,14,79,6,36,33,75
659,0.08,"(19, 24)","(10, 2)",5,85,72,162,11,45,107,163
660,0.12,"(12, 2)","(21, 25)",5,91,129,225,7,65,239,311
661,0.06,"(24, 11)","(5, 23)",7,100,100,207,3,45,83,131
662,0.08,"(27, 10)","(27, 14)",3,88,59,150,11,55,143,209
663,0.18,"(18, 29)","(14, 16)",6,88,74,168,4,37,56,97
664,0.08,"(22, 28)","(11, 7)",7,103,134,244,8,73,593,674
665,0.02,"(5, 24)","(17, 28)",4,67,50,121,4,83,316,403
666,0.18,"(24, 12)","(3, 3)",6,67,74,147,5,42,90,137
667,0.02,"(6, 21)","(0, 1)",15,82,52,149,8,33,32,73
668,0.16,"(17, 27)","(29, 18)",7,88,163,258,11,51,255,317
669,0.02,"(4, 2)","(4, 7)",3,76,27,106,5,38,43,86
670,0.1,"(19, 27)","(18, 16)",7,79,84,170,5,37,41,83
671,0.04,"(8, 25)","(22, 14)",7,91,94,192,23,51,205,279
672,0.08,"(16, 13)","(1, 26)",14,79,68,161,10,62,268,340
673,0.06,"(29, 7)","(7, 19)",7,133,209,349,5,41,175,221
674,0.2,"(2, 24)","(11, 19)",13,76,90,179,5,51,134,190
675,0.12,"(7, 10)","(10, 10)",11,61,14,86,8,34,45,87
676,0.02,"(7, 18)","(25, 20)",11,199,306,516,8,53,243,304
677,0.02,"(0, 10)","(29, 5)",3,100,85,188,5,69,210,284
678,0.02,"(20, 2)","(2, 24)",3,103,122,228,4,112,647,763
679,0.06,"(5, 0)","(17, 20)",14,85,169,268,17,62,227,306
680,0.02,"(0, 28)","(2, 2)",2,94,132,228,6,47,305,358
681,0.2,"(1, 9)","(27, 11)",9,91,153,253,8,49,399,456
682,0.1,"(9, 24)","(6, 1)",13,85,84,182,3,47,72,122
683,0.04,"(6, 19)","(11, 29)",5,103,224,332,7,59,145,211
684,0.18,"(4, 1)","(14, 5)",7,100,79,186,6,36,62,104
685,0.02,"(15, 21)","(6, 6)",22,169,247,438,12,61,142,215
686,0.16,"(18, 8)","(21, 13)",7,61,31,99,9,61,317,387
687,0.06,"(18, 9)","(17, 18)",6,106,217,329,14,47,95,156
688,0.02,"(0, 20)","(27, 10)",11,112,128,251,14,41,116,171
689,0.1,"(19, 27)","(26, 10)",4,133,241,378,6,43,105,154
690,0.14,"(15, 3)","(26, 19)",6,79,83,168,4,36,120,160
691,0.08,"(6, 1)","(2, 29)",5,67,55,127,6,33,61,100
692,0.2,"(21, 28)","(26, 3)",11,88,102,201,7,56,304,367
693,0.14,"(9, 10)","(2, 1)",12,82,124,218,5,33,26,64
694,0.08,"(24, 1)","(18, 15)",5,94,133,232,4,33,53,90
695,0.1,"(24, 16)","(28, 22)",12,85,126,223,7,39,61,107
696,0.14,"(23, 27)","(16, 13)",10,67,59,136,8,54,237,299
697,0.14,"(1, 3)","(0, 3)",5,64,11,80,4,11,5,20
698,0.12,"(9, 5)","(24, 20)",5,100,116,221,5,49,100,154
699,0.1,"(4, 13)","(1, 26)",12,100,198,310,21,41,94,156
700,0.12,"(1, 7)","(9, 29)",11,82,70,163,8,36,68,112
701,0.02,"(14, 12)","(14, 21)",5,67,47,119,7,89,370,466
702,0.12,"(23, 26)","(8, 15)",5,73,101,179,7,47,221,275
703,0.08,"(16, 7)","(19, 2)",11,85,75,171,9,45,135,189
704,0.2,"(28, 1)","(17, 7)",3,64,28,95,10,39,48,97
705,0.16,"(23, 11)","(14, 21)",15,67,56,138,7,54,177,238
706,0.18,"(25, 23)","(20, 18)",5,61,34,100,7,34,42,83
707,0.04,"(1, 11)","(2, 11)",5,21,6,32,5,34,18,57
708,0.1,"(23, 0)","(28, 2)",8,76,33,117,6,51,116,173
709,0.2,"(10, 5)","(16, 7)",3,79,59,141,8,45,87,140
710,0.02,"(15, 28)","(23, 16)",4,112,98,214,16,48,126,190
711,0.2,"(0, 5)","(0, 23)",3,64,29,96,5,37,68,110
712,0.04,"(11, 22)","(12, 26)",10,76,37,123,10,38,41,89
713,0.18,"(17, 16)","(11, 7)",6,76,73,155,8,52,210,270
714,0.18,"(6, 26)","(5, 0)",7,94,294,395,7,52,389,448
715,0.06,"(26, 10)","(17, 12)",3,85,114,202,5,73,239,317
716,0.14,"(9, 27)","(0, 14)",5,64,24,93,12,74,325,411
717,0.1,"(24, 20)","(29, 18)",5,70,73,148,10,43,75,128
718,0.12,"(22, 8)","(26, 26)",20,67,81,168,17,56,244,317
719,0.18,"(5, 3)","(3, 18)",7,70,32,109,5,52,167,224
720,0.08,"(7, 29)","(14, 15)",14,91,154,259,4,42,68,114
721,0.02,"(6, 27)","(6, 8)",18,82,107,207,6,52,103,161
722,0.14,"(17, 21)","(0, 5)",11,94,174,279,6,48,261,315
723,0.2,"(4, 1)","(23, 4)",12,106,178,296,7,55,455,517
724,0.2,"(8, 6)","(0, 5)",12,21,20,53,3,31,31,65
725,0.12,"(24, 1)","(24, 15)",5,94,115,214,10,41,73,124
726,0.02,"(15, 20)","(15, 14)",5,67,15,87,3,153,696,852
727,0.2,"(26, 9)","(22, 18)",11,88,112,211,3,41,61,105
728,0.14,"(4, 22)","(21, 5)",24,112,307,443,10,67,336,413
729,0.2,"(21, 11)","(17, 3)",12,64,46,122,10,56,210,276
730,0.08,"(19, 13)","(10, 29)",8,82,81,171,15,50,118,183
731,0.02,"(25, 18)","(24, 7)",6,196,310,512,4,49,242,295
732,0.16,"(14, 25)","(10, 12)",24,88,97,209,10,41,109,160
733,0.06,"(12, 17)","(0, 23)",6,64,34,104,6,42,109,157
734,0.08,"(8, 0)","(21, 4)",7,82,71,160,4,37,62,103
735,0.2,"(1, 9)","(24, 21)",7,91,233,331,4,45,131,180
736,0.14,"(24, 8)","(0, 18)",6,79,99,184,18,58,343,419
737,0.18,"(7, 4)","(29, 6)",20,64,64,148,8,38,55,101
738,0.18,"(17, 19)","(24, 1)",6,85,141,232,16,41,78,135
739,0.02,"(8, 20)","(21, 8)",3,175,214,392,3,119,483,605
740,0.06,"(23, 3)","(15, 28)",9,88,139,236,20,34,64,118
741,0.16,"(10, 27)","(9, 13)",10,106,203,319,5,62,365,432
742,0.02,"(17, 25)","(27, 1)",5,76,59,140,10,36,63,109
743,0.18,"(0, 16)","(29, 20)",5,91,221,317,7,49,400,456
744,0.02,"(21, 0)","(22, 27)",5,76,76,157,13,91,358,462
745,0.04,"(20, 24)","(21, 3)",12,112,136,260,6,79,272,357
746,0.02,"(4, 4)","(17, 25)",11,175,237,423,10,94,369,473
747,0.14,"(9, 1)","(18, 7)",5,109,287,401,4,43,85,132
748,0.18,"(9, 20)","(29, 4)",9,79,94,182,7,62,459,528
749,0.1,"(13, 21)","(3, 23)",15,94,88,197,14,33,35,82
750,0.08,"(1, 14)","(19, 10)",8,109,154,271,6,50,183,239
751,0.1,"(17, 2)","(22, 27)",7,97,145,249,6,75,772,853
752,0.18,"(2, 0)","(16, 18)",5,94,141,240,6,42,244,292
753,0.12,"(29, 19)","(12, 15)",3,79,76,158,7,44,120,171
754,0.06,"(14, 24)","(12, 10)",4,85,57,146,6,48,133,187
755,0.2,"(5, 9)","(27, 2)",9,88,127,224,9,42,90,141
756,0.2,"(15, 26)","(6, 0)",5,67,80,152,7,42,86,135
757,0.16,"(1, 24)","(1, 3)",6,94,81,181,4,37,58,99
758,0.18,"(5, 24)","(8, 21)",6,64,42,112,6,33,30,69
759,0.2,"(22, 26)","(6, 2)",8,79,93,180,15,35,88,138
760,0.1,"(4, 7)","(27, 27)",11,88,73,172,6,56,257,319
761,0.2,"(24, 0)","(29, 6)",7,70,52,129,5,41,108,154
762,0.04,"(8, 23)","(14, 18)",5,169,338,512,8,43,88,139
763,0.2,"(23, 3)","(10, 15)",12,88,91,191,18,69,699,786
764,0.18,"(21, 7)","(10, 12)",6,64,28,98,8,32,27,67
765,0.12,"(19, 6)","(8, 2)",4,61,24,89,9,31,31,71
766,0.08,"(25, 10)","(0, 22)",10,79,125,214,5,77,321,403
767,0.2,"(19, 2)","(19, 10)",10,70,85,165,5,37,85,127
768,0.04,"(27, 17)","(22, 7)",6,97,93,196,11,76,350,437
769,0.04,"(1, 29)","(25, 11)",9,79,111,199,14,94,481,589
770,0.02,"(27, 4)","(0, 6)",7,100,101,208,6,61,234,301
771,0.2,"(12, 4)","(12, 19)",6,64,25,95,5,32,24,61
772,0.14,"(6, 3)","(20, 20)",9,88,125,222,15,53,342,410
773,0.1,"(15, 26)","(27, 19)",9,88,122,219,15,41,98,154
774,0.06,"(24, 2)","(11, 6)",12,124,175,311,16,42,69,127
775,0.2,"(20, 27)","(8, 26)",10,67,31,108,9,31,27,67
776,0.12,"(2, 3)","(2, 13)",8,88,47,143,11,43,100,154
777,0.16,"(20, 25)","(11, 22)",4,70,35,109,18,34,44,96
778,0.04,"(29, 26)","(2, 1)",6,70,60,136,6,62,206,274
779,0.1,"(13, 3)","(15, 14)",7,73,89,169,6,34,45,85
780,0.14,"(29, 8)","(15, 17)",7,76,66,149,6,38,47,91
781,0.16,"(15, 6)","(22, 23)",13,76,105,194,8,51,260,319
782,0.04,"(13, 21)","(13, 17)",24,70,37,131,7,49,87,143
783,0.06,"(20, 24)","(22, 10)",4,79,70,153,12,48,272,332
784,0.16,"(25, 26)","(18, 12)",6,61,34,101,18,32,48,98
785,0.18,"(15, 24)","(17, 25)",7,64,15,86,7,33,24,64
786,0.2,"(21, 21)","(12, 19)",21,79,96,196,7,35,33,75
787,0.04,"(18, 27)","(11, 12)",6,76,66,148,5,52,104,161
788,0.06,"(0, 17)","(4, 12)",7,61,26,94,4,41,52,97
789,0.02,"(18, 5)","(18, 6)",10,163,284,457,5,33,10,48
790,0.08,"(24, 11)","(25, 9)",7,21,9,37,5,60,175,240
791,0.14,"(29, 0)","(26, 20)",4,64,68,136,3,42,141,186
792,0.16,"(20, 17)","(11, 2)",9,79,81,169,5,62,334,401
793,0.06,"(14, 24)","(8, 7)",4,127,201,332,6,62,241,309
794,0.02,"(24, 11)","(3, 10)",10,115,219,344,9,54,143,206
795,0.06,"(9, 11)","(22, 11)",5,97,114,216,5,51,120,176
796,0.2,"(25, 11)","(27, 25)",5,73,58,136,7,52,498,557
797,0.04,"(4, 1)","(28, 17)",4,91,142,237,3,47,124,174
798,0.02,"(13, 1)","(21, 21)",21,103,167,291,9,70,291,370
799,0.04,"(11, 8)","(10, 17)",6,118,90,214,10,53,150,213
800,0.06,"(8, 22)","(28, 19)",4,115,201,320,4,77,344,425
801,0.04,"(7, 3)","(27, 19)",8,73,72,153,4,38,76,118
802,0.06,"(27, 13)","(24, 21)",12,112,119,243,19,42,86,147
803,0.16,"(0, 10)","(29, 17)",3,94,176,273,2,51,179,232
804,0.12,"(18, 13)","(6, 11)",10,61,27,98,7,48,193,248
805,0.16,"(26, 0)","(10, 7)",5,94,96,195,5,74,432,511
806,0.2,"(18, 7)","(23, 15)",11,73,67,151,11,47,107,165
807,0.06,"(1, 26)","(24, 10)",8,163,230,401,6,73,434,513
808,0.2,"(19, 23)","(9, 11)",16,85,86,187,9,46,199,254
809,0.08,"(27, 12)","(11, 17)",5,121,156,282,6,41,83,130
810,0.12,"(10, 21)","(12, 8)",6,73,57,136,6,55,177,238
811,0.06,"(24, 27)","(17, 9)",3,88,62,153,4,54,204,262
812,0.04,"(12, 11)","(18, 17)",16,73,75,164,6,44,160,210
813,0.06,"(10, 21)","(9, 6)",6,103,205,314,2,48,135,185
814,0.1,"(0, 10)","(19, 8)",7,109,193,309,6,74,660,740
815,0.14,"(13, 28)","(12, 27)",9,61,12,82,4,36,28,68
816,0.14,"(4, 28)","(19, 6)",5,130,302,437,2,47,214,263
817,0.14,"(17, 20)","(24, 6)",8,85,80,173,7,55,376,438
818,0.1,"(7, 9)","(0, 2)",6,61,22,89,9,36,103,148
819,0.14,"(28, 21)","(17, 11)",3,94,97,194,5,46,115,166
820,0.06,"(21, 16)","(5, 1)",7,115,101,223,4,37,62,103
821,0.08,"(7, 26)","(25, 17)",11,85,84,180,3,50,95,148
822,0.16,"(18, 14)","(16, 4)",7,70,101,178,4,38,144,186
823,0.14,"(0, 17)","(6, 2)",5,73,41,119,5,31,35,71
824,0.08,"(9, 16)","(7, 20)",4,76,33,113,5,36,32,73
825,0.08,"(11, 8)","(27, 17)",5,94,148,247,8,54,160,222
826,0.1,"(15, 25)","(3, 12)",4,73,41,118,4,37,60,101
827,0.18,"(10, 0)","(28, 10)",5,67,91,163,2,42,248,292
828,0.12,"(10, 9)","(10, 6)",4,64,19,87,3,40,35,78
829,0.08,"(0, 23)","(4, 14)",13,64,42,119,13,52,102,167
830,0.18,"(7, 17)","(12, 29)",17,94,153,264,8,50,150,208
831,0.14,"(25, 22)","(21, 15)",7,73,43,123,13,33,88,134
832,0.18,"(9, 26)","(12, 18)",8,94,94,196,16,39,72,127
833,0.12,"(15, 13)","(25, 10)",8,94,169,271,4,48,274,326
834,0.14,"(28, 18)","(2, 20)",5,67,42,114,5,63,373,441
835,0.08,"(17, 19)","(21, 4)",5,88,222,315,3,59,174,236
836,0.1,"(15, 14)","(23, 14)",4,76,51,131,10,71,589,670
837,0.18,"(18, 15)","(6, 26)",10,70,46,126,4,70,877,951
838,0.12,"(27, 20)","(7, 22)",8,91,129,228,12,35,91,138
839,0.04,"(29, 28)","(28, 15)",3,118,150,271,3,41,52,96
840,0.04,"(16, 5)","(7, 28)",4,88,71,163,4,55,307,366
841,0.08,"(23, 27)","(4, 14)",15,76,107,198,14,42,88,144
842,0.18,"(17, 9)","(10, 12)",8,70,37,115,11,11,19,41
843,0.16,"(9, 29)","(29, 19)",5,67,79,151,9,36,62,107
844,0.02,"(2, 13)","(14, 10)",8,133,153,294,10,59,123,192
845,0.14,"(8, 11)","(12, 18)",23,88,239,350,4,38,54,96
846,0.16,"(0, 21)","(25, 18)",6,112,148,266,3,33,45,81
847,0.06,"(26, 28)","(23, 27)",8,76,55,139,10,34,45,89
848,0.08,"(25, 18)","(22, 4)",11,67,72,150,8,52,184,244
849,0.1,"(26, 9)","(22, 18)",5,76,80,161,6,45,156,207
850,0.1,"(12, 10)","(10, 1)",8,73,46,127,10,36,76,122
851,0.04,"(20, 3)","(1, 7)",6,94,103,203,3,33,37,73
852,0.18,"(9, 23)","(12, 28)",13,97,91,201,10,76,392,478
853,0.04,"(16, 10)","(10, 11)",6,103,89,198,6,53,152,211
854,0.04,"(25, 17)","(5, 27)",8,106,97,211,22,47,134,203
855,0.12,"(13, 7)","(6, 19)",5,103,238,346,11,54,542,607
856,0.06,"(26, 22)","(10, 3)",22,67,80,169,23,49,188,260
857,0.02,"(17, 12)","(19, 12)",6,79,35,120,9,48,60,117
858,0.06,"(22, 25)","(3, 22)",5,100,65,170,3,44,115,162
859,0.06,"(2, 1)","(13, 9)",6,73,48,127,7,63,204,274
860,0.18,"(10, 6)","(13, 0)",18,70,84,172,13,35,103,151
861,0.08,"(22, 3)","(11, 13)",16,94,110,220,8,56,143,207
862,0.16,"(8, 3)","(7, 16)",14,70,59,143,4,46,73,123
863,0.2,"(0, 17)","(24, 8)",5,88,188,281,4,66,482,552
864,0.14,"(22, 13)","(23, 28)",15,97,279,391,11,42,243,296
865,0.1,"(11, 16)","(21, 23)",7,118,230,355,8,35,73,116
866,0.1,"(6, 27)","(20, 29)",15,73,56,144,7,39,97,143
867,0.18,"(22, 2)","(10, 17)",9,97,116,222,13,75,1089,1177
868,0.04,"(0, 10)","(15, 9)",9,109,126,244,4,51,135,190
869,0.2,"(3, 22)","(8, 8)",16,76,50,142,14,39,144,197
870,0.06,"(23, 21)","(20, 21)",10,76,41,127,6,31,29,66
871,0.02,"(24, 2)","(22, 26)",7,163,277,447,10,96,481,587
872,0.14,"(25, 24)","(1, 24)",6,85,122,213,11,49,171,231
873,0.18,"(8, 24)","(4, 23)",3,61,12,76,12,11,17,40
874,0.14,"(8, 11)","(28, 1)",7,100,232,339,10,66,226,302
875,0.08,"(20, 22)","(21, 8)",12,97,98,207,6,37,63,106
876,0.16,"(14, 7)","(17, 29)",10,130,286,426,15,51,337,403
877,0.1,"(13, 14)","(0, 0)",4,88,192,284,5,31,63,99
878,0.06,"(1, 15)","(1, 26)",4,82,55,141,7,32,48,87
879,0.18,"(13, 16)","(24, 10)",8,97,121,226,7,46,182,235
880,0.12,"(11, 14)","(5, 15)",4,73,27,104,6,36,33,75
881,0.08,"(11, 7)","(28, 3)",6,79,83,168,3,50,158,211
882,0.12,"(5, 1)","(24, 24)",8,109,123,240,5,36,176,217
883,0.08,"(26, 1)","(23, 3)",7,88,79,174,8,47,100,155
884,0.06,"(19, 23)","(3, 18)",12,91,60,163,9,58,425,492
885,0.18,"(19, 27)","(20, 25)",6,67,58,131,7,36,77,120
886,0.18,"(1, 23)","(29, 22)",9,73,129,211,5,41,181,227
887,0.18,"(24, 10)","(12, 20)",10,85,141,236,16,37,104,157
888,0.06,"(11, 5)","(1, 12)",7,79,46,132,10,46,106,162
889,0.18,"(18, 6)","(8, 8)",6,73,36,115,9,34,32,75
890,0.06,"(4, 18)","(0, 12)",14,61,41,116,6,34,19,59
891,0.12,"(29, 2)","(9, 11)",5,97,228,330,10,50,195,255
892,0.02,"(29, 3)","(20, 9)",5,115,139,259,8,78,214,300
893,0.14,"(2, 28)","(17, 25)",11,64,57,132,13,38,60,111
894,0.2,"(28, 21)","(25, 5)",5,76,60,141,5,66,591,662
895,0.14,"(29, 22)","(0, 9)",9,91,114,214,5,62,147,214
896,0.16,"(9, 7)","(9, 23)",9,70,94,173,22,40,180,242
897,0.1,"(18, 0)","(28, 29)",5,67,92,164,5,35,100,140
898,0.06,"(5, 11)","(15, 2)",13,73,104,190,6,32,41,79
899,0.08,"(23, 10)","(8, 4)",11,73,52,136,12,44,214,270
900,0.04,"(29, 4)","(24, 14)",11,103,111,225,8,88,294,390
901,0.04,"(6, 23)","(10, 29)",10,106,102,218,7,47,76,130
902,0.1,"(18, 2)","(27, 5)",6,67,64,137,8,49,109,166
903,0.08,"(18, 18)","(18, 26)",7,109,255,371,8,38,48,94
904,0.02,"(26, 13)","(24, 8)",13,124,109,246,7,88,260,355
905,0.04,"(1, 1)","(26, 6)",5,97,267,369,10,45,141,196
906,0.06,"(3, 21)","(7, 6)",9,76,60,145,5,52,93,150
907,0.1,"(24, 18)","(3, 3)",15,121,170,306,5,41,91,137
908,0.04,"(22, 14)","(23, 10)",10,94,89,193,7,57,269,333
909,0.06,"(23, 25)","(10, 21)",8,76,53,137,8,35,56,99
910,0.18,"(1, 15)","(28, 5)",6,82,79,167,6,38,75,119
911,0.06,"(18, 23)","(11, 23)",13,94,62,169,19,41,57,117
912,0.16,"(16, 23)","(15, 17)",6,67,32,105,12,33,39,84
913,0.02,"(11, 15)","(17, 18)",6,118,138,262,7,50,137,194
914,0.06,"(3, 4)","(10, 2)",11,76,72,159,4,36,37,77
915,0.2,"(15, 19)","(25, 4)",6,88,147,241,5,46,456,507
916,0.18,"(3, 14)","(29, 21)",3,76,87,166,3,37,125,165
917,0.2,"(20, 8)","(17, 24)",7,76,57,140,6,48,156,210
918,0.08,"(13, 2)","(6, 8)",29,70,67,166,9,46,162,217
919,0.04,"(19, 3)","(5, 19)",6,79,77,162,6,38,67,111
920,0.02,"(0, 20)","(27, 13)",5,79,80,164,3,57,158,218
921,0.1,"(19, 18)","(10, 14)",5,67,29,101,8,35,55,98
922,0.2,"(0, 10)","(10, 16)",5,64,36,105,8,39,66,113
923,0.02,"(27, 15)","(15, 6)",7,103,88,198,9,33,43,85
924,0.2,"(12, 5)","(14, 14)",6,82,84,172,6,32,25,63
925,0.02,"(1, 29)","(24, 6)",10,109,101,220,3,58,141,202
926,0.12,"(22, 22)","(7, 22)",18,97,104,219,3,53,148,204
927,0.16,"(21, 4)","(29, 1)",11,67,50,128,7,33,53,93
928,0.16,"(16, 13)","(23, 27)",6,82,71,159,6,49,324,379
929,0.16,"(22, 8)","(14, 28)",7,97,183,287,10,41,207,258
930,0.18,"(5, 5)","(19, 6)",10,82,87,179,5,51,133,189
931,0.2,"(5, 13)","(24, 6)",4,100,163,267,7,35,191,233
932,0.14,"(18, 23)","(21, 17)",8,85,77,170,17,37,93,147
933,0.02,"(17, 25)","(4, 6)",8,154,166,328,18,102,353,473
934,0.02,"(29, 19)","(22, 12)",19,184,407,610,8,37,67,112
935,0.06,"(17, 1)","(9, 6)",7,76,64,147,3,43,77,123
936,0.14,"(11, 0)","(22, 12)",6,94,104,204,6,39,66,111
937,0.04,"(0, 13)","(1, 8)",26,112,126,264,6,54,129,189
938,0.14,"(12, 18)","(25, 29)",14,91,194,299,3,39,76,118
939,0.14,"(11, 26)","(3, 19)",8,73,37,118,9,43,65,117
940,0.12,"(20, 21)","(19, 24)",14,61,27,102,9,34,58,101
941,0.02,"(24, 29)","(5, 5)",11,115,373,499,27,76,305,408
942,0.18,"(11, 10)","(9, 6)",9,61,27,97,6,43,68,117
943,0.02,"(9, 6)","(0, 10)",7,73,113,193,11,44,132,187
944,0.16,"(8, 27)","(11, 8)",14,76,62,152,4,64,760,828
945,0.06,"(28, 13)","(15, 13)",10,41,26,77,5,32,26,63
946,0.18,"(20, 27)","(4, 9)",12,85,77,174,16,44,154,214
947,0.06,"(2, 14)","(20, 7)",2,76,102,180,2,52,199,253
948,0.08,"(18, 7)","(22, 15)",4,67,44,115,8,50,294,352
949,0.18,"(5, 29)","(18, 15)",5,76,64,145,7,45,109,161
950,0.14,"(10, 22)","(13, 7)",6,73,107,186,5,31,22,58
951,0.18,"(11, 12)","(27, 21)",5,97,131,233,6,63,960,1029
952,0.1,"(17, 1)","(2, 27)",4,103,115,222,7,48,357,412
953,0.16,"(13, 21)","(20, 20)",11,97,142,250,8,45,118,171
954,0.1,"(28, 4)","(13, 25)",2,79,93,174,2,50,125,177
955,0.02,"(26, 7)","(12, 2)",10,94,76,180,3,42,77,122
956,0.14,"(22, 7)","(12, 14)",5,112,279,396,2,32,40,74
957,0.12,"(27, 20)","(10, 25)",10,97,184,291,14,49,107,170
958,0.02,"(22, 7)","(11, 27)",6,103,105,214,5,76,199,280
959,0.14,"(9, 27)","(22, 27)",8,73,77,158,7,38,161,206
960,0.2,"(0, 2)","(12, 17)",4,109,277,390,3,69,861,933
961,0.18,"(9, 22)","(25, 29)",5,79,85,169,8,44,129,181
962,0.14,"(14, 16)","(28, 26)",4,82,118,204,8,47,174,229
963,0.06,"(16, 8)","(4, 1)",15,73,66,154,6,68,344,418
964,0.12,"(28, 11)","(28, 6)",7,64,41,112,6,37,49,92
965,0.2,"(25, 23)","(18, 25)",5,67,22,94,19,37,48,104
966,0.08,"(5, 11)","(20, 1)",8,85,119,212,5,39,273,317
967,0.08,"(1, 15)","(15, 24)",9,88,123,220,6,61,374,441
968,0.12,"(24, 24)","(26, 12)",17,82,124,223,18,52,205,275
969,0.04,"(17, 9)","(28, 0)",4,67,83,154,5,34,104,143
970,0.06,"(3, 10)","(1, 18)",10,67,29,106,9,33,39,81
971,0.06,"(5, 7)","(23, 19)",16,64,66,146,5,72,258,335
972,0.16,"(9, 24)","(10, 25)",4,1,4,9,6,1,6,13
973,0.1,"(27, 10)","(1, 24)",6,76,56,138,6,59,123,188
974,0.06,"(8, 24)","(16, 9)",12,79,133,224,14,64,214,292
975,0.04,"(28, 18)","(23, 2)",4,100,124,228,11,31,54,96
976,0.16,"(29, 2)","(25, 11)",9,73,62,144,2,36,56,94
977,0.06,"(15, 21)","(29, 20)",7,94,111,212,17,75,505,597
978,0.18,"(20, 3)","(15, 9)",3,67,38,108,4,46,66,116
979,0.04,"(29, 13)","(7, 18)",24,106,156,286,6,62,164,232
980,0.2,"(13, 1)","(5, 12)",8,64,37,109,12,33,52,97
981,0.06,"(28, 4)","(1, 3)",4,79,150,233,6,72,334,412
982,0.14,"(4, 25)","(16, 18)",21,97,98,216,10,39,69,118
983,0.1,"(22, 5)","(3, 19)",7,106,229,342,9,55,190,254
984,0.1,"(6, 29)","(20, 19)",8,88,72,168,31,48,116,195
985,0.1,"(28, 0)","(28, 7)",7,61,31,99,8,35,40,83
986,0.1,"(26, 29)","(19, 15)",6,70,65,141,7,33,50,90
987,0.02,"(29, 10)","(1, 10)",8,115,135,258,4,43,76,123
988,0.08,"(18, 27)","(17, 11)",11,91,91,193,2,42,62,106
989,0.02,"(24, 29)","(14, 10)",11,166,313,490,12,104,325,441
990,0.1,"(7, 17)","(3, 19)",26,67,53,146,7,48,80,135
991,0.12,"(21, 4)","(27, 29)",3,82,109,194,4,42,112,158
992,0.2,"(27, 29)","(6, 25)",3,97,196,296,18,46,131,195
993,0.08,"(28, 17)","(9, 5)",11,100,100,211,10,67,396,473
994,0.14,"(0, 15)","(1, 4)",3,85,54,142,7,35,81,123
995,0.16,"(22, 24)","(0, 3)",11,64,62,137,7,35,60,102
996,0.2,"(25, 5)","(18, 6)",38,64,47,149,27,47,141,215
997,0.08,"(18, 3)","(24, 2)",10,76,75,161,7,46,95,148
998,0.14,"(3, 8)","(5, 26)",5,76,43,124,6,45,114,165
999,0.18,"(0, 18)","(0, 24)",15,73,46,134,9,33,61,103
,,,,8.21,87.347,109.1,204.657,8.22,48.514,184.94,241.674
