0,0.02,"(7, 14)","(24, 27)",30,115,189,334,7,138,140,285
1,0.14,"(26, 19)","(29, 15)",30,91,138,259,10,77,82,169
2,0.18,"(13, 4)","(23, 7)",52,94,125,271,25,45,65,135
3,0.06,"(27, 10)","(8, 7)",12,94,116,222,10,130,135,275
4,0.04,"(25, 13)","(17, 5)",5,109,60,174,5,85,85,175
5,0.12,"(18, 1)","(5, 2)",4,67,39,110,5,94,94,193
6,0.08,"(2, 12)","(9, 15)",6,67,54,127,4,38,37,79
7,0.04,"(16, 2)","(0, 4)",10,76,136,222,13,56,64,133
8,0.08,"(8, 21)","(21, 16)",4,106,160,270,4,49,48,101
9,0.06,"(8, 0)","(3, 10)",10,67,27,104,20,22,37,79
10,0.12,"(16, 11)","(9, 4)",8,61,27,96,13,51,59,123
11,0.12,"(29, 17)","(8, 14)",7,94,77,178,5,102,102,209
12,0.16,"(4, 7)","(25, 17)",5,109,104,218,10,115,120,245
13,0.16,"(11, 0)","(10, 0)",6,31,7,44,5,66,66,137
14,0.2,"(16, 2)","(2, 11)",12,103,216,331,14,74,83,171
15,0.08,"(5, 16)","(13, 23)",5,76,66,147,5,44,44,93
16,0.08,"(29, 5)","(9, 4)",7,70,65,142,17,115,127,259
17,0.18,"(24, 6)","(18, 3)",5,91,105,201,4,25,24,53
18,0.14,"(4, 27)","(17, 18)",10,70,70,150,11,60,66,137
19,0.18,"(29, 13)","(3, 22)",7,118,238,363,17,119,131,267
20,0.06,"(22, 10)","(10, 26)",5,103,155,263,4,81,80,165
21,0.08,"(3, 22)","(2, 9)",8,91,56,155,9,51,55,115
22,0.12,"(12, 16)","(3, 7)",12,109,198,319,6,65,66,137
23,0.02,"(0, 17)","(10, 15)",5,91,70,166,4,122,121,247
24,0.14,"(5, 25)","(15, 27)",5,79,79,163,14,90,99,203
25,0.12,"(11, 26)","(25, 27)",9,79,99,187,5,115,115,235
26,0.04,"(14, 10)","(4, 6)",24,85,145,254,15,142,152,309
27,0.04,"(27, 0)","(16, 14)",10,154,224,388,4,80,79,163
28,0.08,"(2, 10)","(11, 4)",4,85,118,207,4,59,58,121
29,0.18,"(26, 6)","(12, 29)",21,94,223,338,9,87,91,187
30,0.14,"(10, 4)","(3, 21)",12,97,108,217,5,71,71,147
31,0.1,"(17, 16)","(16, 29)",11,79,76,166,8,63,66,137
32,0.06,"(9, 4)","(7, 22)",5,70,38,113,6,118,119,243
33,0.2,"(15, 19)","(7, 27)",9,94,272,375,5,89,89,183
34,0.2,"(6, 19)","(24, 24)",7,112,287,406,6,89,90,185
35,0.1,"(4, 29)","(25, 14)",9,103,139,251,5,72,72,149
36,0.16,"(3, 12)","(23, 10)",8,94,156,258,13,105,113,231
37,0.04,"(13, 23)","(15, 0)",8,88,65,161,5,271,271,547
38,0.04,"(13, 11)","(11, 6)",26,82,60,168,7,54,56,117
39,0.12,"(23, 18)","(22, 9)",14,76,67,157,6,77,78,161
40,0.12,"(29, 7)","(12, 19)",13,103,124,240,4,58,57,119
41,0.1,"(4, 20)","(7, 16)",8,73,50,131,10,29,34,73
42,0.1,"(5, 2)","(29, 3)",9,73,163,245,3,49,47,99
43,0.08,"(14, 11)","(8, 27)",8,79,57,144,11,89,95,195
44,0.12,"(12, 27)","(2, 29)",14,79,171,264,9,69,73,151
45,0.2,"(12, 8)","(14, 26)",4,118,414,536,4,212,211,427
46,0.08,"(7, 1)","(25, 26)",4,82,64,150,11,108,114,233
47,0.18,"(4, 10)","(12, 29)",7,79,82,168,17,66,78,161
48,0.16,"(5, 10)","(20, 1)",4,73,52,129,5,291,291,587
49,0.16,"(5, 0)","(26, 20)",6,85,213,304,7,81,83,171
50,0.04,"(11, 9)","(6, 15)",5,70,27,102,4,83,82,169
51,0.04,"(8, 15)","(0, 13)",7,61,20,88,16,99,110,225
52,0.02,"(12, 9)","(23, 7)",7,136,167,310,7,51,53,111
53,0.06,"(16, 1)","(0, 29)",6,61,47,114,7,66,68,141
54,0.06,"(19, 27)","(1, 28)",10,73,48,131,8,148,151,307
55,0.02,"(4, 18)","(29, 3)",14,91,74,179,7,48,50,105
56,0.14,"(21, 1)","(10, 1)",5,76,42,123,6,71,72,149
57,0.14,"(24, 13)","(8, 17)",9,67,62,138,9,166,170,345
58,0.2,"(17, 11)","(19, 6)",9,100,146,255,9,27,31,67
59,0.06,"(2, 20)","(24, 19)",32,139,420,591,15,115,125,255
60,0.1,"(22, 3)","(26, 28)",6,73,101,180,17,94,106,217
61,0.1,"(3, 1)","(12, 19)",6,100,125,231,5,71,71,147
62,0.16,"(13, 11)","(15, 25)",7,76,61,144,60,89,144,293
63,0.14,"(4, 19)","(12, 5)",9,118,173,300,9,59,63,131
64,0.18,"(8, 17)","(19, 1)",4,85,133,222,7,113,115,235
65,0.12,"(13, 6)","(16, 29)",4,109,337,450,5,136,136,277
66,0.14,"(11, 10)","(26, 29)",4,76,116,196,10,83,88,181
67,0.08,"(10, 25)","(13, 24)",4,76,35,115,5,44,44,93
68,0.1,"(27, 26)","(6, 0)",5,70,85,160,5,112,112,229
69,0.18,"(16, 25)","(20, 4)",8,76,84,168,9,117,121,247
70,0.14,"(0, 0)","(19, 17)",11,100,153,264,4,97,96,197
71,0.06,"(21, 17)","(2, 13)",5,79,46,130,6,88,89,183
72,0.18,"(5, 1)","(14, 2)",5,88,138,231,3,63,61,127
73,0.08,"(10, 2)","(24, 3)",14,85,86,185,23,121,139,283
74,0.1,"(9, 28)","(18, 26)",11,103,77,191,5,67,67,139
75,0.02,"(9, 28)","(4, 19)",11,109,71,191,11,106,112,229
76,0.18,"(12, 26)","(22, 9)",4,97,122,223,5,109,109,223
77,0.14,"(17, 4)","(28, 2)",6,64,51,121,5,170,170,345
78,0.18,"(14, 22)","(3, 29)",9,82,120,211,4,137,136,277
79,0.18,"(13, 17)","(18, 2)",6,67,54,127,4,205,204,413
80,0.08,"(11, 24)","(8, 20)",12,79,87,178,16,67,78,161
81,0.02,"(22, 23)","(13, 15)",15,76,70,161,11,237,243,491
82,0.04,"(23, 27)","(6, 29)",7,79,115,201,6,70,71,147
83,0.08,"(21, 19)","(16, 25)",6,103,99,208,7,183,185,375
84,0.2,"(13, 5)","(0, 16)",7,82,74,163,8,127,130,265
85,0.2,"(16, 28)","(2, 4)",3,94,138,235,6,275,276,557
86,0.1,"(24, 27)","(2, 29)",13,82,130,225,19,118,132,269
87,0.12,"(3, 2)","(21, 22)",6,103,210,319,5,149,149,303
88,0.18,"(10, 26)","(17, 16)",14,112,309,435,14,46,55,115
89,0.08,"(9, 27)","(0, 24)",8,88,48,144,5,46,46,97
90,0.06,"(16, 25)","(19, 18)",10,64,36,110,7,55,57,119
91,0.04,"(13, 26)","(12, 14)",3,130,115,248,5,116,116,237
92,0.06,"(3, 0)","(17, 14)",2,85,146,233,3,79,77,159
93,0.06,"(16, 2)","(0, 6)",5,64,27,96,5,83,83,171
94,0.08,"(8, 21)","(6, 19)",8,85,40,133,4,61,60,125
95,0.14,"(0, 7)","(7, 1)",3,97,67,167,3,37,35,75
96,0.1,"(27, 16)","(6, 2)",7,100,131,238,5,131,131,267
97,0.2,"(2, 5)","(22, 11)",6,79,82,167,9,90,94,193
98,0.16,"(27, 2)","(12, 1)",5,70,38,113,6,76,77,159
99,0.18,"(5, 2)","(5, 16)",7,61,22,90,5,46,46,97
100,0.1,"(3, 5)","(28, 26)",9,88,99,196,10,56,61,127
101,0.16,"(14, 29)","(20, 23)",12,73,72,157,28,22,45,95
102,0.18,"(17, 0)","(13, 1)",5,61,13,79,13,8,16,37
103,0.12,"(10, 29)","(3, 9)",12,100,156,268,4,114,113,231
104,0.04,"(28, 22)","(0, 17)",5,94,266,365,3,134,132,269
105,0.16,"(9, 18)","(6, 11)",8,70,64,142,14,136,145,295
106,0.06,"(0, 0)","(29, 11)",6,82,118,206,29,169,193,391
107,0.02,"(11, 16)","(19, 8)",6,97,115,218,8,225,228,461
108,0.06,"(0, 14)","(0, 28)",6,103,82,191,8,179,182,369
109,0.1,"(7, 4)","(3, 17)",22,76,58,156,5,97,97,199
110,0.14,"(8, 7)","(17, 2)",5,88,77,170,18,49,62,129
111,0.02,"(25, 21)","(25, 12)",23,154,240,417,3,97,95,195
112,0.08,"(23, 11)","(1, 0)",4,67,76,147,4,152,151,307
113,0.08,"(21, 5)","(8, 23)",9,103,114,226,8,113,116,237
114,0.04,"(28, 2)","(2, 10)",9,91,82,182,9,127,131,267
115,0.16,"(7, 22)","(8, 10)",17,76,62,155,16,36,47,99
116,0.16,"(27, 6)","(29, 27)",21,64,65,150,5,241,241,487
117,0.2,"(24, 3)","(27, 17)",11,88,116,215,4,210,209,423
118,0.2,"(27, 29)","(29, 5)",9,67,58,134,3,199,197,399
119,0.12,"(18, 13)","(0, 17)",5,64,36,105,19,63,77,159
120,0.2,"(18, 5)","(15, 23)",14,76,57,147,4,59,58,121
121,0.14,"(17, 25)","(23, 2)",7,79,118,204,8,176,179,363
122,0.16,"(0, 22)","(19, 8)",10,145,314,469,6,135,136,277
123,0.16,"(19, 26)","(17, 12)",6,64,33,103,8,38,41,87
124,0.18,"(10, 11)","(19, 15)",9,91,82,182,5,57,57,119
125,0.2,"(6, 26)","(19, 0)",6,103,180,289,4,107,106,217
126,0.18,"(26, 8)","(3, 29)",6,67,69,142,3,110,108,221
127,0.14,"(15, 12)","(4, 27)",7,82,86,175,11,86,92,189
128,0.12,"(28, 18)","(11, 5)",19,112,171,302,4,51,50,105
129,0.1,"(16, 22)","(3, 1)",24,79,87,190,9,114,118,241
130,0.06,"(7, 3)","(4, 24)",4,61,31,96,9,217,221,447
131,0.06,"(27, 14)","(21, 16)",14,85,80,179,3,65,63,131
132,0.1,"(26, 23)","(5, 7)",8,91,141,240,16,138,149,303
133,0.04,"(7, 0)","(7, 15)",9,145,146,300,10,97,102,209
134,0.16,"(28, 15)","(1, 8)",7,88,155,250,8,113,116,237
135,0.08,"(16, 4)","(16, 16)",6,91,57,154,28,47,70,145
136,0.08,"(3, 29)","(9, 26)",12,64,33,109,3,15,13,31
137,0.14,"(0, 13)","(6, 24)",4,64,29,97,7,88,90,185
138,0.2,"(20, 19)","(12, 20)",8,73,43,124,8,78,81,167
139,0.2,"(10, 13)","(13, 6)",6,64,43,113,4,85,84,173
140,0.18,"(21, 1)","(5, 4)",6,67,33,106,6,97,98,201
141,0.08,"(15, 29)","(25, 8)",7,82,81,170,6,91,92,189
142,0.08,"(29, 1)","(14, 10)",6,64,53,123,7,63,65,135
143,0.1,"(20, 23)","(12, 26)",5,67,20,92,13,76,84,173
144,0.04,"(13, 26)","(26, 15)",6,148,256,410,5,110,110,225
145,0.04,"(17, 2)","(21, 21)",18,151,427,596,13,126,134,273
146,0.16,"(5, 27)","(16, 14)",32,79,133,244,5,106,106,217
147,0.06,"(17, 28)","(22, 0)",6,94,108,208,5,73,73,151
148,0.06,"(10, 3)","(4, 5)",8,73,41,122,5,80,80,165
149,0.02,"(24, 10)","(7, 15)",5,145,266,416,7,193,195,395
150,0.08,"(13, 29)","(24, 16)",8,133,196,337,8,60,63,131
151,0.08,"(21, 27)","(5, 26)",5,64,26,95,10,74,79,163
152,0.14,"(15, 14)","(14, 23)",28,82,86,196,9,101,105,215
153,0.2,"(19, 17)","(0, 11)",7,73,160,240,5,159,159,323
154,0.06,"(2, 11)","(2, 5)",21,76,38,135,8,108,111,227
155,0.12,"(22, 24)","(6, 14)",10,85,140,235,9,64,68,141
156,0.06,"(20, 4)","(21, 3)",10,61,13,84,6,45,46,97
157,0.04,"(19, 21)","(7, 27)",8,70,64,142,6,135,136,277
158,0.14,"(21, 21)","(15, 8)",8,70,81,159,6,47,48,101
159,0.2,"(12, 15)","(2, 20)",10,67,43,120,3,76,74,153
160,0.14,"(13, 7)","(7, 13)",9,109,177,295,12,80,87,179
161,0.04,"(0, 5)","(21, 1)",22,124,185,331,3,146,144,293
162,0.06,"(14, 1)","(0, 7)",8,67,101,176,4,71,70,145
163,0.04,"(22, 7)","(26, 10)",6,79,40,125,7,138,140,285
164,0.14,"(18, 15)","(15, 4)",6,94,77,177,7,85,87,179
165,0.08,"(13, 13)","(25, 2)",17,82,121,220,8,119,122,249
166,0.18,"(2, 11)","(16, 18)",4,88,81,173,5,53,53,111
167,0.16,"(14, 16)","(28, 16)",9,76,95,180,7,194,196,397
168,0.14,"(8, 17)","(1, 29)",7,76,86,169,4,56,55,115
169,0.2,"(2, 22)","(15, 21)",5,76,70,151,11,133,139,283
170,0.08,"(16, 15)","(12, 10)",6,79,42,127,7,77,79,163
171,0.18,"(10, 28)","(15, 10)",6,76,103,185,8,117,120,245
172,0.2,"(11, 27)","(22, 2)",7,88,149,244,5,82,82,169
173,0.12,"(17, 24)","(22, 13)",8,85,133,226,12,41,48,101
174,0.08,"(12, 29)","(3, 19)",10,76,45,131,14,116,125,255
175,0.08,"(23, 26)","(1, 9)",18,106,127,251,14,90,99,203
176,0.02,"(21, 4)","(12, 12)",6,178,308,492,5,141,141,287
177,0.18,"(27, 1)","(11, 4)",2,70,27,99,4,26,25,55
178,0.1,"(29, 9)","(6, 4)",10,79,194,283,5,85,85,175
179,0.18,"(18, 4)","(6, 25)",6,97,128,231,9,58,62,129
180,0.18,"(11, 17)","(8, 4)",7,88,61,156,6,108,109,223
181,0.08,"(26, 14)","(12, 6)",9,103,155,267,7,122,124,253
182,0.04,"(10, 4)","(21, 28)",10,97,106,213,12,138,145,295
183,0.02,"(28, 10)","(11, 3)",7,115,154,276,6,227,228,461
184,0.1,"(4, 20)","(18, 20)",6,97,99,202,11,76,82,169
185,0.04,"(8, 21)","(28, 25)",7,82,118,207,4,76,75,155
186,0.1,"(0, 3)","(0, 12)",6,67,43,116,8,115,118,241
187,0.1,"(5, 7)","(23, 28)",12,88,145,245,5,61,61,127
188,0.16,"(17, 28)","(13, 13)",12,70,73,155,6,129,130,265
189,0.06,"(25, 19)","(28, 26)",5,76,45,126,7,97,99,203
190,0.2,"(24, 15)","(0, 7)",8,73,92,173,10,127,132,269
191,0.18,"(17, 19)","(7, 11)",6,82,49,137,19,82,96,197
192,0.2,"(14, 23)","(14, 0)",4,73,64,141,8,177,180,365
193,0.12,"(16, 15)","(7, 18)",11,85,50,146,9,61,65,135
194,0.02,"(12, 6)","(15, 0)",11,67,64,142,5,119,119,243
195,0.06,"(11, 27)","(23, 6)",9,109,164,282,5,60,60,125
196,0.2,"(3, 14)","(2, 26)",4,73,40,117,12,157,164,333
197,0.08,"(12, 21)","(5, 24)",6,31,16,53,25,91,111,227
198,0.06,"(15, 24)","(6, 18)",5,79,112,196,12,139,146,297
199,0.16,"(3, 23)","(10, 18)",5,82,55,142,10,21,26,57
200,0.06,"(11, 0)","(21, 0)",9,94,102,205,3,33,31,67
201,0.12,"(2, 3)","(16, 24)",11,82,177,270,7,105,107,219
202,0.1,"(29, 16)","(16, 29)",8,85,113,206,4,174,173,351
203,0.18,"(18, 5)","(10, 25)",8,109,269,386,8,141,144,293
204,0.16,"(17, 25)","(23, 11)",7,73,96,176,10,73,78,161
205,0.1,"(10, 15)","(0, 16)",9,67,26,102,7,67,69,143
206,0.08,"(8, 7)","(5, 12)",8,64,42,114,17,57,69,143
207,0.16,"(0, 7)","(10, 2)",26,76,83,185,23,122,140,285
208,0.1,"(19, 3)","(27, 11)",4,106,185,295,4,97,96,197
209,0.06,"(6, 18)","(21, 22)",4,139,200,343,10,53,58,121
210,0.04,"(11, 29)","(28, 22)",15,94,108,217,6,46,47,99
211,0.16,"(17, 11)","(29, 0)",5,103,124,232,9,105,109,223
212,0.18,"(12, 26)","(29, 3)",7,79,93,179,6,82,83,171
213,0.04,"(10, 11)","(29, 25)",4,79,154,237,14,129,138,281
214,0.2,"(15, 3)","(28, 18)",13,73,158,244,3,106,104,213
215,0.04,"(28, 1)","(22, 9)",5,130,153,288,6,69,70,145
216,0.12,"(27, 29)","(11, 23)",4,67,43,114,35,86,116,237
217,0.04,"(11, 16)","(11, 20)",4,64,10,78,4,25,24,53
218,0.18,"(3, 28)","(8, 28)",2,73,53,128,2,44,41,87
219,0.02,"(23, 11)","(11, 1)",8,76,65,149,8,97,100,205
220,0.2,"(9, 21)","(12, 12)",13,85,127,225,5,127,127,259
221,0.14,"(8, 12)","(24, 21)",5,88,106,199,5,354,354,713
222,0.02,"(8, 2)","(8, 4)",6,67,29,102,15,30,40,85
223,0.18,"(29, 29)","(10, 13)",19,115,243,377,16,46,57,119
224,0.02,"(1, 16)","(10, 4)",4,121,110,235,9,48,52,109
225,0.08,"(14, 8)","(6, 9)",8,70,34,112,10,96,101,207
226,0.18,"(1, 27)","(4, 13)",2,94,129,225,3,61,59,123
227,0.14,"(6, 22)","(5, 5)",2,88,75,165,4,96,95,195
228,0.18,"(1, 17)","(23, 1)",8,100,108,216,5,478,478,961
229,0.12,"(22, 11)","(10, 3)",10,64,29,103,4,57,56,117
230,0.16,"(12, 12)","(21, 29)",20,67,70,157,19,109,123,251
231,0.02,"(23, 3)","(2, 11)",5,130,104,239,8,73,76,157
232,0.14,"(13, 12)","(1, 14)",12,73,57,142,10,126,131,267
233,0.04,"(22, 20)","(15, 27)",11,94,137,242,11,38,44,93
234,0.18,"(18, 6)","(21, 9)",6,73,77,156,8,29,32,69
235,0.1,"(18, 25)","(25, 22)",4,76,64,144,4,44,43,91
236,0.18,"(25, 11)","(24, 22)",5,94,102,201,3,106,104,213
237,0.02,"(5, 1)","(29, 27)",7,112,217,336,7,80,82,169
238,0.12,"(26, 22)","(22, 7)",14,85,129,228,9,172,176,357
239,0.2,"(3, 3)","(29, 8)",6,82,108,196,7,160,162,329
240,0.12,"(1, 17)","(7, 19)",5,73,69,147,4,30,29,63
241,0.14,"(23, 16)","(15, 6)",5,97,97,199,5,35,35,75
242,0.08,"(14, 25)","(9, 17)",8,85,94,187,17,179,191,387
243,0.02,"(15, 3)","(6, 23)",19,142,216,377,6,100,101,207
244,0.16,"(10, 27)","(17, 29)",6,82,66,154,4,21,20,45
245,0.06,"(5, 24)","(8, 23)",7,88,65,160,10,47,52,109
246,0.16,"(1, 7)","(1, 12)",4,85,67,156,11,19,25,55
247,0.14,"(22, 13)","(8, 23)",8,97,166,271,4,35,34,73
248,0.06,"(7, 26)","(3, 16)",10,97,73,180,4,70,69,143
249,0.08,"(11, 25)","(1, 2)",9,73,100,182,13,77,85,175
250,0.16,"(10, 7)","(1, 14)",5,70,42,117,9,87,91,187
251,0.02,"(29, 7)","(3, 11)",7,112,197,316,4,192,191,387
252,0.18,"(10, 9)","(21, 18)",5,127,291,423,5,45,45,95
253,0.12,"(26, 17)","(17, 26)",5,118,271,394,6,73,74,153
254,0.1,"(2, 0)","(28, 7)",4,88,81,173,7,104,106,217
255,0.18,"(5, 18)","(20, 29)",7,73,116,196,6,191,192,389
256,0.18,"(10, 25)","(1, 12)",10,67,31,108,3,84,82,169
257,0.1,"(5, 17)","(25, 11)",5,91,180,276,13,45,53,111
258,0.06,"(5, 3)","(12, 19)",14,94,119,227,18,61,74,153
259,0.12,"(5, 23)","(28, 0)",5,64,56,125,6,58,59,123
260,0.16,"(27, 22)","(15, 21)",10,85,158,253,3,47,45,95
261,0.18,"(0, 29)","(27, 26)",5,82,121,208,3,218,216,437
262,0.1,"(8, 22)","(12, 9)",15,109,114,238,11,169,175,355
263,0.16,"(5, 22)","(28, 9)",6,88,131,225,5,75,75,155
264,0.06,"(13, 13)","(19, 6)",9,109,111,229,21,107,123,251
265,0.08,"(8, 27)","(10, 0)",9,61,51,121,8,103,106,217
266,0.02,"(26, 9)","(2, 27)",7,136,232,375,7,56,58,121
267,0.12,"(7, 24)","(9, 17)",7,106,79,192,4,51,50,105
268,0.1,"(26, 24)","(2, 7)",10,106,103,219,7,55,57,119
269,0.16,"(26, 2)","(3, 15)",13,100,251,364,11,153,159,323
270,0.12,"(5, 7)","(27, 22)",6,73,84,163,11,150,156,317
271,0.02,"(25, 6)","(5, 23)",10,178,271,459,7,167,169,343
272,0.12,"(17, 2)","(10, 12)",5,94,70,169,7,58,60,125
273,0.06,"(18, 21)","(15, 1)",10,103,85,198,5,115,115,235
274,0.16,"(9, 15)","(17, 21)",4,109,324,437,6,70,71,147
275,0.2,"(4, 2)","(19, 26)",4,94,149,247,5,116,116,237
276,0.04,"(14, 2)","(25, 22)",9,94,107,210,7,118,120,245
277,0.14,"(13, 19)","(26, 8)",3,88,71,162,6,105,106,217
278,0.2,"(12, 28)","(13, 12)",10,91,79,180,5,70,70,145
279,0.02,"(26, 12)","(21, 11)",5,109,79,193,14,17,26,57
280,0.06,"(18, 24)","(15, 6)",23,64,59,146,9,94,98,201
281,0.02,"(3, 17)","(29, 11)",7,133,152,292,14,240,249,503
282,0.12,"(15, 29)","(4, 12)",6,103,172,281,5,68,68,141
283,0.04,"(22, 2)","(21, 0)",6,100,99,205,5,29,29,63
284,0.18,"(6, 16)","(26, 23)",3,100,105,208,4,142,141,287
285,0.02,"(17, 5)","(3, 20)",2,145,112,259,18,98,111,227
286,0.2,"(14, 13)","(10, 10)",10,76,52,138,10,47,52,109
287,0.14,"(5, 26)","(6, 1)",5,91,123,219,10,96,101,207
288,0.06,"(10, 14)","(14, 2)",9,85,121,215,6,70,71,147
289,0.12,"(6, 11)","(12, 19)",8,112,193,313,4,31,30,65
290,0.16,"(21, 19)","(27, 16)",6,67,56,129,19,117,131,267
291,0.06,"(18, 3)","(15, 15)",3,97,78,178,8,99,102,209
292,0.16,"(8, 2)","(17, 6)",3,106,129,238,3,39,37,79
293,0.06,"(14, 18)","(9, 22)",5,82,45,132,10,28,33,71
294,0.14,"(24, 22)","(0, 11)",9,85,130,224,9,88,92,189
295,0.04,"(13, 25)","(27, 17)",5,130,299,434,8,154,157,319
296,0.08,"(16, 1)","(26, 19)",8,76,90,174,2,110,107,219
297,0.1,"(16, 6)","(22, 11)",5,67,54,126,9,50,54,113
298,0.02,"(29, 8)","(23, 21)",8,115,155,278,3,94,92,189
299,0.06,"(29, 15)","(0, 21)",4,112,94,210,2,128,125,255
300,0.16,"(11, 25)","(19, 25)",7,70,33,110,5,52,52,109
301,0.2,"(13, 19)","(24, 1)",12,70,69,151,10,84,89,183
302,0.12,"(3, 6)","(19, 6)",4,88,84,176,7,55,57,119
303,0.18,"(11, 7)","(23, 2)",4,100,139,243,8,250,253,511
304,0.04,"(27, 15)","(5, 26)",12,112,184,308,14,104,113,231
305,0.14,"(29, 4)","(10, 29)",8,73,135,216,5,147,147,299
306,0.02,"(29, 29)","(19, 4)",6,127,265,398,12,95,102,209
307,0.14,"(18, 3)","(5, 1)",12,79,55,146,6,97,98,201
308,0.06,"(5, 0)","(15, 9)",3,94,132,229,5,52,52,109
309,0.1,"(5, 19)","(16, 7)",10,97,107,214,15,37,47,99
310,0.04,"(24, 12)","(1, 25)",5,79,69,153,10,50,55,115
311,0.2,"(16, 1)","(5, 25)",5,88,227,320,4,106,105,215
312,0.02,"(19, 27)","(18, 2)",7,73,83,163,9,218,222,449
313,0.02,"(18, 5)","(29, 27)",6,139,162,307,5,56,56,117
314,0.08,"(10, 12)","(18, 1)",6,73,78,157,7,111,113,231
315,0.18,"(22, 27)","(12, 5)",12,91,138,241,7,86,88,181
316,0.06,"(23, 2)","(15, 10)",6,61,29,96,5,142,142,289
317,0.02,"(17, 2)","(27, 23)",12,88,126,226,5,152,152,309
318,0.12,"(26, 19)","(12, 27)",16,85,220,321,5,34,34,73
319,0.08,"(12, 13)","(0, 0)",11,61,56,128,4,211,210,425
320,0.18,"(7, 22)","(26, 16)",31,118,196,345,10,66,71,147
321,0.16,"(17, 10)","(16, 16)",7,79,55,141,7,27,29,63
322,0.1,"(13, 17)","(16, 20)",19,64,35,118,11,35,41,87
323,0.08,"(21, 21)","(6, 14)",11,88,87,186,9,28,32,69
324,0.04,"(15, 4)","(7, 18)",11,109,198,318,5,40,40,85
325,0.18,"(23, 16)","(5, 0)",8,82,83,173,10,151,156,317
326,0.06,"(18, 17)","(10, 14)",5,88,74,167,6,42,43,91
327,0.08,"(16, 4)","(21, 11)",6,94,96,196,10,38,43,91
328,0.04,"(22, 23)","(9, 24)",9,118,140,267,11,83,89,183
329,0.02,"(24, 6)","(28, 17)",8,136,180,324,6,146,147,299
330,0.1,"(26, 22)","(13, 0)",9,85,96,190,9,96,100,205
331,0.14,"(15, 26)","(23, 3)",22,91,114,227,12,49,56,117
332,0.08,"(19, 11)","(8, 21)",16,88,116,220,11,65,71,147
333,0.04,"(7, 17)","(29, 16)",9,91,75,175,4,112,111,227
334,0.18,"(28, 12)","(5, 15)",3,85,106,194,19,84,98,201
335,0.14,"(15, 1)","(9, 1)",11,67,30,108,8,82,85,175
336,0.02,"(14, 18)","(12, 9)",9,121,125,255,19,183,197,399
337,0.2,"(1, 10)","(29, 1)",3,70,102,175,8,370,373,751
338,0.1,"(0, 4)","(14, 11)",24,76,63,163,11,133,139,283
339,0.06,"(22, 8)","(17, 5)",5,31,15,51,12,65,72,149
340,0.12,"(6, 12)","(18, 29)",5,112,148,265,5,100,100,205
341,0.12,"(6, 7)","(1, 8)",8,73,40,121,13,19,27,59
342,0.02,"(6, 25)","(28, 6)",10,100,105,215,7,110,112,229
343,0.04,"(15, 14)","(10, 22)",14,79,66,159,11,73,79,163
344,0.08,"(26, 27)","(23, 29)",16,67,26,109,7,23,25,55
345,0.02,"(1, 3)","(4, 2)",4,70,23,97,7,42,44,93
346,0.02,"(9, 6)","(27, 0)",10,73,59,142,7,56,58,121
347,0.06,"(0, 19)","(2, 21)",9,61,12,82,13,40,48,101
348,0.12,"(7, 7)","(22, 4)",5,109,142,256,5,219,219,443
349,0.14,"(15, 29)","(26, 24)",10,100,99,209,7,75,77,159
350,0.06,"(2, 13)","(0, 21)",15,85,72,172,15,17,27,59
351,0.02,"(20, 19)","(9, 22)",2,88,50,140,4,93,92,189
352,0.02,"(23, 14)","(19, 25)",7,214,358,579,9,208,212,429
353,0.06,"(23, 10)","(21, 12)",16,61,22,99,15,8,18,41
354,0.18,"(19, 4)","(11, 14)",12,103,196,311,5,55,55,115
355,0.08,"(23, 29)","(11, 1)",2,85,128,215,5,69,69,143
356,0.16,"(10, 6)","(2, 4)",6,61,20,87,8,61,64,133
357,0.04,"(3, 27)","(23, 19)",28,112,178,318,6,74,75,155
358,0.02,"(17, 2)","(18, 28)",4,67,59,130,5,161,161,327
359,0.08,"(24, 25)","(8, 20)",10,103,168,281,8,65,68,141
360,0.06,"(17, 6)","(29, 17)",3,88,109,200,6,166,167,339
361,0.2,"(7, 9)","(2, 4)",8,61,20,89,4,25,24,53
362,0.18,"(15, 16)","(3, 24)",3,79,88,170,7,181,183,371
363,0.04,"(19, 25)","(14, 14)",8,151,256,415,21,49,65,135
364,0.02,"(29, 20)","(23, 28)",5,88,212,305,6,111,112,229
365,0.14,"(0, 28)","(10, 9)",7,88,160,255,6,48,49,103
366,0.18,"(23, 8)","(4, 29)",6,70,69,145,6,203,204,413
367,0.02,"(27, 24)","(0, 6)",4,67,62,133,7,182,184,373
368,0.14,"(16, 9)","(4, 17)",6,76,90,172,5,101,101,207
369,0.08,"(19, 21)","(6, 0)",11,109,249,369,7,167,169,343
370,0.2,"(16, 25)","(19, 13)",9,85,132,226,17,55,67,139
371,0.14,"(24, 19)","(17, 1)",19,70,57,146,6,83,84,173
372,0.16,"(17, 2)","(23, 27)",4,82,72,158,6,134,135,275
373,0.16,"(17, 5)","(23, 24)",9,94,96,199,3,175,173,351
374,0.12,"(21, 23)","(2, 12)",13,73,52,138,4,114,113,231
375,0.2,"(0, 18)","(26, 0)",17,64,66,147,5,229,229,463
376,0.18,"(8, 18)","(4, 4)",6,82,127,215,6,84,85,175
377,0.12,"(24, 4)","(2, 27)",6,73,60,139,16,98,109,223
378,0.2,"(23, 24)","(14, 25)",13,85,97,195,15,34,44,93
379,0.06,"(0, 14)","(15, 2)",5,127,144,276,8,116,119,243
380,0.1,"(27, 24)","(9, 29)",3,103,126,232,10,119,124,253
381,0.14,"(15, 14)","(13, 14)",6,73,33,112,18,26,39,83
382,0.1,"(6, 22)","(26, 25)",10,85,83,178,5,126,126,257
383,0.02,"(15, 12)","(29, 1)",16,91,147,254,4,201,200,405
384,0.18,"(28, 19)","(28, 29)",5,76,64,145,6,180,181,367
385,0.14,"(6, 22)","(29, 14)",6,91,185,282,8,89,92,189
386,0.04,"(26, 8)","(7, 22)",11,88,158,257,5,102,102,209
387,0.04,"(18, 3)","(25, 0)",5,82,151,238,22,37,54,113
388,0.06,"(1, 5)","(26, 5)",4,91,84,179,7,108,110,225
389,0.1,"(14, 19)","(0, 24)",42,76,113,231,5,52,52,109
390,0.18,"(8, 19)","(16, 27)",3,79,53,135,8,68,71,147
391,0.06,"(25, 15)","(26, 20)",7,70,74,151,5,44,44,93
392,0.1,"(25, 16)","(27, 7)",14,88,216,318,3,63,61,127
393,0.02,"(26, 16)","(9, 11)",6,133,142,281,3,47,45,95
394,0.16,"(11, 5)","(11, 13)",10,67,45,122,9,71,75,155
395,0.04,"(8, 25)","(2, 10)",5,109,214,328,6,134,135,275
396,0.1,"(15, 17)","(11, 1)",6,91,69,166,8,110,113,231
397,0.12,"(14, 21)","(2, 0)",8,79,129,216,6,161,162,329
398,0.08,"(21, 29)","(25, 4)",15,97,121,233,8,103,106,217
399,0.16,"(14, 22)","(2, 7)",7,91,135,233,9,179,183,371
400,0.04,"(18, 1)","(24, 28)",5,109,133,247,8,126,129,263
401,0.02,"(24, 19)","(22, 6)",16,250,512,778,15,87,97,199
402,0.02,"(5, 7)","(1, 25)",8,67,39,114,4,83,82,169
403,0.12,"(8, 29)","(29, 28)",7,103,195,305,13,133,141,287
404,0.06,"(4, 8)","(8, 17)",4,70,37,111,18,43,56,117
405,0.16,"(23, 3)","(19, 5)",11,64,19,94,5,77,77,159
406,0.14,"(7, 3)","(29, 23)",6,70,95,171,4,52,51,107
407,0.08,"(21, 27)","(6, 5)",4,103,155,262,9,136,140,285
408,0.14,"(6, 4)","(12, 0)",6,64,38,108,4,46,45,95
409,0.14,"(17, 23)","(13, 23)",12,31,22,65,10,12,17,39
410,0.04,"(6, 10)","(9, 0)",5,118,174,297,6,121,122,249
411,0.08,"(14, 3)","(17, 21)",5,109,127,241,5,81,81,167
412,0.14,"(18, 10)","(29, 3)",11,79,91,181,11,110,116,237
413,0.12,"(22, 2)","(28, 11)",18,85,83,186,5,157,157,319
414,0.06,"(22, 25)","(5, 25)",26,76,133,235,20,89,104,213
415,0.1,"(27, 16)","(29, 12)",6,67,64,137,6,51,52,109
416,0.16,"(5, 23)","(15, 24)",8,130,252,390,15,79,89,183
417,0.08,"(1, 19)","(9, 16)",7,76,46,129,7,41,43,91
418,0.08,"(13, 16)","(23, 21)",6,103,139,248,8,59,62,129
419,0.08,"(10, 28)","(11, 11)",7,73,55,135,6,155,156,317
420,0.12,"(11, 29)","(18, 28)",7,82,81,170,11,23,29,63
421,0.1,"(17, 12)","(22, 19)",15,85,195,295,32,140,167,339
422,0.1,"(5, 25)","(23, 24)",5,88,66,159,8,98,101,207
423,0.14,"(27, 15)","(3, 11)",11,85,67,163,7,155,157,319
424,0.02,"(21, 23)","(12, 16)",7,94,71,172,16,150,161,327
425,0.18,"(27, 2)","(9, 29)",7,82,204,293,7,72,74,153
426,0.08,"(27, 1)","(6, 21)",12,106,164,282,7,80,82,169
427,0.2,"(16, 12)","(29, 27)",5,97,92,194,6,161,162,329
428,0.18,"(3, 25)","(7, 11)",5,91,160,256,6,69,70,145
429,0.12,"(26, 23)","(4, 11)",5,88,69,162,6,40,41,87
430,0.06,"(4, 1)","(24, 4)",3,61,44,108,10,75,80,165
431,0.1,"(20, 14)","(23, 8)",15,67,81,163,7,105,107,219
432,0.04,"(21, 17)","(4, 28)",21,175,337,533,4,93,92,189
433,0.02,"(15, 1)","(25, 6)",5,103,109,217,7,207,209,423
434,0.04,"(29, 16)","(0, 14)",9,112,151,272,3,98,96,197
435,0.04,"(3, 4)","(15, 3)",9,82,59,150,6,135,136,277
436,0.18,"(10, 23)","(22, 21)",11,100,165,276,9,163,167,339
437,0.18,"(20, 4)","(3, 6)",5,76,62,143,8,160,163,331
438,0.16,"(2, 20)","(14, 11)",9,112,267,388,4,71,70,145
439,0.02,"(29, 19)","(23, 17)",10,142,333,485,10,107,112,229
440,0.02,"(5, 1)","(25, 9)",3,85,75,163,20,172,187,379
441,0.1,"(12, 16)","(23, 15)",4,73,68,145,8,87,90,185
442,0.04,"(8, 21)","(29, 5)",4,91,126,221,8,102,105,215
443,0.1,"(5, 4)","(15, 23)",5,127,210,342,8,116,119,243
444,0.08,"(1, 22)","(29, 23)",10,88,113,211,14,149,158,321
445,0.02,"(0, 24)","(5, 12)",3,100,103,206,5,51,51,107
446,0.14,"(26, 6)","(25, 12)",9,70,46,125,8,64,67,139
447,0.1,"(16, 14)","(3, 12)",5,64,34,103,19,48,62,129
448,0.04,"(20, 28)","(24, 29)",11,73,26,110,8,150,153,311
449,0.16,"(27, 14)","(29, 0)",13,61,47,121,5,117,117,239
450,0.08,"(10, 12)","(26, 2)",9,94,175,278,8,68,71,147
451,0.2,"(21, 18)","(9, 16)",12,85,126,223,10,29,34,73
452,0.06,"(15, 25)","(18, 23)",5,79,47,131,8,35,38,81
453,0.1,"(19, 29)","(0, 0)",8,94,139,241,10,53,58,121
454,0.14,"(1, 22)","(16, 16)",4,106,202,312,5,86,86,177
455,0.12,"(4, 26)","(10, 4)",4,106,174,284,5,52,52,109
456,0.12,"(25, 18)","(9, 10)",11,79,153,243,9,80,84,173
457,0.18,"(28, 8)","(13, 24)",6,109,217,332,3,141,139,283
458,0.14,"(19, 5)","(9, 20)",6,106,147,259,9,82,86,177
459,0.02,"(16, 19)","(19, 23)",12,76,88,176,7,188,190,385
460,0.16,"(29, 2)","(18, 22)",8,73,102,183,7,64,66,137
461,0.08,"(29, 11)","(19, 28)",8,103,183,294,5,105,105,215
462,0.08,"(27, 29)","(13, 2)",26,109,148,283,5,70,70,145
463,0.04,"(5, 5)","(29, 0)",4,70,61,135,5,145,145,295
464,0.18,"(3, 23)","(3, 12)",6,64,31,101,7,49,51,107
465,0.18,"(3, 11)","(3, 0)",7,70,43,120,5,229,229,463
466,0.18,"(29, 9)","(4, 24)",5,79,76,160,8,174,177,359
467,0.08,"(11, 23)","(28, 8)",12,103,99,214,4,51,50,105
468,0.06,"(27, 19)","(26, 26)",6,106,199,311,11,96,102,209
469,0.08,"(17, 15)","(0, 25)",12,73,119,204,7,99,101,207
470,0.1,"(9, 5)","(21, 22)",13,73,65,151,7,48,50,105
471,0.04,"(15, 25)","(15, 11)",14,97,155,266,4,37,36,77
472,0.08,"(24, 3)","(2, 11)",7,88,72,167,6,67,68,141
473,0.12,"(10, 29)","(13, 12)",6,103,178,287,4,235,234,473
474,0.06,"(16, 3)","(8, 18)",8,82,62,152,5,172,172,349
475,0.2,"(0, 20)","(25, 29)",14,73,109,196,10,221,226,457
476,0.18,"(19, 6)","(13, 4)",6,76,52,134,5,30,30,65
477,0.16,"(10, 7)","(13, 4)",4,88,71,163,7,67,69,143
478,0.18,"(24, 12)","(17, 13)",5,88,75,168,5,107,107,219
479,0.14,"(2, 0)","(20, 17)",10,88,141,239,23,95,113,231
480,0.14,"(2, 24)","(26, 16)",15,118,182,315,4,151,150,305
481,0.2,"(5, 16)","(25, 12)",4,103,288,395,4,139,138,281
482,0.04,"(10, 26)","(1, 19)",7,115,159,281,6,118,119,243
483,0.18,"(0, 7)","(1, 21)",4,82,71,157,5,54,54,113
484,0.08,"(21, 29)","(21, 11)",7,82,54,143,15,73,83,171
485,0.08,"(15, 17)","(28, 28)",11,70,61,142,3,93,91,187
486,0.16,"(1, 7)","(3, 27)",22,91,233,346,4,99,98,201
487,0.14,"(19, 11)","(14, 27)",11,88,229,328,6,104,105,215
488,0.06,"(12, 2)","(1, 13)",5,76,51,132,10,101,106,217
489,0.1,"(10, 1)","(16, 1)",5,61,31,97,12,82,89,183
490,0.18,"(18, 4)","(12, 4)",9,61,22,92,5,21,21,47
491,0.08,"(24, 9)","(5, 18)",9,85,161,255,6,59,60,125
492,0.14,"(10, 10)","(15, 29)",6,91,77,174,6,50,51,107
493,0.06,"(27, 12)","(19, 17)",6,88,60,154,8,24,27,59
494,0.16,"(3, 29)","(22, 29)",11,100,181,292,16,247,258,521
495,0.1,"(25, 16)","(16, 22)",4,79,40,123,5,67,67,139
496,0.04,"(14, 19)","(23, 7)",6,94,205,305,8,185,188,381
497,0.14,"(22, 1)","(14, 19)",2,88,124,214,5,49,49,103
498,0.2,"(6, 10)","(13, 2)",8,79,75,162,10,50,55,115
499,0.1,"(18, 1)","(10, 16)",6,103,97,206,3,49,47,99
500,0.12,"(26, 8)","(3, 7)",8,73,47,128,3,104,102,209
501,0.2,"(1, 6)","(6, 25)",6,85,157,248,4,183,182,369
502,0.12,"(6, 15)","(18, 4)",16,82,136,234,11,176,182,369
503,0.06,"(22, 9)","(29, 11)",4,76,37,117,10,85,90,185
504,0.06,"(24, 20)","(28, 26)",2,73,38,113,3,59,57,119
505,0.02,"(11, 17)","(5, 15)",7,61,18,86,8,26,29,63
506,0.06,"(2, 11)","(3, 26)",5,79,34,118,10,66,71,147
507,0.06,"(27, 2)","(18, 21)",10,85,101,196,5,174,174,353
508,0.04,"(21, 1)","(24, 18)",7,79,94,180,7,120,122,249
509,0.18,"(1, 0)","(5, 28)",3,67,42,112,2,164,161,327
510,0.18,"(20, 3)","(15, 26)",5,91,83,179,13,154,162,329
511,0.02,"(16, 15)","(12, 21)",8,127,186,321,5,238,238,481
512,0.2,"(22, 29)","(20, 11)",5,91,102,198,5,59,59,123
513,0.18,"(9, 8)","(24, 0)",5,73,50,128,24,159,178,361
514,0.12,"(23, 18)","(22, 8)",3,70,37,110,5,77,77,159
515,0.12,"(6, 8)","(28, 1)",9,76,102,187,4,72,71,147
516,0.12,"(27, 17)","(15, 0)",9,73,85,167,4,56,55,115
517,0.18,"(9, 9)","(26, 17)",11,94,125,230,10,135,140,285
518,0.14,"(11, 5)","(21, 29)",7,67,61,135,5,119,119,243
519,0.2,"(24, 5)","(9, 17)",10,94,268,372,12,61,68,141
520,0.12,"(21, 18)","(16, 11)",7,67,32,106,13,38,46,97
521,0.1,"(8, 20)","(8, 4)",6,115,183,304,10,103,108,221
522,0.2,"(6, 15)","(25, 11)",17,67,67,151,6,63,64,133
523,0.02,"(27, 15)","(16, 26)",11,142,271,424,7,82,84,173
524,0.14,"(26, 16)","(26, 12)",4,79,59,142,5,21,21,47
525,0.04,"(14, 21)","(5, 0)",6,73,74,153,9,81,85,175
526,0.04,"(11, 13)","(19, 29)",11,112,213,336,6,100,101,207
527,0.2,"(12, 8)","(10, 26)",6,88,200,294,10,139,144,293
528,0.02,"(4, 20)","(11, 1)",16,160,298,474,3,97,95,195
529,0.1,"(6, 7)","(0, 14)",15,64,33,112,7,141,143,291
530,0.1,"(7, 9)","(27, 12)",11,109,159,279,8,194,197,399
531,0.1,"(13, 27)","(12, 23)",5,61,16,82,13,22,30,65
532,0.04,"(0, 11)","(18, 13)",7,118,119,244,7,93,95,195
533,0.06,"(1, 27)","(8, 27)",6,82,58,146,4,40,39,83
534,0.2,"(17, 0)","(3, 12)",16,85,68,169,7,104,106,217
535,0.12,"(25, 6)","(17, 28)",11,76,64,151,5,76,76,157
536,0.04,"(29, 29)","(26, 29)",3,67,15,85,3,127,125,255
537,0.14,"(0, 20)","(0, 3)",7,67,34,108,8,179,182,369
538,0.04,"(0, 17)","(9, 11)",6,106,76,188,19,79,93,191
539,0.12,"(19, 29)","(2, 28)",6,88,44,138,5,89,89,183
540,0.2,"(22, 2)","(6, 3)",6,85,64,155,10,103,108,221
541,0.12,"(9, 28)","(26, 18)",6,103,232,341,11,106,112,229
542,0.1,"(18, 13)","(3, 11)",18,103,93,214,15,55,65,135
543,0.1,"(29, 21)","(8, 3)",1,91,120,212,3,104,102,209
544,0.16,"(25, 20)","(29, 9)",4,70,48,122,6,91,92,189
545,0.2,"(27, 26)","(29, 19)",6,67,38,111,8,97,100,205
546,0.08,"(1, 9)","(12, 19)",4,88,52,144,4,109,108,221
547,0.16,"(29, 3)","(8, 3)",3,88,64,155,4,80,79,163
548,0.18,"(10, 4)","(21, 14)",6,91,151,248,11,42,48,101
549,0.12,"(22, 3)","(20, 29)",5,106,113,224,5,90,90,185
550,0.18,"(27, 3)","(20, 19)",6,97,266,369,4,94,93,191
551,0.12,"(25, 0)","(11, 5)",9,88,99,196,5,36,36,77
552,0.2,"(1, 8)","(19, 10)",6,64,55,125,16,112,123,251
553,0.08,"(3, 14)","(28, 23)",6,85,75,166,13,152,160,325
554,0.02,"(14, 8)","(21, 22)",17,142,311,470,6,91,92,189
555,0.06,"(25, 25)","(15, 21)",4,106,59,169,6,62,63,131
556,0.02,"(5, 29)","(0, 27)",11,64,17,92,18,9,22,49
557,0.04,"(4, 19)","(26, 1)",12,61,51,124,7,53,55,115
558,0.02,"(12, 24)","(9, 29)",10,76,61,147,3,106,104,213
559,0.08,"(14, 15)","(27, 29)",12,76,91,179,7,87,89,183
560,0.04,"(15, 18)","(25, 14)",7,100,152,259,11,132,138,281
561,0.12,"(11, 0)","(1, 9)",6,82,58,146,9,114,118,241
562,0.1,"(24, 14)","(10, 11)",13,67,37,117,13,33,41,87
563,0.08,"(6, 16)","(10, 27)",16,73,85,174,5,93,93,191
564,0.2,"(29, 25)","(25, 4)",8,88,165,261,4,78,77,159
565,0.06,"(15, 8)","(8, 22)",11,85,119,215,7,39,41,87
566,0.06,"(11, 8)","(22, 16)",7,64,64,135,6,131,132,269
567,0.18,"(18, 26)","(25, 3)",3,73,108,184,7,88,90,185
568,0.16,"(13, 13)","(11, 4)",9,64,35,108,6,98,99,203
569,0.06,"(0, 5)","(16, 28)",5,100,132,237,12,81,88,181
570,0.02,"(19, 16)","(3, 4)",10,121,200,331,5,78,78,161
571,0.06,"(11, 11)","(1, 3)",7,64,46,117,6,127,128,261
572,0.06,"(17, 5)","(19, 15)",12,85,63,160,5,187,187,379
573,0.06,"(23, 23)","(11, 15)",7,109,161,277,6,33,34,73
574,0.08,"(21, 5)","(4, 21)",4,91,100,195,6,63,64,133
575,0.08,"(17, 11)","(5, 18)",30,73,87,190,13,109,117,239
576,0.16,"(20, 19)","(12, 25)",8,67,42,117,8,128,131,267
577,0.18,"(16, 0)","(2, 14)",4,109,222,335,3,64,62,129
578,0.18,"(25, 7)","(0, 29)",13,61,63,137,5,66,66,137
579,0.16,"(12, 11)","(12, 15)",7,73,44,124,4,73,72,149
580,0.06,"(17, 22)","(15, 15)",20,85,138,243,5,109,109,223
581,0.04,"(7, 25)","(9, 11)",16,61,38,115,5,156,156,317
582,0.14,"(17, 25)","(9, 1)",7,73,81,161,18,99,112,229
583,0.2,"(7, 12)","(15, 20)",4,100,229,333,9,36,40,85
584,0.1,"(3, 13)","(29, 4)",6,73,72,151,4,134,133,271
585,0.12,"(7, 7)","(16, 16)",3,73,53,129,9,48,52,109
586,0.18,"(4, 3)","(6, 17)",20,91,291,402,6,129,130,265
587,0.14,"(14, 4)","(17, 5)",4,73,49,126,10,34,39,83
588,0.08,"(28, 27)","(6, 21)",5,73,135,213,10,91,96,197
589,0.08,"(28, 22)","(22, 14)",4,109,135,248,7,68,70,145
590,0.18,"(20, 23)","(4, 29)",7,76,106,189,14,113,122,249
591,0.18,"(14, 13)","(3, 0)",4,85,87,176,7,114,116,237
592,0.16,"(16, 18)","(26, 9)",4,106,171,281,3,110,108,221
593,0.02,"(26, 10)","(27, 8)",21,73,31,125,8,22,25,55
594,0.02,"(9, 26)","(29, 29)",8,157,280,445,5,193,193,391
595,0.16,"(20, 11)","(27, 11)",5,70,44,119,8,73,76,157
596,0.08,"(13, 1)","(8, 3)",3,31,13,47,10,14,19,43
597,0.12,"(6, 15)","(13, 13)",14,73,67,154,5,112,112,229
598,0.08,"(15, 8)","(18, 7)",4,94,114,212,3,8,6,17
599,0.1,"(21, 17)","(7, 9)",13,82,97,192,6,236,237,479
600,0.04,"(2, 21)","(23, 3)",12,121,151,284,6,102,103,211
601,0.08,"(12, 11)","(8, 28)",4,82,83,169,6,195,196,397
602,0.08,"(18, 21)","(19, 6)",8,88,111,207,14,57,66,137
603,0.02,"(21, 3)","(13, 20)",6,193,361,560,7,36,38,81
604,0.1,"(26, 17)","(5, 17)",5,97,145,247,9,73,77,159
605,0.08,"(15, 5)","(27, 20)",6,109,152,267,5,125,125,255
606,0.06,"(19, 10)","(5, 0)",4,73,129,206,3,123,121,247
607,0.1,"(3, 5)","(23, 14)",7,76,95,178,6,101,102,209
608,0.14,"(14, 16)","(2, 4)",7,82,103,192,8,78,81,167
609,0.02,"(17, 17)","(23, 21)",8,193,301,502,9,86,90,185
610,0.04,"(2, 24)","(6, 23)",7,82,44,133,7,88,90,185
611,0.12,"(12, 1)","(17, 22)",3,73,62,138,7,82,84,173
612,0.16,"(11, 6)","(7, 5)",4,31,10,45,8,23,26,57
613,0.18,"(11, 25)","(19, 6)",9,115,305,429,10,149,154,313
614,0.2,"(25, 0)","(13, 2)",3,100,90,193,4,70,69,143
615,0.04,"(25, 11)","(24, 19)",4,91,60,155,5,76,76,157
616,0.02,"(7, 16)","(18, 23)",9,133,257,399,10,117,122,249
617,0.1,"(18, 10)","(20, 14)",4,76,40,120,5,57,57,119
618,0.16,"(23, 24)","(17, 27)",20,64,33,117,11,54,60,125
619,0.2,"(18, 25)","(14, 24)",8,67,31,106,9,39,43,91
620,0.06,"(17, 0)","(9, 27)",10,67,61,138,6,182,183,371
621,0.1,"(1, 15)","(1, 26)",4,73,41,118,6,104,105,215
622,0.04,"(23, 26)","(25, 21)",6,118,117,241,8,21,24,53
623,0.04,"(23, 24)","(6, 16)",14,112,104,230,7,43,45,95
624,0.14,"(27, 7)","(4, 11)",7,82,174,263,4,53,52,109
625,0.12,"(10, 12)","(16, 0)",6,67,111,184,11,133,139,283
626,0.16,"(16, 3)","(22, 22)",7,91,118,216,3,125,123,251
627,0.12,"(1, 17)","(23, 21)",6,103,92,201,5,88,88,181
628,0.04,"(1, 0)","(18, 18)",18,100,185,303,15,91,101,207
629,0.02,"(20, 5)","(18, 29)",8,100,130,238,4,101,100,205
630,0.08,"(23, 26)","(28, 23)",16,106,132,254,10,61,66,137
631,0.1,"(29, 27)","(14, 2)",13,88,109,210,11,152,158,321
632,0.06,"(20, 16)","(2, 12)",3,88,123,214,10,61,66,137
633,0.1,"(13, 1)","(23, 22)",6,100,289,395,4,59,58,121
634,0.08,"(16, 14)","(27, 14)",12,97,117,226,11,226,232,469
635,0.18,"(29, 26)","(13, 17)",10,91,86,187,6,42,43,91
636,0.2,"(22, 19)","(9, 3)",8,100,233,341,6,54,55,115
637,0.2,"(18, 2)","(28, 6)",13,67,80,160,7,155,157,319
638,0.1,"(24, 25)","(7, 16)",12,145,414,571,13,141,149,303
639,0.14,"(20, 17)","(8, 27)",6,76,109,191,6,129,130,265
640,0.02,"(9, 13)","(15, 8)",10,244,315,569,7,51,53,111
641,0.14,"(8, 10)","(14, 1)",4,70,88,162,5,37,37,79
642,0.14,"(4, 16)","(11, 27)",4,100,185,289,11,98,104,213
643,0.16,"(14, 24)","(21, 0)",10,82,119,211,18,192,205,415
644,0.2,"(27, 28)","(21, 9)",9,82,144,235,9,115,119,243
645,0.04,"(16, 29)","(24, 16)",17,127,246,390,6,60,61,127
646,0.04,"(4, 23)","(11, 21)",4,82,45,131,4,46,45,95
647,0.14,"(20, 20)","(17, 10)",5,64,53,122,3,97,95,195
648,0.18,"(27, 27)","(2, 6)",6,91,180,277,14,68,77,159
649,0.1,"(7, 26)","(24, 8)",5,100,181,286,6,100,101,207
650,0.1,"(22, 4)","(11, 0)",10,64,35,109,8,49,52,109
651,0.02,"(27, 2)","(12, 16)",12,109,119,240,4,52,51,107
652,0.1,"(14, 29)","(16, 23)",8,79,38,125,9,73,77,159
653,0.04,"(12, 21)","(13, 21)",13,61,19,93,3,13,11,27
654,0.12,"(22, 8)","(1, 13)",4,82,108,194,12,125,132,269
655,0.14,"(9, 0)","(16, 9)",5,97,140,242,5,77,77,159
656,0.08,"(3, 13)","(7, 10)",4,85,38,127,9,150,154,313
657,0.02,"(8, 21)","(7, 13)",7,205,290,502,7,101,103,211
658,0.04,"(13, 21)","(16, 9)",4,94,65,163,15,98,108,221
659,0.02,"(16, 19)","(27, 29)",17,169,316,502,3,117,115,235
660,0.1,"(3, 24)","(15, 12)",20,103,110,233,5,111,111,227
661,0.02,"(21, 15)","(2, 19)",6,70,39,115,9,149,153,311
662,0.2,"(5, 18)","(24, 12)",8,70,63,141,11,108,114,233
663,0.14,"(5, 20)","(2, 21)",5,64,30,99,5,69,69,143
664,0.18,"(10, 2)","(8, 25)",10,91,84,185,6,67,68,141
665,0.06,"(3, 24)","(14, 1)",11,112,279,402,6,131,132,269
666,0.14,"(5, 18)","(23, 5)",9,85,156,250,7,104,106,217
667,0.1,"(21, 19)","(29, 0)",4,64,49,117,11,91,97,199
668,0.08,"(2, 29)","(4, 18)",3,70,32,105,4,72,71,147
669,0.1,"(27, 16)","(25, 13)",5,67,35,107,5,26,26,57
670,0.06,"(2, 4)","(26, 17)",5,112,133,250,6,114,115,235
671,0.04,"(14, 27)","(17, 9)",5,94,126,225,4,100,99,203
672,0.14,"(17, 13)","(23, 21)",7,100,101,208,4,125,124,253
673,0.06,"(4, 19)","(2, 29)",6,70,25,101,4,93,92,189
674,0.16,"(19, 15)","(1, 25)",11,100,101,212,8,101,104,213
675,0.06,"(26, 15)","(21, 22)",4,73,35,112,6,65,66,137
676,0.02,"(7, 24)","(26, 24)",5,88,96,189,4,97,96,197
677,0.12,"(0, 19)","(14, 1)",7,79,67,153,6,140,141,287
678,0.16,"(3, 15)","(28, 1)",4,76,105,185,6,172,173,351
679,0.14,"(21, 0)","(12, 13)",10,85,70,165,5,116,116,237
680,0.06,"(18, 21)","(23, 28)",8,88,147,243,6,78,79,163
681,0.06,"(18, 6)","(5, 27)",10,73,75,158,5,90,90,185
682,0.06,"(17, 11)","(3, 17)",5,100,178,283,6,146,147,299
683,0.02,"(4, 10)","(14, 11)",9,79,83,171,3,115,113,231
684,0.18,"(28, 5)","(8, 8)",5,85,48,138,8,165,168,341
685,0.04,"(20, 13)","(1, 24)",6,94,209,309,4,69,68,141
686,0.2,"(17, 22)","(8, 15)",7,82,72,161,9,22,26,57
687,0.2,"(15, 20)","(5, 25)",5,70,35,110,13,69,77,159
688,0.14,"(25, 17)","(18, 12)",8,64,33,105,6,37,38,81
689,0.18,"(16, 15)","(20, 2)",2,106,226,334,2,61,58,121
690,0.1,"(14, 9)","(9, 19)",15,73,77,165,3,72,70,145
691,0.14,"(12, 18)","(25, 24)",7,73,69,149,6,195,196,397
692,0.08,"(2, 6)","(8, 16)",5,73,57,135,18,58,71,147
693,0.08,"(7, 25)","(10, 17)",7,76,57,140,10,18,23,51
694,0.2,"(28, 12)","(18, 16)",7,82,35,124,6,42,43,91
695,0.12,"(22, 25)","(3, 22)",3,76,123,202,4,71,70,145
696,0.12,"(9, 0)","(7, 11)",6,79,58,143,6,89,90,185
697,0.18,"(9, 1)","(13, 6)",5,76,73,154,10,60,65,135
698,0.12,"(2, 3)","(7, 24)",7,97,86,190,6,58,59,123
699,0.12,"(7, 22)","(7, 27)",5,82,53,140,9,46,50,105
700,0.04,"(11, 5)","(19, 24)",7,154,225,386,8,106,109,223
701,0.18,"(20, 0)","(10, 6)",7,82,56,145,4,39,38,81
702,0.02,"(28, 13)","(10, 25)",9,106,164,279,11,138,144,293
703,0.12,"(6, 12)","(5, 4)",3,64,42,109,6,32,33,71
704,0.2,"(26, 25)","(4, 19)",5,88,202,295,9,42,46,97
705,0.08,"(18, 0)","(4, 22)",5,76,110,191,6,141,142,289
706,0.12,"(11, 19)","(17, 25)",10,79,104,193,24,87,106,217
707,0.2,"(16, 1)","(23, 16)",9,97,244,350,11,75,81,167
708,0.18,"(13, 10)","(11, 6)",7,64,13,84,4,13,12,29
709,0.04,"(4, 20)","(0, 22)",23,31,27,81,5,53,53,111
710,0.14,"(12, 25)","(8, 4)",34,103,141,278,10,116,121,247
711,0.12,"(19, 12)","(1, 6)",9,85,183,277,6,246,247,499
712,0.02,"(2, 23)","(18, 19)",5,85,67,157,5,165,165,335
713,0.04,"(8, 13)","(11, 7)",7,118,144,269,6,57,58,121
714,0.02,"(20, 27)","(14, 20)",10,97,79,186,13,160,168,341
715,0.18,"(17, 22)","(24, 14)",8,82,191,281,10,110,115,235
716,0.2,"(29, 20)","(3, 6)",6,109,207,322,10,247,252,509
717,0.02,"(18, 4)","(27, 28)",7,121,204,332,11,117,123,251
718,0.18,"(12, 23)","(7, 7)",14,100,290,404,6,77,78,161
719,0.1,"(3, 6)","(1, 5)",7,67,18,92,16,13,24,53
720,0.04,"(19, 2)","(17, 11)",8,76,74,158,8,144,147,299
721,0.2,"(8, 10)","(4, 23)",12,70,51,133,9,107,111,227
722,0.06,"(23, 16)","(28, 27)",12,106,111,229,6,40,41,87
723,0.16,"(2, 12)","(25, 25)",6,85,94,185,9,117,121,247
724,0.18,"(5, 21)","(3, 21)",20,61,31,112,11,17,23,51
725,0.12,"(0, 29)","(3, 19)",7,67,23,97,5,37,37,79
726,0.1,"(28, 20)","(23, 10)",11,91,76,178,7,78,80,165
727,0.2,"(4, 12)","(27, 25)",14,88,145,247,8,117,120,245
728,0.14,"(10, 18)","(10, 29)",6,61,30,97,7,55,57,119
729,0.14,"(0, 3)","(21, 3)",7,82,61,150,10,115,120,245
730,0.18,"(14, 8)","(22, 8)",11,82,84,177,29,79,103,211
731,0.16,"(16, 22)","(9, 22)",10,67,26,103,4,51,50,105
732,0.06,"(27, 11)","(26, 20)",6,91,74,171,2,63,60,125
733,0.16,"(18, 9)","(10, 19)",6,82,88,176,4,86,85,175
734,0.18,"(6, 0)","(1, 13)",5,76,93,174,3,154,152,309
735,0.16,"(25, 28)","(8, 10)",6,73,87,166,7,114,116,237
736,0.08,"(18, 16)","(13, 9)",5,70,29,104,5,44,44,93
737,0.14,"(15, 22)","(25, 1)",5,112,221,338,7,98,100,205
738,0.1,"(27, 1)","(28, 27)",3,94,136,233,8,112,115,235
739,0.14,"(16, 27)","(9, 2)",12,88,111,211,15,71,81,167
740,0.12,"(12, 12)","(6, 19)",8,82,43,133,4,24,23,51
741,0.12,"(15, 7)","(15, 15)",9,103,214,326,6,49,50,105
742,0.1,"(27, 13)","(12, 19)",8,94,139,241,9,139,143,291
743,0.18,"(8, 23)","(15, 21)",5,70,67,142,12,23,30,65
744,0.06,"(6, 13)","(10, 11)",14,82,134,230,3,19,17,39
745,0.08,"(21, 2)","(29, 16)",8,106,140,254,6,117,118,241
746,0.06,"(2, 26)","(16, 29)",6,85,89,180,17,84,96,197
747,0.18,"(14, 21)","(14, 18)",10,73,68,151,9,16,20,45
748,0.06,"(21, 13)","(25, 10)",5,73,47,125,3,82,80,165
749,0.12,"(4, 15)","(25, 5)",7,85,265,357,4,105,104,213
750,0.18,"(21, 0)","(11, 7)",7,76,50,133,2,56,53,111
751,0.18,"(19, 16)","(27, 16)",4,100,106,210,5,131,131,267
752,0.02,"(26, 13)","(25, 1)",2,70,74,146,5,41,41,87
753,0.14,"(11, 10)","(21, 12)",12,67,51,130,18,62,75,155
754,0.06,"(15, 22)","(6, 3)",9,166,185,360,7,97,99,203
755,0.06,"(24, 3)","(18, 10)",5,97,67,169,6,51,52,109
756,0.04,"(22, 6)","(6, 7)",7,79,84,170,8,89,92,189
757,0.18,"(6, 21)","(21, 16)",10,82,183,275,14,91,100,205
758,0.02,"(23, 26)","(11, 23)",8,121,112,241,6,107,108,221
759,0.16,"(27, 0)","(29, 16)",3,61,42,106,3,48,46,97
760,0.08,"(29, 25)","(7, 13)",11,88,172,271,10,58,63,131
761,0.14,"(23, 19)","(6, 27)",12,70,108,190,10,77,82,169
762,0.02,"(29, 3)","(5, 18)",6,172,291,469,8,143,146,297
763,0.16,"(12, 23)","(4, 29)",9,70,77,156,6,95,96,197
764,0.04,"(23, 10)","(29, 13)",10,91,73,174,8,61,64,133
765,0.16,"(13, 18)","(14, 19)",8,61,11,80,4,6,5,15
766,0.12,"(23, 29)","(9, 13)",5,100,129,234,5,79,79,163
767,0.04,"(19, 9)","(10, 0)",5,88,86,179,3,40,38,81
768,0.1,"(24, 24)","(27, 7)",7,91,136,234,13,146,154,313
769,0.14,"(17, 22)","(22, 17)",10,91,121,222,14,37,46,97
770,0.06,"(20, 24)","(11, 11)",12,67,45,124,8,36,39,83
771,0.02,"(9, 1)","(12, 17)",11,145,144,300,3,105,103,211
772,0.06,"(14, 20)","(18, 21)",6,82,39,127,5,59,59,123
773,0.14,"(23, 5)","(24, 24)",13,88,228,329,5,318,318,641
774,0.16,"(28, 4)","(10, 25)",12,100,133,245,4,72,71,147
775,0.02,"(2, 2)","(20, 11)",12,64,67,143,16,219,230,465
776,0.12,"(14, 23)","(27, 26)",4,91,105,200,7,55,57,119
777,0.04,"(27, 9)","(23, 6)",6,139,162,307,10,46,51,107
778,0.16,"(21, 18)","(14, 13)",5,70,32,107,7,38,40,85
779,0.06,"(28, 6)","(13, 1)",14,142,172,328,5,161,161,327
780,0.18,"(9, 11)","(19, 0)",5,106,168,279,9,62,66,137
781,0.2,"(4, 16)","(14, 5)",9,76,88,173,29,72,96,197
782,0.06,"(19, 20)","(11, 21)",3,67,18,88,5,28,28,61
783,0.02,"(18, 18)","(20, 29)",5,109,214,328,6,89,90,185
784,0.18,"(18, 27)","(5, 9)",8,91,176,275,5,76,76,157
785,0.2,"(9, 17)","(12, 19)",5,91,84,180,8,75,78,161
786,0.18,"(25, 13)","(16, 0)",6,82,136,224,8,124,127,259
787,0.1,"(23, 12)","(5, 6)",6,124,148,278,4,76,75,155
788,0.12,"(18, 27)","(24, 10)",6,88,155,249,9,114,118,241
789,0.14,"(25, 22)","(0, 11)",5,82,120,207,6,85,86,177
790,0.08,"(20, 4)","(9, 21)",6,100,112,218,13,151,159,323
791,0.1,"(15, 9)","(25, 18)",6,103,165,274,19,152,166,337
792,0.18,"(23, 21)","(13, 3)",15,85,101,201,8,112,115,235
793,0.08,"(27, 19)","(13, 3)",12,100,119,231,5,93,93,191
794,0.14,"(17, 26)","(14, 26)",6,64,15,85,10,23,28,61
795,0.2,"(9, 20)","(23, 7)",6,82,182,270,16,67,78,161
796,0.18,"(8, 18)","(0, 3)",5,73,130,208,18,131,144,293
797,0.04,"(21, 0)","(25, 23)",3,85,70,158,4,95,94,193
798,0.2,"(7, 6)","(29, 1)",6,91,111,208,10,460,465,935
799,0.08,"(0, 27)","(27, 13)",26,94,162,282,11,75,81,167
800,0.08,"(6, 28)","(23, 12)",9,97,109,215,8,101,104,213
801,0.02,"(25, 11)","(27, 3)",7,85,54,146,6,107,108,221
802,0.2,"(9, 22)","(6, 26)",29,76,63,168,11,66,72,149
803,0.06,"(1, 24)","(19, 15)",9,64,73,146,9,128,132,269
804,0.2,"(18, 19)","(18, 14)",8,70,40,118,4,72,71,147
805,0.2,"(10, 9)","(1, 24)",8,100,203,311,18,316,329,663
806,0.12,"(10, 20)","(28, 5)",5,73,69,147,10,77,82,169
807,0.04,"(29, 27)","(7, 12)",11,88,110,209,9,65,69,143
808,0.06,"(27, 2)","(7, 0)",4,85,64,153,14,101,110,225
809,0.1,"(14, 20)","(24, 7)",11,79,127,217,7,164,166,337
810,0.08,"(29, 20)","(7, 18)",7,88,202,297,9,66,70,145
811,0.06,"(9, 5)","(17, 29)",6,76,121,203,5,69,69,143
812,0.02,"(20, 25)","(21, 4)",9,82,69,160,13,133,141,287
813,0.16,"(8, 14)","(10, 11)",6,79,87,172,5,31,31,67
814,0.18,"(29, 27)","(28, 16)",9,64,46,119,8,68,71,147
815,0.16,"(19, 24)","(6, 9)",4,109,248,361,11,106,112,229
816,0.16,"(10, 22)","(3, 14)",9,88,63,160,7,101,103,211
817,0.12,"(0, 20)","(28, 18)",3,97,142,242,3,76,74,153
818,0.16,"(2, 17)","(23, 13)",9,79,87,175,5,103,103,211
819,0.02,"(18, 21)","(10, 2)",6,76,60,142,18,94,107,219
820,0.02,"(11, 7)","(3, 25)",3,97,160,260,4,123,122,249
821,0.1,"(4, 16)","(5, 15)",13,64,18,95,10,17,22,49
822,0.06,"(22, 24)","(9, 25)",10,79,88,177,5,73,73,151
823,0.14,"(25, 6)","(19, 11)",4,73,80,157,7,67,69,143
824,0.1,"(27, 4)","(25, 13)",5,70,31,106,8,40,43,91
825,0.12,"(28, 29)","(14, 15)",3,91,98,192,4,223,222,449
826,0.02,"(28, 2)","(11, 4)",5,61,25,91,9,111,115,235
827,0.08,"(20, 23)","(27, 26)",28,73,66,167,9,59,63,131
828,0.04,"(24, 12)","(7, 26)",8,97,125,230,11,89,95,195
829,0.1,"(28, 18)","(21, 26)",11,94,63,168,6,70,71,147
830,0.12,"(6, 22)","(23, 21)",4,97,133,234,7,114,116,237
831,0.2,"(0, 27)","(3, 29)",6,70,21,97,5,29,29,63
832,0.08,"(27, 16)","(1, 17)",13,82,89,184,4,53,52,109
833,0.06,"(27, 16)","(18, 2)",6,106,216,328,5,93,93,191
834,0.04,"(2, 17)","(29, 13)",7,64,77,148,20,127,142,289
835,0.08,"(8, 6)","(18, 11)",6,106,119,231,4,89,88,181
836,0.1,"(16, 14)","(7, 1)",5,85,129,219,7,61,63,131
837,0.08,"(26, 7)","(17, 28)",17,100,205,322,11,134,140,285
838,0.16,"(17, 29)","(11, 7)",21,97,134,252,5,64,64,133
839,0.1,"(11, 4)","(20, 10)",7,85,92,184,7,60,62,129
840,0.2,"(29, 7)","(9, 4)",12,109,151,272,5,100,100,205
841,0.08,"(9, 20)","(15, 17)",6,67,60,133,7,35,37,79
842,0.04,"(10, 11)","(7, 23)",6,100,110,216,6,183,184,373
843,0.04,"(5, 15)","(4, 4)",9,67,30,106,9,186,190,385
844,0.2,"(3, 28)","(10, 28)",6,67,38,111,6,90,91,187
845,0.16,"(10, 11)","(23, 22)",5,112,300,417,10,123,128,261
846,0.08,"(22, 6)","(10, 9)",4,76,89,169,4,56,55,115
847,0.08,"(4, 19)","(16, 26)",4,109,141,254,5,139,139,283
848,0.02,"(6, 20)","(23, 26)",21,139,286,446,8,137,140,285
849,0.16,"(9, 19)","(16, 22)",7,76,75,158,4,89,88,181
850,0.04,"(11, 9)","(21, 9)",3,103,104,210,3,126,124,253
851,0.18,"(13, 16)","(3, 9)",6,73,51,130,7,49,51,107
852,0.14,"(27, 8)","(25, 25)",6,97,116,219,6,69,70,145
853,0.14,"(22, 22)","(25, 27)",20,79,60,159,6,74,75,155
854,0.12,"(24, 25)","(16, 25)",13,67,28,108,6,48,49,103
855,0.1,"(10, 2)","(12, 15)",14,109,279,402,10,86,91,187
856,0.08,"(0, 24)","(20, 9)",6,91,106,203,15,56,66,137
857,0.06,"(24, 24)","(16, 17)",4,103,95,202,2,77,74,153
858,0.1,"(26, 24)","(1, 24)",4,64,40,108,5,75,75,155
859,0.14,"(10, 12)","(5, 19)",10,88,134,232,7,121,123,251
860,0.2,"(28, 26)","(5, 11)",3,106,270,379,7,76,78,161
861,0.04,"(16, 17)","(13, 13)",13,61,36,110,14,222,231,467
862,0.12,"(6, 10)","(3, 26)",2,82,135,219,3,139,137,279
863,0.16,"(7, 28)","(8, 25)",5,76,52,133,13,54,62,129
864,0.1,"(21, 25)","(23, 8)",17,70,53,140,19,53,67,139
865,0.16,"(9, 20)","(26, 29)",9,76,184,269,4,124,123,251
866,0.02,"(17, 0)","(28, 21)",8,73,110,191,6,80,81,167
867,0.2,"(13, 21)","(27, 13)",5,103,213,321,16,167,178,361
868,0.16,"(13, 1)","(1, 6)",4,70,32,106,5,76,76,157
869,0.16,"(19, 3)","(28, 16)",5,82,153,240,17,168,180,365
870,0.02,"(16, 25)","(1, 18)",10,121,203,334,12,122,129,263
871,0.08,"(22, 28)","(12, 26)",4,64,18,86,6,31,32,69
872,0.18,"(2, 27)","(28, 11)",11,97,223,331,10,58,63,131
873,0.08,"(4, 0)","(26, 8)",5,124,250,379,4,117,116,237
874,0.14,"(8, 13)","(20, 17)",8,76,54,138,5,103,103,211
875,0.18,"(29, 2)","(28, 6)",4,67,25,96,4,13,12,29
876,0.16,"(29, 13)","(22, 9)",5,82,34,121,3,47,45,95
877,0.2,"(0, 18)","(15, 7)",21,97,339,457,7,127,129,263
878,0.04,"(21, 10)","(21, 2)",3,79,89,171,12,55,62,129
879,0.18,"(16, 20)","(19, 25)",8,85,97,190,4,46,45,95
880,0.12,"(19, 29)","(17, 3)",4,85,109,198,11,143,149,303
881,0.16,"(14, 2)","(0, 29)",10,61,63,134,13,100,108,221
882,0.16,"(14, 7)","(17, 24)",11,85,134,230,2,45,42,89
883,0.04,"(17, 4)","(2, 15)",8,100,75,183,6,119,120,245
884,0.12,"(29, 2)","(23, 14)",8,79,108,195,5,36,36,77
885,0.08,"(0, 22)","(21, 9)",14,100,100,214,5,215,215,435
886,0.1,"(14, 25)","(13, 8)",6,64,44,114,6,43,44,93
887,0.04,"(18, 7)","(4, 9)",4,94,86,184,6,146,147,299
888,0.12,"(10, 5)","(7, 3)",6,76,35,117,9,22,26,57
889,0.04,"(22, 26)","(28, 6)",5,82,90,177,3,85,83,171
890,0.14,"(25, 10)","(14, 13)",6,82,40,128,7,56,58,121
891,0.18,"(22, 6)","(13, 26)",22,70,90,182,9,56,60,125
892,0.18,"(2, 2)","(11, 6)",9,94,76,179,11,67,73,151
893,0.16,"(5, 0)","(0, 5)",6,64,21,91,5,149,149,303
894,0.06,"(4, 8)","(18, 23)",9,70,56,135,6,92,93,191
895,0.12,"(6, 27)","(27, 28)",6,76,68,150,4,228,227,459
896,0.12,"(25, 1)","(22, 9)",19,79,57,155,6,52,53,111
897,0.18,"(7, 26)","(13, 0)",6,88,208,302,5,84,84,173
898,0.16,"(28, 21)","(9, 26)",11,97,211,319,4,112,111,227
899,0.04,"(6, 1)","(4, 10)",3,88,96,187,3,64,62,129
900,0.08,"(6, 1)","(12, 27)",17,94,137,248,3,81,79,163
901,0.06,"(14, 25)","(9, 19)",7,67,28,102,10,164,169,343
902,0.14,"(21, 22)","(22, 0)",6,79,107,192,12,136,143,291
903,0.2,"(13, 9)","(10, 10)",8,61,25,94,6,46,47,99
904,0.04,"(12, 14)","(7, 18)",4,196,485,685,5,66,66,137
905,0.12,"(7, 21)","(18, 22)",6,103,168,277,13,86,94,193
906,0.12,"(6, 15)","(1, 8)",4,61,17,82,11,65,71,147
907,0.16,"(8, 28)","(7, 8)",5,121,367,493,10,84,89,183
908,0.04,"(12, 1)","(7, 2)",2,70,17,89,7,74,76,157
909,0.04,"(22, 26)","(19, 23)",8,70,29,107,10,47,52,109
910,0.08,"(6, 7)","(11, 12)",9,82,42,133,10,59,64,133
911,0.2,"(2, 11)","(19, 27)",5,88,209,302,10,134,139,283
912,0.1,"(8, 14)","(3, 17)",5,79,37,121,6,32,33,71
913,0.1,"(29, 20)","(27, 17)",4,61,20,85,9,77,81,167
914,0.1,"(25, 21)","(16, 15)",10,70,46,126,9,149,153,311
915,0.12,"(9, 11)","(25, 11)",3,70,98,171,10,93,98,201
916,0.04,"(29, 2)","(19, 16)",6,106,163,275,4,139,138,281
917,0.08,"(20, 9)","(5, 24)",17,79,67,163,4,73,72,149
918,0.18,"(1, 3)","(24, 19)",6,100,225,331,7,54,56,117
919,0.1,"(19, 27)","(11, 4)",13,115,123,251,13,52,60,125
920,0.16,"(28, 8)","(3, 12)",9,79,66,154,5,112,112,229
921,0.02,"(16, 14)","(6, 29)",3,91,155,249,7,93,95,195
922,0.1,"(5, 21)","(20, 27)",19,100,93,212,13,54,62,129
923,0.2,"(20, 3)","(23, 17)",5,88,91,184,4,68,67,139
924,0.08,"(2, 2)","(11, 19)",9,115,143,267,11,117,123,251
925,0.1,"(2, 20)","(27, 15)",6,115,150,271,5,76,76,157
926,0.04,"(28, 26)","(26, 12)",5,70,48,123,5,30,30,65
927,0.14,"(8, 4)","(5, 16)",5,76,36,117,4,39,38,81
928,0.18,"(23, 29)","(3, 19)",5,88,116,209,5,91,91,187
929,0.1,"(28, 2)","(5, 27)",16,94,137,247,6,79,80,165
930,0.04,"(18, 27)","(26, 22)",10,70,52,132,6,112,113,231
931,0.18,"(2, 22)","(25, 11)",4,94,214,312,16,101,112,229
932,0.02,"(10, 23)","(12, 3)",4,82,65,151,10,119,124,253
933,0.1,"(14, 16)","(27, 21)",5,76,123,204,14,174,183,371
934,0.1,"(5, 2)","(12, 2)",9,88,66,163,12,177,184,373
935,0.2,"(13, 24)","(2, 13)",11,64,37,112,12,78,85,175
936,0.02,"(15, 7)","(16, 25)",18,136,219,373,17,95,107,219
937,0.14,"(19, 13)","(14, 6)",7,79,43,129,32,50,77,159
938,0.06,"(6, 24)","(18, 11)",9,94,94,197,6,53,54,113
939,0.14,"(15, 11)","(14, 4)",9,82,85,176,4,34,33,71
940,0.18,"(8, 26)","(5, 12)",12,82,77,171,4,163,162,329
941,0.06,"(24, 12)","(1, 0)",9,64,57,130,4,86,85,175
942,0.04,"(23, 28)","(28, 11)",12,112,109,233,32,105,132,269
943,0.06,"(14, 24)","(19, 9)",6,112,152,270,3,59,57,119
944,0.04,"(14, 5)","(8, 28)",8,112,184,304,8,101,104,213
945,0.02,"(28, 27)","(0, 20)",3,121,112,236,8,61,64,133
946,0.14,"(18, 13)","(3, 18)",7,109,175,291,13,123,131,267
947,0.16,"(24, 10)","(7, 7)",6,112,129,247,4,171,170,345
948,0.2,"(29, 26)","(20, 14)",10,64,48,122,2,36,33,71
949,0.2,"(14, 29)","(13, 24)",6,94,71,171,5,18,18,41
950,0.14,"(9, 11)","(14, 6)",17,85,76,178,11,36,42,89
951,0.08,"(12, 26)","(29, 24)",4,67,81,152,6,164,165,335
952,0.04,"(28, 29)","(14, 3)",25,97,137,259,7,136,138,281
953,0.08,"(29, 0)","(18, 26)",6,112,341,459,6,95,96,197
954,0.18,"(20, 29)","(8, 1)",7,73,85,165,3,130,128,261
955,0.02,"(6, 24)","(24, 20)",7,142,287,436,5,206,206,417
956,0.16,"(24, 10)","(15, 20)",6,76,72,154,7,45,47,99
957,0.12,"(21, 16)","(5, 27)",10,85,91,186,5,156,156,317
958,0.06,"(16, 2)","(14, 5)",5,70,63,138,6,55,56,117
959,0.08,"(5, 16)","(3, 10)",4,85,122,211,5,36,36,77
960,0.1,"(24, 25)","(7, 23)",10,94,73,177,10,79,84,173
961,0.02,"(6, 3)","(12, 15)",9,97,94,200,9,132,136,277
962,0.18,"(11, 0)","(10, 4)",13,61,29,103,7,10,12,29
963,0.18,"(21, 20)","(18, 25)",11,82,62,155,20,39,54,113
964,0.18,"(11, 23)","(11, 16)",5,64,39,108,4,39,38,81
965,0.2,"(6, 12)","(10, 1)",9,82,84,175,8,62,65,135
966,0.04,"(8, 23)","(16, 12)",10,112,138,260,4,89,88,181
967,0.06,"(5, 24)","(25, 5)",5,109,174,288,9,57,61,127
968,0.02,"(18, 11)","(14, 14)",5,166,186,357,9,103,107,219
969,0.2,"(22, 16)","(0, 10)",6,70,43,119,9,171,175,355
970,0.14,"(16, 14)","(26, 14)",5,85,82,172,4,49,48,101
971,0.08,"(8, 6)","(17, 17)",9,91,109,209,9,101,105,215
972,0.2,"(5, 8)","(2, 11)",5,70,39,114,6,10,11,27
973,0.1,"(7, 19)","(11, 16)",14,85,62,161,8,25,28,61
974,0.08,"(22, 14)","(23, 23)",10,88,94,192,7,70,72,149
975,0.14,"(3, 11)","(4, 18)",8,67,42,117,5,59,59,123
976,0.12,"(19, 17)","(15, 13)",8,82,101,191,6,45,46,97
977,0.18,"(26, 8)","(27, 8)",8,67,20,95,8,1,8,17
978,0.1,"(0, 9)","(1, 21)",12,76,73,161,12,58,65,135
979,0.14,"(23, 8)","(4, 8)",15,97,110,222,7,73,75,155
980,0.16,"(23, 18)","(27, 25)",7,76,44,127,13,36,44,93
981,0.14,"(8, 2)","(20, 24)",4,76,121,201,23,76,94,193
982,0.18,"(14, 8)","(24, 16)",4,127,196,327,4,179,178,361
983,0.16,"(17, 3)","(8, 28)",4,91,171,266,3,76,74,153
984,0.1,"(12, 25)","(21, 29)",4,91,86,181,8,130,133,271
985,0.18,"(23, 0)","(0, 27)",12,70,70,152,5,137,137,279
986,0.14,"(12, 4)","(7, 29)",4,91,120,215,7,75,77,159
987,0.02,"(24, 24)","(23, 15)",4,76,40,120,14,80,89,183
988,0.08,"(1, 27)","(8, 29)",6,91,90,187,22,53,70,145
989,0.18,"(5, 9)","(13, 5)",6,61,36,103,6,131,132,269
990,0.18,"(15, 8)","(3, 13)",6,70,71,147,10,84,89,183
991,0.2,"(26, 1)","(10, 16)",6,79,120,205,5,36,36,77
992,0.06,"(27, 5)","(1, 14)",10,82,118,210,14,103,112,229
993,0.04,"(14, 25)","(26, 23)",16,94,99,209,7,81,83,171
994,0.12,"(12, 14)","(16, 14)",9,100,100,209,4,8,7,19
995,0.06,"(8, 26)","(20, 17)",5,76,75,156,16,98,109,223
996,0.04,"(18, 26)","(8, 7)",7,103,147,257,4,177,176,357
997,0.12,"(2, 15)","(17, 25)",4,70,53,127,6,94,95,195
998,0.2,"(20, 25)","(2, 25)",6,94,86,186,5,232,232,469
999,0.16,"(14, 20)","(17, 24)",10,70,64,144,14,95,104,213
,,,,,,,,,,,
,,,,8.437,88.438,110.21,207.085,8.104,94.937,98.045,201.086
