test,alpha,bot_pos,rat_pos,neighbor_sensings_1,ping_tries_1,move_tries_1,total_actions_1,neighbor_sensings_2,ping_tries_2,move_tries_2,total_actions_2
0,0.12,"(29, 16)","(18, 0)",16,98,113,227,7,91,145,243
1,0.16,"(4, 2)","(4, 25)",6,109,114,229,5,91,78,174
2,0.08,"(26, 29)","(16, 7)",16,70,85,171,7,91,144,242
3,0.1,"(20, 16)","(11, 3)",21,43,63,127,4,71,63,138
4,0.1,"(14, 23)","(5, 29)",12,95,106,213,7,41,108,156
5,0.08,"(28, 22)","(17, 9)",9,133,141,283,9,81,98,188
6,0.16,"(16, 11)","(27, 24)",9,149,157,315,11,61,106,178
7,0.04,"(7, 7)","(24, 14)",7,63,69,139,5,101,118,224
8,0.16,"(28, 11)","(5, 28)",10,60,69,139,4,41,73,118
9,0.2,"(13, 23)","(4, 21)",10,106,115,231,7,41,25,73
10,0.14,"(26, 9)","(7, 27)",7,60,66,133,4,81,165,250
11,0.02,"(18, 19)","(6, 16)",7,114,120,241,6,91,54,151
12,0.02,"(27, 12)","(3, 3)",7,184,190,381,5,161,217,383
13,0.08,"(8, 25)","(29, 14)",7,123,129,259,4,61,102,167
14,0.14,"(21, 24)","(15, 26)",6,151,156,313,3,71,49,123
15,0.08,"(6, 1)","(9, 13)",4,17,20,41,6,51,38,95
16,0.18,"(23, 23)","(27, 23)",4,113,116,233,6,51,54,111
17,0.04,"(27, 25)","(11, 8)",4,174,177,355,7,131,178,316
18,0.1,"(29, 10)","(1, 22)",5,74,78,157,10,41,74,125
19,0.18,"(24, 27)","(1, 10)",11,71,81,163,9,141,287,437
20,0.08,"(25, 29)","(11, 21)",14,123,136,273,3,121,137,261
21,0.1,"(0, 18)","(22, 25)",6,125,130,261,5,101,135,241
22,0.2,"(13, 10)","(29, 15)",7,60,66,133,24,61,118,203
23,0.14,"(11, 2)","(2, 5)",4,109,112,225,7,61,48,116
24,0.14,"(13, 3)","(20, 11)",18,99,116,233,12,61,85,158
25,0.2,"(15, 1)","(28, 29)",12,86,97,195,5,31,109,145
26,0.2,"(1, 23)","(5, 10)",9,88,96,193,7,61,41,109
27,0.1,"(0, 25)","(19, 14)",10,113,122,245,7,51,134,192
28,0.14,"(4, 16)","(9, 3)",4,69,72,145,19,71,152,242
29,0.06,"(28, 28)","(6, 27)",3,76,78,157,4,81,70,155
30,0.14,"(9, 22)","(12, 3)",4,100,103,207,3,61,103,167
31,0.08,"(19, 24)","(6, 22)",7,111,117,235,11,141,118,270
32,0.06,"(19, 19)","(26, 10)",6,84,89,179,16,101,139,256
33,0.1,"(28, 8)","(18, 7)",7,61,67,135,5,31,31,67
34,0.1,"(4, 11)","(9, 13)",8,66,73,147,9,61,71,141
35,0.08,"(6, 10)","(25, 0)",8,150,157,315,7,51,109,167
36,0.16,"(6, 9)","(24, 4)",5,92,96,193,8,121,197,326
37,0.04,"(11, 26)","(23, 7)",4,85,88,177,9,81,119,209
38,0.1,"(22, 4)","(11, 25)",22,68,89,179,21,71,114,206
39,0.18,"(17, 8)","(18, 21)",17,103,119,239,10,31,57,98
40,0.16,"(17, 1)","(26, 18)",4,159,162,325,4,111,160,275
41,0.16,"(3, 29)","(4, 20)",8,100,107,215,6,81,74,161
42,0.12,"(7, 13)","(0, 5)",11,199,209,419,7,91,118,216
43,0.08,"(10, 11)","(9, 4)",8,65,72,145,20,71,57,148
44,0.04,"(6, 20)","(28, 26)",18,77,94,189,18,91,114,223
45,0.04,"(13, 17)","(7, 29)",21,105,125,251,9,181,211,401
46,0.12,"(8, 15)","(14, 2)",5,75,79,159,12,71,83,166
47,0.2,"(2, 16)","(17, 24)",6,112,117,235,9,61,125,195
48,0.06,"(11, 18)","(2, 15)",7,48,54,109,3,31,26,60
49,0.18,"(10, 9)","(3, 9)",6,106,111,223,3,41,21,65
50,0.2,"(19, 24)","(13, 3)",8,119,126,253,9,91,262,362
51,0.18,"(17, 1)","(14, 14)",16,86,101,203,9,111,217,337
52,0.08,"(20, 18)","(7, 27)",5,126,130,261,5,81,67,153
53,0.02,"(3, 17)","(4, 12)",11,191,201,403,8,141,93,242
54,0.14,"(10, 15)","(16, 8)",11,107,117,235,13,61,108,182
55,0.14,"(25, 27)","(7, 19)",4,112,115,231,8,81,195,284
56,0.1,"(21, 23)","(4, 22)",19,80,98,197,7,61,111,179
57,0.14,"(9, 2)","(29, 7)",8,144,151,303,10,81,140,231
58,0.06,"(19, 8)","(17, 9)",5,23,27,55,3,41,13,57
59,0.02,"(4, 10)","(14, 14)",6,160,165,331,4,391,315,710
60,0.08,"(15, 6)","(26, 9)",9,47,55,111,4,101,142,247
61,0.18,"(29, 8)","(16, 16)",2,82,83,167,3,131,226,360
62,0.12,"(14, 8)","(23, 11)",6,77,82,165,5,101,233,339
63,0.06,"(25, 9)","(23, 4)",8,49,56,113,13,91,52,156
64,0.06,"(4, 8)","(4, 16)",10,152,161,323,5,91,59,155
65,0.2,"(25, 25)","(24, 17)",23,109,131,263,17,91,82,190
66,0.04,"(2, 0)","(20, 14)",5,130,134,269,7,181,155,343
67,0.02,"(0, 16)","(20, 12)",2,73,74,149,2,201,341,544
68,0.18,"(28, 28)","(27, 2)",6,150,155,311,7,61,172,240
69,0.1,"(14, 5)","(7, 22)",7,105,111,223,15,101,109,225
70,0.12,"(1, 23)","(21, 2)",3,80,82,165,2,71,108,181
71,0.14,"(6, 4)","(5, 28)",3,92,94,189,8,51,169,228
72,0.04,"(18, 8)","(27, 0)",4,133,136,273,13,61,85,159
73,0.12,"(29, 12)","(15, 4)",5,95,99,199,20,81,70,171
74,0.1,"(14, 29)","(28, 14)",2,74,75,151,4,81,120,205
75,0.04,"(3, 2)","(3, 4)",14,35,48,97,12,51,40,103
76,0.1,"(1, 13)","(5, 1)",5,114,118,237,6,41,80,127
77,0.04,"(29, 8)","(27, 23)",16,46,61,123,11,71,66,148
78,0.16,"(7, 5)","(10, 15)",6,107,112,225,10,41,55,106
79,0.02,"(14, 15)","(26, 3)",7,127,133,267,8,161,163,332
80,0.06,"(12, 28)","(6, 15)",8,85,92,185,5,121,130,256
81,0.08,"(6, 3)","(14, 25)",11,74,84,169,3,81,99,183
82,0.1,"(12, 6)","(1, 19)",5,130,134,269,3,81,59,143
83,0.1,"(26, 24)","(8, 14)",9,28,36,73,12,41,66,119
84,0.02,"(1, 7)","(18, 1)",4,151,154,309,8,71,151,230
85,0.08,"(3, 20)","(12, 29)",4,98,101,203,8,61,84,153
86,0.14,"(1, 27)","(3, 18)",5,63,67,135,4,81,85,170
87,0.12,"(9, 17)","(28, 15)",6,104,109,219,10,61,69,140
88,0.1,"(20, 19)","(8, 29)",16,82,97,195,7,41,111,159
89,0.16,"(27, 9)","(12, 14)",9,93,101,203,11,71,192,274
90,0.14,"(7, 27)","(13, 22)",8,12,19,39,7,61,53,121
91,0.14,"(16, 25)","(20, 19)",6,80,85,171,13,71,89,173
92,0.2,"(4, 10)","(7, 15)",21,95,115,231,8,61,46,115
93,0.12,"(21, 5)","(15, 5)",4,8,11,23,8,51,21,80
94,0.02,"(8, 4)","(16, 25)",7,102,108,217,6,91,114,211
95,0.04,"(8, 22)","(13, 2)",6,66,71,143,5,131,129,265
96,0.08,"(19, 28)","(24, 0)",7,108,114,229,3,111,146,260
97,0.02,"(27, 16)","(28, 8)",4,92,95,191,2,91,82,175
98,0.1,"(21, 15)","(4, 4)",6,100,105,211,9,81,112,202
99,0.1,"(17, 1)","(29, 2)",5,84,88,177,4,41,77,122
100,0.04,"(16, 1)","(21, 21)",11,178,188,377,8,61,66,135
101,0.02,"(1, 14)","(2, 16)",3,32,34,69,3,101,29,133
102,0.08,"(20, 20)","(17, 29)",6,117,122,245,5,51,146,202
103,0.12,"(29, 15)","(17, 15)",9,71,79,159,4,71,38,113
104,0.18,"(27, 0)","(6, 18)",17,42,58,117,12,111,255,378
105,0.16,"(22, 28)","(0, 4)",4,58,61,123,3,31,64,98
106,0.08,"(23, 21)","(26, 21)",14,176,189,379,4,51,53,108
107,0.02,"(27, 20)","(26, 24)",4,61,64,129,10,131,80,221
108,0.06,"(23, 17)","(12, 14)",8,63,70,141,4,61,57,122
109,0.12,"(5, 19)","(29, 11)",9,74,82,165,5,51,97,153
110,0.08,"(12, 22)","(9, 20)",7,81,87,175,11,41,17,69
111,0.12,"(26, 8)","(19, 14)",3,21,23,47,6,21,35,62
112,0.02,"(18, 14)","(12, 18)",7,163,169,339,8,231,198,437
113,0.06,"(22, 3)","(29, 17)",4,105,108,217,6,71,101,178
114,0.14,"(15, 4)","(22, 17)",7,83,89,179,3,61,161,225
115,0.08,"(3, 20)","(27, 4)",17,53,69,139,4,81,149,234
116,0.12,"(17, 18)","(24, 15)",10,75,84,169,22,71,207,300
117,0.06,"(9, 29)","(2, 6)",8,133,140,281,6,41,108,155
118,0.06,"(6, 15)","(26, 29)",15,134,148,297,9,61,147,217
119,0.02,"(8, 20)","(5, 3)",6,77,82,165,4,131,50,185
120,0.2,"(24, 14)","(14, 15)",2,70,71,143,3,31,16,50
121,0.16,"(23, 9)","(2, 22)",9,68,76,153,5,71,96,172
122,0.18,"(0, 3)","(25, 5)",9,113,121,243,10,51,168,229
123,0.18,"(29, 4)","(29, 24)",5,98,102,205,4,91,146,241
124,0.04,"(22, 27)","(28, 18)",46,112,157,315,6,61,107,174
125,0.08,"(27, 11)","(14, 9)",4,86,89,179,7,51,75,133
126,0.18,"(23, 25)","(24, 24)",5,20,24,49,4,11,5,20
127,0.02,"(27, 28)","(19, 17)",10,206,215,431,5,121,122,248
128,0.14,"(0, 26)","(28, 22)",2,112,113,227,3,51,120,174
129,0.04,"(22, 20)","(25, 19)",9,43,51,103,3,141,113,257
130,0.08,"(13, 20)","(25, 10)",24,84,107,215,15,41,97,153
131,0.2,"(26, 0)","(24, 20)",6,114,119,239,6,111,279,396
132,0.1,"(25, 27)","(20, 19)",5,40,44,89,10,81,98,189
133,0.18,"(14, 5)","(26, 21)",15,80,94,189,7,51,127,185
134,0.14,"(14, 13)","(28, 29)",4,133,136,273,11,21,46,78
135,0.04,"(9, 19)","(26, 14)",5,64,68,137,9,161,177,347
136,0.16,"(1, 0)","(9, 27)",8,91,98,197,7,111,159,277
137,0.02,"(13, 3)","(5, 2)",6,29,34,69,5,151,91,247
138,0.12,"(5, 19)","(9, 26)",8,95,102,205,19,91,127,237
139,0.04,"(24, 29)","(6, 20)",6,94,99,199,11,51,62,124
140,0.06,"(10, 12)","(21, 2)",5,104,108,217,11,111,169,291
141,0.2,"(19, 12)","(15, 26)",5,145,149,299,4,51,93,148
142,0.14,"(23, 4)","(2, 29)",13,76,88,177,9,131,267,407
143,0.04,"(14, 15)","(8, 6)",3,42,44,89,8,81,61,150
144,0.16,"(0, 4)","(4, 8)",4,34,37,75,6,61,62,129
145,0.18,"(19, 19)","(24, 5)",3,99,101,203,4,51,103,158
146,0.16,"(26, 10)","(21, 29)",4,189,192,385,6,131,169,306
147,0.04,"(7, 11)","(1, 12)",7,32,38,77,7,111,42,160
148,0.1,"(6, 15)","(16, 8)",3,151,153,307,2,61,113,176
149,0.2,"(28, 20)","(25, 5)",5,87,91,183,7,71,157,235
150,0.14,"(27, 6)","(21, 29)",9,218,226,453,5,101,140,246
151,0.04,"(15, 2)","(18, 1)",6,102,107,215,13,121,51,185
152,0.2,"(18, 1)","(5, 26)",4,102,105,211,5,61,110,176
153,0.02,"(19, 18)","(23, 12)",9,55,63,127,3,141,190,334
154,0.18,"(16, 29)","(6, 3)",15,89,103,207,6,51,75,132
155,0.02,"(19, 26)","(16, 6)",6,131,136,273,4,151,189,344
156,0.16,"(16, 2)","(21, 21)",5,134,138,277,4,81,145,230
157,0.14,"(4, 13)","(1, 26)",4,91,94,189,4,91,88,183
158,0.14,"(19, 1)","(6, 22)",6,116,121,243,6,91,188,285
159,0.04,"(10, 1)","(8, 16)",14,86,99,199,3,191,145,339
160,0.02,"(0, 4)","(4, 29)",6,205,210,421,3,11,34,48
161,0.06,"(28, 19)","(5, 14)",4,116,119,239,6,81,71,158
162,0.12,"(9, 10)","(21, 17)",8,73,80,161,7,81,146,234
163,0.14,"(29, 6)","(21, 2)",2,193,194,389,5,51,50,106
164,0.12,"(12, 11)","(17, 20)",5,16,20,41,8,41,57,106
165,0.02,"(29, 24)","(5, 4)",11,100,110,221,5,161,107,273
166,0.16,"(10, 28)","(8, 4)",9,77,85,171,5,81,139,225
167,0.14,"(3, 7)","(15, 20)",7,89,95,191,8,111,232,351
168,0.02,"(7, 13)","(10, 14)",6,27,32,65,5,141,67,213
169,0.14,"(10, 29)","(3, 17)",2,116,117,235,3,51,36,90
170,0.08,"(1, 23)","(26, 29)",6,156,161,323,3,41,115,159
171,0.18,"(28, 5)","(12, 16)",8,87,94,189,12,41,175,228
172,0.18,"(27, 27)","(15, 13)",10,96,105,211,10,71,197,278
173,0.06,"(21, 20)","(3, 8)",5,55,59,119,15,111,129,255
174,0.04,"(25, 0)","(18, 26)",8,101,108,217,4,101,118,223
175,0.08,"(26, 0)","(21, 1)",26,46,71,143,17,11,32,60
176,0.18,"(15, 12)","(27, 21)",6,108,113,227,7,101,172,280
177,0.2,"(2, 14)","(21, 0)",4,87,90,181,5,31,88,124
178,0.02,"(14, 29)","(12, 14)",26,15,40,81,10,151,144,305
179,0.02,"(5, 8)","(7, 0)",7,118,124,249,6,91,113,210
180,0.06,"(19, 26)","(25, 28)",9,105,113,227,36,131,181,348
181,0.2,"(9, 24)","(25, 0)",11,66,76,153,7,21,66,94
182,0.18,"(15, 16)","(11, 27)",8,65,72,145,8,71,74,153
183,0.08,"(11, 12)","(14, 11)",11,17,27,55,11,101,129,241
184,0.16,"(2, 17)","(8, 7)",7,84,90,181,8,51,43,102
185,0.02,"(7, 0)","(17, 2)",5,78,82,165,5,141,129,275
186,0.18,"(21, 26)","(28, 11)",7,108,114,229,8,61,154,223
187,0.02,"(19, 18)","(20, 8)",4,84,87,175,8,131,216,355
188,0.04,"(2, 20)","(2, 16)",8,108,115,231,4,61,123,188
189,0.2,"(14, 17)","(28, 13)",5,112,116,233,12,51,102,165
190,0.12,"(8, 24)","(26, 26)",4,151,154,309,8,51,81,140
191,0.16,"(6, 29)","(13, 11)",12,23,34,69,11,91,145,247
192,0.12,"(25, 13)","(28, 8)",5,135,139,279,10,81,66,157
193,0.14,"(6, 8)","(7, 26)",6,104,109,219,8,101,115,224
194,0.18,"(9, 14)","(21, 4)",12,147,158,317,5,61,79,145
195,0.08,"(26, 4)","(18, 4)",6,56,61,123,4,61,57,122
196,0.12,"(9, 25)","(23, 5)",5,55,59,119,5,81,103,189
197,0.06,"(17, 7)","(25, 20)",4,105,108,217,3,161,167,331
198,0.04,"(12, 3)","(14, 14)",6,93,98,197,4,131,112,247
199,0.2,"(26, 8)","(25, 8)",10,6,15,31,8,41,16,65
200,0.2,"(16, 4)","(29, 28)",5,46,50,101,17,31,96,144
201,0.06,"(18, 20)","(16, 28)",15,75,89,179,16,91,151,258
202,0.08,"(22, 19)","(29, 15)",9,100,108,217,7,81,155,243
203,0.12,"(3, 25)","(15, 22)",11,87,97,195,6,101,75,182
204,0.06,"(4, 3)","(17, 29)",7,116,122,245,8,31,63,102
205,0.2,"(27, 6)","(25, 16)",8,90,97,195,10,51,51,112
206,0.18,"(12, 19)","(22, 6)",9,53,61,123,9,111,237,357
207,0.04,"(18, 3)","(2, 2)",17,119,135,271,7,41,41,89
208,0.06,"(19, 29)","(20, 12)",4,134,137,275,3,71,102,176
209,0.1,"(11, 9)","(4, 20)",5,102,106,213,3,41,71,115
210,0.1,"(25, 0)","(9, 21)",8,85,92,185,4,71,78,153
211,0.04,"(14, 27)","(14, 14)",13,66,78,157,14,41,84,139
212,0.08,"(10, 3)","(23, 25)",12,39,50,101,5,61,94,160
213,0.2,"(27, 10)","(15, 29)",4,201,204,409,4,41,98,143
214,0.04,"(29, 25)","(20, 18)",9,115,123,247,10,51,62,123
215,0.02,"(23, 27)","(20, 5)",4,148,151,303,5,241,152,398
216,0.02,"(10, 27)","(16, 4)",8,331,338,677,5,301,320,626
217,0.18,"(27, 17)","(24, 26)",9,119,127,255,11,71,109,191
218,0.16,"(10, 4)","(27, 9)",11,159,169,339,4,101,188,293
219,0.08,"(24, 3)","(8, 3)",11,127,137,275,7,71,117,195
220,0.02,"(15, 9)","(4, 19)",4,72,75,151,6,171,136,313
221,0.04,"(28, 25)","(14, 26)",3,108,110,221,10,21,29,60
222,0.04,"(12, 5)","(25, 19)",10,26,35,71,12,151,221,384
223,0.18,"(9, 15)","(22, 7)",15,24,38,77,18,81,106,205
224,0.18,"(27, 28)","(2, 19)",18,83,100,201,19,101,205,325
225,0.08,"(10, 0)","(19, 11)",5,108,112,225,6,111,127,244
226,0.02,"(5, 11)","(11, 22)",5,125,129,259,6,141,125,272
227,0.2,"(17, 2)","(9, 18)",11,91,101,203,7,51,181,239
228,0.14,"(18, 0)","(3, 22)",3,39,41,83,4,71,87,162
229,0.04,"(8, 1)","(1, 25)",5,167,171,343,10,161,169,340
230,0.04,"(26, 9)","(5, 4)",9,107,115,231,7,121,131,259
231,0.02,"(10, 10)","(12, 20)",6,23,28,57,12,201,129,342
232,0.16,"(1, 9)","(0, 26)",6,146,151,303,5,31,67,103
233,0.04,"(24, 23)","(29, 28)",21,142,162,325,12,51,152,215
234,0.2,"(6, 26)","(25, 14)",12,96,107,215,9,71,121,201
235,0.14,"(20, 16)","(2, 26)",5,91,95,191,8,51,101,160
236,0.02,"(23, 11)","(8, 2)",8,106,113,227,3,61,96,160
237,0.08,"(19, 22)","(10, 19)",4,98,101,203,9,91,88,188
238,0.02,"(28, 14)","(11, 21)",4,103,106,213,8,241,407,656
239,0.2,"(20, 25)","(9, 15)",6,24,29,59,8,141,298,447
240,0.18,"(19, 0)","(16, 0)",7,6,12,25,8,81,45,134
241,0.06,"(16, 9)","(4, 12)",6,73,78,157,4,81,113,198
242,0.1,"(18, 25)","(7, 11)",6,92,97,195,5,71,64,140
243,0.16,"(28, 5)","(18, 16)",4,151,154,309,4,151,250,405
244,0.2,"(14, 1)","(28, 16)",4,110,113,227,3,51,105,159
245,0.2,"(10, 24)","(13, 26)",4,133,136,273,3,71,69,143
246,0.08,"(18, 19)","(10, 18)",6,126,131,263,4,21,21,46
247,0.08,"(27, 6)","(10, 9)",7,91,97,195,15,81,235,331
248,0.12,"(11, 27)","(19, 29)",6,116,121,243,3,101,64,168
249,0.04,"(9, 16)","(24, 29)",15,148,162,325,7,71,98,176
250,0.14,"(2, 2)","(15, 19)",7,105,111,223,3,111,138,252
251,0.04,"(16, 5)","(14, 15)",8,122,129,259,8,101,118,227
252,0.08,"(21, 17)","(25, 15)",4,32,35,71,6,71,60,137
253,0.1,"(3, 8)","(19, 26)",26,83,108,217,11,91,129,231
254,0.1,"(28, 5)","(0, 26)",3,59,61,123,2,51,64,117
255,0.12,"(12, 10)","(8, 6)",4,96,99,199,6,31,33,70
256,0.04,"(26, 0)","(23, 5)",6,66,71,143,4,41,74,119
257,0.1,"(29, 27)","(7, 29)",16,117,132,265,4,51,53,108
258,0.1,"(6, 6)","(18, 5)",13,83,95,191,9,91,166,266
259,0.18,"(6, 12)","(23, 28)",6,55,60,121,5,41,60,106
260,0.02,"(14, 7)","(9, 19)",4,178,181,363,7,81,54,142
261,0.1,"(0, 18)","(19, 18)",8,137,144,289,7,81,113,201
262,0.04,"(27, 11)","(17, 13)",15,86,100,201,4,61,45,110
263,0.1,"(22, 8)","(24, 25)",12,112,123,247,7,41,78,126
264,0.14,"(19, 4)","(29, 7)",2,116,117,235,5,51,90,146
265,0.08,"(0, 14)","(29, 24)",4,69,72,145,6,81,107,194
266,0.12,"(17, 27)","(19, 15)",13,127,139,279,10,71,112,193
267,0.04,"(16, 18)","(14, 23)",7,58,64,129,14,51,41,106
268,0.04,"(13, 22)","(14, 19)",6,8,13,27,16,71,41,128
269,0.18,"(18, 6)","(24, 16)",5,77,81,163,11,81,134,226
270,0.18,"(24, 15)","(2, 10)",7,58,64,129,4,131,288,423
271,0.1,"(17, 13)","(15, 15)",7,72,78,157,15,61,80,156
272,0.14,"(28, 8)","(5, 25)",6,65,70,141,6,91,249,346
273,0.02,"(0, 20)","(15, 25)",18,178,195,391,9,41,124,174
274,0.16,"(10, 27)","(0, 18)",7,174,180,361,6,41,41,88
275,0.12,"(19, 15)","(20, 5)",12,81,92,185,7,71,81,159
276,0.02,"(4, 10)","(21, 14)",3,117,119,239,5,161,275,441
277,0.18,"(19, 14)","(10, 16)",7,90,96,193,4,51,29,84
278,0.1,"(17, 4)","(20, 14)",13,113,125,251,11,61,46,118
279,0.18,"(19, 25)","(16, 23)",5,86,90,181,3,41,23,67
280,0.08,"(0, 27)","(20, 18)",10,86,95,191,6,111,153,270
281,0.02,"(1, 24)","(13, 17)",5,92,96,193,6,121,87,214
282,0.2,"(4, 23)","(26, 8)",8,70,77,155,4,91,248,343
283,0.06,"(10, 1)","(3, 19)",5,114,118,237,8,41,46,95
284,0.02,"(15, 4)","(10, 7)",7,47,53,107,30,91,65,186
285,0.2,"(8, 20)","(12, 0)",7,60,66,133,7,81,127,215
286,0.16,"(6, 18)","(18, 25)",8,100,107,215,4,41,114,159
287,0.06,"(24, 18)","(16, 20)",15,86,100,201,9,41,32,82
288,0.08,"(18, 9)","(2, 21)",5,62,66,133,16,131,168,315
289,0.18,"(21, 29)","(0, 17)",2,105,106,213,2,51,114,167
290,0.2,"(16, 15)","(16, 3)",6,111,116,233,6,151,258,415
291,0.06,"(22, 19)","(6, 26)",5,117,121,243,14,61,86,161
292,0.1,"(15, 19)","(7, 4)",4,100,103,207,4,91,170,265
293,0.18,"(8, 24)","(14, 2)",3,99,101,203,5,71,140,216
294,0.1,"(27, 24)","(29, 17)",12,17,28,57,7,31,47,85
295,0.14,"(24, 18)","(9, 3)",7,56,62,125,8,81,104,193
296,0.02,"(26, 10)","(15, 24)",5,115,119,239,34,191,198,423
297,0.06,"(14, 12)","(23, 29)",6,47,52,105,5,41,60,106
298,0.2,"(0, 26)","(21, 16)",4,111,114,229,5,81,150,236
299,0.04,"(21, 8)","(24, 22)",9,137,145,291,6,141,198,345
300,0.2,"(22, 19)","(14, 12)",17,65,81,163,20,41,62,123
301,0.12,"(21, 28)","(22, 20)",3,109,111,223,15,51,62,128
302,0.1,"(21, 25)","(10, 2)",9,90,98,197,8,91,124,223
303,0.02,"(12, 10)","(18, 14)",11,105,115,231,12,111,106,229
304,0.2,"(14, 11)","(20, 7)",4,130,133,267,9,61,136,206
305,0.1,"(11, 0)","(5, 11)",10,80,89,179,10,91,115,216
306,0.08,"(17, 1)","(15, 4)",7,54,60,121,6,71,25,102
307,0.06,"(2, 25)","(9, 18)",6,102,107,215,7,91,80,178
308,0.1,"(25, 18)","(11, 15)",7,99,105,211,14,71,57,142
309,0.14,"(1, 20)","(13, 27)",11,119,129,259,12,71,104,187
310,0.18,"(29, 21)","(14, 9)",10,95,104,209,6,81,211,298
311,0.18,"(2, 9)","(26, 0)",4,95,98,197,3,31,95,129
312,0.02,"(22, 7)","(0, 4)",8,192,199,399,14,221,174,409
313,0.1,"(8, 3)","(25, 22)",27,37,63,127,4,51,79,134
314,0.06,"(3, 17)","(24, 6)",12,100,111,223,10,71,65,146
315,0.16,"(12, 10)","(29, 20)",20,44,63,127,14,21,62,97
316,0.04,"(18, 17)","(18, 12)",7,13,19,39,8,71,77,156
317,0.1,"(17, 13)","(18, 0)",7,123,129,259,21,41,100,162
318,0.08,"(17, 21)","(8, 14)",9,21,29,59,6,161,219,386
319,0.06,"(29, 28)","(18, 18)",21,114,134,269,8,81,63,152
320,0.08,"(11, 28)","(14, 11)",5,95,99,199,3,161,188,352
321,0.02,"(16, 20)","(14, 7)",4,264,267,535,6,71,112,189
322,0.04,"(26, 14)","(5, 28)",4,35,38,77,3,111,149,263
323,0.12,"(9, 17)","(18, 9)",19,21,39,79,15,91,221,327
324,0.16,"(21, 11)","(26, 26)",19,136,154,309,8,61,150,219
325,0.2,"(13, 10)","(1, 28)",9,140,148,297,4,41,95,140
326,0.04,"(7, 11)","(19, 11)",11,161,171,343,6,111,160,277
327,0.12,"(22, 20)","(16, 25)",8,92,99,199,4,31,22,57
328,0.02,"(9, 5)","(8, 21)",11,132,142,285,5,141,119,265
329,0.16,"(29, 6)","(18, 17)",5,85,89,179,6,111,232,349
330,0.2,"(15, 25)","(27, 25)",4,84,87,175,10,101,232,343
331,0.04,"(14, 24)","(10, 6)",7,130,136,273,4,171,173,348
332,0.18,"(16, 16)","(22, 27)",7,128,134,269,6,81,152,239
333,0.04,"(25, 2)","(9, 7)",11,53,63,127,14,51,61,126
334,0.2,"(26, 6)","(28, 1)",6,24,29,59,6,41,34,81
335,0.04,"(0, 0)","(11, 12)",1,110,110,221,1,301,190,492
336,0.06,"(11, 20)","(15, 11)",4,12,15,31,6,61,44,111
337,0.12,"(13, 16)","(0, 22)",14,156,169,339,4,71,80,155
338,0.16,"(9, 11)","(2, 23)",8,106,113,227,4,91,171,266
339,0.2,"(26, 17)","(19, 9)",5,79,83,167,5,71,165,241
340,0.2,"(16, 25)","(11, 12)",5,83,87,175,9,81,192,282
341,0.1,"(11, 12)","(5, 16)",2,89,90,181,2,91,39,132
342,0.14,"(14, 14)","(15, 18)",6,9,14,29,5,131,159,295
343,0.16,"(14, 4)","(17, 14)",6,80,85,171,8,61,87,156
344,0.08,"(27, 27)","(19, 5)",16,166,181,363,5,121,253,379
345,0.2,"(22, 0)","(28, 23)",3,95,97,195,7,111,177,295
346,0.04,"(6, 4)","(23, 20)",8,30,37,75,6,81,90,177
347,0.04,"(24, 27)","(13, 7)",10,121,130,261,10,41,76,127
348,0.08,"(15, 28)","(17, 3)",4,59,62,125,5,81,102,188
349,0.08,"(25, 26)","(12, 26)",18,111,128,257,13,51,65,129
350,0.06,"(10, 26)","(8, 18)",4,86,89,179,16,61,36,113
351,0.16,"(23, 27)","(3, 18)",4,33,36,73,8,91,179,278
352,0.16,"(3, 28)","(19, 24)",7,123,129,259,6,61,121,188
353,0.16,"(16, 27)","(8, 13)",15,25,39,79,13,81,141,235
354,0.02,"(2, 8)","(25, 21)",16,136,151,303,4,271,276,551
355,0.12,"(28, 2)","(10, 26)",9,72,80,161,9,91,148,248
356,0.18,"(28, 1)","(1, 13)",6,84,89,179,5,91,233,329
357,0.14,"(14, 6)","(12, 7)",5,17,21,43,7,21,21,49
358,0.06,"(5, 29)","(13, 22)",26,88,113,227,9,151,152,312
359,0.14,"(22, 9)","(9, 29)",3,64,66,133,2,41,73,116
360,0.14,"(12, 2)","(1, 9)",4,71,74,149,6,71,193,270
361,0.04,"(23, 29)","(16, 13)",7,77,83,167,4,121,170,295
362,0.14,"(24, 2)","(28, 1)",15,41,55,111,10,41,41,92
363,0.16,"(29, 7)","(11, 22)",7,75,81,163,7,111,140,258
364,0.02,"(2, 21)","(9, 10)",11,110,120,241,12,141,96,249
365,0.18,"(9, 23)","(7, 13)",6,78,83,167,5,101,219,325
366,0.02,"(13, 9)","(11, 7)",7,40,46,93,10,21,12,43
367,0.04,"(19, 22)","(24, 23)",14,89,102,205,9,81,70,160
368,0.06,"(9, 12)","(5, 9)",5,80,84,169,7,101,88,196
369,0.18,"(2, 5)","(14, 25)",7,81,87,175,4,101,233,338
370,0.14,"(25, 13)","(21, 18)",17,43,59,119,9,71,64,144
371,0.16,"(11, 25)","(14, 0)",5,75,79,159,15,51,101,167
372,0.2,"(5, 8)","(23, 1)",6,100,105,211,3,51,101,155
373,0.08,"(26, 27)","(29, 4)",9,140,148,297,19,51,171,241
374,0.04,"(4, 11)","(0, 3)",7,103,109,219,15,91,63,169
375,0.2,"(27, 16)","(14, 15)",19,100,118,237,8,41,38,87
376,0.14,"(28, 28)","(16, 12)",9,30,38,77,3,61,187,251
377,0.12,"(2, 24)","(7, 13)",12,104,115,231,6,41,37,84
378,0.06,"(18, 14)","(7, 14)",8,113,120,241,13,151,125,289
379,0.2,"(16, 17)","(29, 20)",8,104,111,223,6,91,207,304
380,0.12,"(24, 28)","(15, 29)",5,130,134,269,6,71,121,198
381,0.1,"(25, 2)","(1, 7)",7,110,116,233,5,71,159,235
382,0.04,"(4, 6)","(27, 14)",12,85,96,193,22,121,156,299
383,0.08,"(25, 4)","(10, 25)",9,65,73,147,8,131,132,271
384,0.04,"(25, 25)","(17, 14)",9,168,176,353,4,141,229,374
385,0.12,"(24, 14)","(20, 11)",4,44,47,95,17,81,87,185
386,0.1,"(12, 1)","(10, 25)",5,83,87,175,7,121,173,301
387,0.1,"(25, 1)","(25, 24)",4,96,99,199,2,31,99,132
388,0.04,"(14, 29)","(16, 21)",3,90,92,185,8,111,73,192
389,0.12,"(3, 23)","(13, 10)",4,27,30,61,11,71,110,192
390,0.12,"(29, 3)","(2, 21)",4,44,47,95,20,81,170,271
391,0.2,"(13, 11)","(10, 6)",14,40,53,107,10,31,31,72
392,0.08,"(6, 27)","(25, 10)",10,95,104,209,7,101,145,253
393,0.06,"(24, 0)","(4, 7)",11,49,59,119,3,111,97,211
394,0.16,"(15, 0)","(8, 29)",3,71,73,147,5,81,159,245
395,0.14,"(23, 25)","(21, 8)",8,104,111,223,17,71,144,232
396,0.12,"(4, 26)","(6, 4)",5,89,93,187,20,81,134,235
397,0.04,"(23, 17)","(5, 1)",25,82,106,213,5,91,178,274
398,0.06,"(17, 3)","(11, 1)",5,61,65,131,6,111,75,192
399,0.12,"(0, 15)","(23, 28)",8,60,67,135,6,61,71,138
400,0.18,"(0, 20)","(15, 4)",6,81,86,173,20,41,105,166
401,0.1,"(24, 26)","(19, 22)",5,79,83,167,3,61,35,99
402,0.04,"(21, 1)","(26, 2)",11,17,27,55,4,131,76,211
403,0.1,"(12, 26)","(13, 27)",4,103,106,213,4,61,14,79
404,0.16,"(27, 23)","(19, 11)",5,85,89,179,10,51,99,160
405,0.08,"(25, 1)","(4, 16)",3,38,40,81,7,121,123,251
406,0.08,"(4, 3)","(28, 7)",3,81,83,167,11,91,218,320
407,0.04,"(5, 5)","(7, 11)",6,155,160,321,8,171,180,359
408,0.14,"(21, 8)","(1, 16)",7,117,123,247,6,51,67,124
409,0.12,"(21, 12)","(27, 24)",11,129,139,279,9,61,84,154
410,0.12,"(4, 3)","(17, 5)",8,100,107,215,6,91,112,209
411,0.06,"(10, 5)","(7, 7)",7,122,128,257,20,81,47,148
412,0.16,"(14, 27)","(12, 20)",6,102,107,215,6,61,43,110
413,0.16,"(21, 0)","(9, 20)",6,65,70,141,4,101,229,334
414,0.2,"(6, 15)","(10, 23)",11,13,23,47,8,61,79,148
415,0.2,"(11, 23)","(6, 29)",4,25,28,57,7,81,103,191
416,0.1,"(9, 21)","(9, 5)",8,100,107,215,5,161,193,359
417,0.04,"(27, 29)","(10, 10)",4,84,87,175,8,171,147,326
418,0.04,"(24, 2)","(9, 28)",5,68,72,145,9,71,99,179
419,0.04,"(18, 24)","(29, 14)",6,104,109,219,7,151,159,317
420,0.12,"(3, 8)","(13, 14)",11,22,32,65,9,81,154,244
421,0.08,"(22, 26)","(6, 11)",7,32,38,77,6,41,91,138
422,0.2,"(0, 7)","(12, 6)",7,117,123,247,6,71,167,244
423,0.16,"(21, 18)","(26, 0)",6,95,100,201,6,51,154,211
424,0.04,"(10, 0)","(14, 17)",3,78,80,161,7,91,104,202
425,0.14,"(21, 5)","(25, 20)",7,150,156,313,7,71,95,173
426,0.14,"(23, 20)","(5, 27)",7,142,148,297,8,71,115,194
427,0.08,"(9, 8)","(5, 6)",12,35,46,93,8,111,69,188
428,0.18,"(14, 10)","(16, 19)",4,83,86,173,8,131,298,437
429,0.1,"(17, 25)","(28, 7)",7,159,165,331,11,91,131,233
430,0.12,"(15, 13)","(28, 24)",12,77,88,177,7,81,71,159
431,0.1,"(15, 14)","(13, 28)",4,63,66,133,8,81,138,227
432,0.14,"(25, 2)","(13, 29)",28,98,125,251,7,31,80,118
433,0.02,"(0, 9)","(10, 9)",15,84,98,197,12,121,120,253
434,0.06,"(0, 4)","(2, 20)",7,69,75,151,8,151,142,301
435,0.04,"(9, 13)","(3, 1)",7,173,179,359,3,111,216,330
436,0.06,"(8, 18)","(21, 24)",4,102,105,211,4,91,75,170
437,0.02,"(18, 11)","(15, 5)",5,108,112,225,7,61,56,124
438,0.16,"(19, 21)","(12, 21)",4,75,78,157,7,61,45,113
439,0.06,"(18, 3)","(26, 7)",13,131,143,287,6,171,89,266
440,0.06,"(24, 11)","(14, 3)",9,111,119,239,5,91,123,219
441,0.14,"(25, 4)","(16, 24)",5,121,125,251,27,111,283,421
442,0.14,"(27, 5)","(28, 16)",4,107,110,221,4,81,120,205
443,0.16,"(18, 17)","(21, 10)",4,92,95,191,11,51,74,136
444,0.18,"(25, 23)","(21, 14)",7,13,19,39,9,111,133,253
445,0.2,"(12, 22)","(14, 21)",10,12,21,43,3,21,7,31
446,0.12,"(1, 13)","(16, 2)",5,92,96,193,6,71,52,129
447,0.12,"(16, 0)","(8, 12)",4,94,97,195,7,151,171,329
448,0.1,"(23, 22)","(18, 17)",8,78,85,171,11,41,25,77
449,0.18,"(3, 5)","(14, 8)",6,128,133,267,5,91,131,227
450,0.18,"(25, 17)","(28, 20)",3,155,157,315,4,41,44,89
451,0.08,"(8, 17)","(25, 17)",33,68,100,201,16,71,101,188
452,0.06,"(24, 27)","(9, 11)",8,73,80,161,6,111,129,246
453,0.14,"(17, 3)","(25, 16)",11,151,161,323,5,71,102,178
454,0.1,"(22, 4)","(10, 21)",9,100,108,217,6,91,173,270
455,0.12,"(10, 14)","(19, 3)",6,88,93,187,6,121,107,234
456,0.12,"(29, 13)","(14, 20)",5,22,26,53,11,111,164,286
457,0.2,"(4, 18)","(9, 21)",8,21,28,57,16,41,49,106
458,0.02,"(17, 20)","(14, 21)",13,48,60,121,4,51,23,78
459,0.2,"(17, 23)","(9, 19)",6,109,114,229,5,151,298,454
460,0.16,"(10, 15)","(17, 9)",12,63,74,149,17,111,160,288
461,0.08,"(0, 11)","(16, 23)",69,125,193,387,67,111,190,368
462,0.1,"(21, 13)","(7, 1)",10,153,162,325,11,81,78,170
463,0.04,"(26, 20)","(23, 5)",4,135,138,277,5,101,120,226
464,0.16,"(5, 16)","(14, 20)",9,137,145,291,10,121,122,253
465,0.16,"(4, 7)","(18, 18)",4,29,32,65,12,61,191,264
466,0.02,"(1, 5)","(12, 12)",6,178,183,367,5,101,146,252
467,0.14,"(10, 4)","(20, 19)",22,70,91,183,9,91,139,239
468,0.2,"(2, 4)","(11, 3)",6,101,106,213,7,121,285,413
469,0.06,"(8, 7)","(5, 17)",8,110,117,235,7,91,51,149
470,0.1,"(22, 7)","(24, 2)",6,100,105,211,11,41,74,126
471,0.14,"(27, 8)","(29, 0)",8,110,117,235,6,81,156,243
472,0.2,"(25, 2)","(4, 28)",5,58,62,125,5,71,95,171
473,0.14,"(12, 28)","(25, 21)",9,89,97,195,4,41,71,116
474,0.2,"(15, 27)","(5, 10)",18,143,160,321,13,51,104,168
475,0.06,"(20, 3)","(0, 19)",8,71,78,157,5,31,70,106
476,0.02,"(12, 12)","(17, 0)",2,156,157,315,4,31,68,103
477,0.06,"(24, 4)","(12, 3)",9,32,40,81,6,21,19,46
478,0.2,"(26, 7)","(7, 22)",16,33,48,97,13,51,105,169
479,0.18,"(23, 26)","(5, 9)",5,83,87,175,9,111,253,373
480,0.2,"(28, 20)","(19, 3)",3,74,76,153,10,81,164,255
481,0.08,"(29, 22)","(11, 13)",10,28,37,75,8,31,49,88
482,0.1,"(3, 4)","(10, 5)",5,27,31,63,8,41,30,79
483,0.04,"(0, 20)","(5, 15)",4,53,56,113,3,121,71,195
484,0.06,"(2, 20)","(12, 21)",11,56,66,133,6,71,61,138
485,0.02,"(26, 13)","(11, 17)",13,275,287,575,10,281,340,631
486,0.14,"(28, 6)","(19, 28)",4,78,81,163,8,61,95,164
487,0.08,"(6, 0)","(6, 12)",7,97,103,207,12,101,70,183
488,0.14,"(17, 2)","(6, 12)",5,26,30,61,12,81,70,163
489,0.04,"(3, 7)","(8, 14)",8,72,79,159,9,81,73,163
490,0.16,"(8, 13)","(27, 17)",5,52,56,113,2,31,64,97
491,0.16,"(4, 2)","(10, 3)",5,12,16,33,3,71,55,129
492,0.18,"(18, 12)","(24, 17)",7,110,116,233,3,171,329,503
493,0.1,"(3, 27)","(29, 10)",12,61,72,145,10,71,138,219
494,0.08,"(7, 4)","(9, 21)",9,70,78,157,15,71,96,182
495,0.16,"(4, 23)","(12, 22)",9,89,97,195,8,91,59,158
496,0.18,"(22, 3)","(11, 11)",7,81,87,175,8,41,58,107
497,0.2,"(22, 3)","(2, 29)",10,52,61,123,12,41,66,119
498,0.04,"(3, 24)","(15, 3)",4,91,94,189,4,81,48,133
499,0.1,"(16, 16)","(11, 3)",10,62,71,143,51,91,124,266
500,0.1,"(29, 1)","(18, 28)",12,114,125,251,5,71,143,219
501,0.04,"(8, 14)","(18, 5)",5,106,110,221,6,161,179,346
502,0.08,"(21, 11)","(10, 8)",8,124,131,263,11,91,146,248
503,0.08,"(12, 20)","(15, 14)",7,75,81,163,11,81,134,226
504,0.16,"(7, 26)","(5, 13)",3,103,105,211,7,61,62,130
505,0.18,"(25, 27)","(2, 7)",19,73,91,183,10,31,77,118
506,0.06,"(5, 15)","(10, 10)",7,82,88,177,9,31,57,97
507,0.1,"(8, 3)","(18, 29)",4,110,113,227,8,101,108,217
508,0.14,"(2, 6)","(5, 25)",4,101,104,209,8,71,164,243
509,0.08,"(5, 19)","(24, 7)",4,37,40,81,7,71,86,164
510,0.12,"(22, 19)","(6, 1)",9,37,45,91,22,41,72,135
511,0.14,"(11, 3)","(24, 14)",7,89,95,191,26,131,143,300
512,0.12,"(2, 2)","(3, 26)",5,85,89,179,6,121,155,282
513,0.18,"(17, 26)","(23, 5)",6,97,102,205,7,81,125,213
514,0.2,"(14, 13)","(1, 14)",11,52,62,125,6,81,119,206
515,0.04,"(28, 3)","(0, 15)",11,133,143,287,7,141,179,327
516,0.02,"(0, 15)","(20, 15)",8,161,168,337,13,181,199,393
517,0.12,"(1, 18)","(27, 9)",5,83,87,175,7,71,150,228
518,0.08,"(9, 18)","(7, 2)",5,61,65,131,5,121,132,258
519,0.16,"(17, 19)","(23, 9)",8,33,40,81,5,81,83,169
520,0.18,"(23, 9)","(23, 15)",10,84,93,187,21,61,94,176
521,0.14,"(25, 25)","(5, 9)",6,93,98,197,19,81,128,228
522,0.12,"(27, 10)","(12, 4)",14,131,144,289,11,101,139,251
523,0.06,"(29, 21)","(9, 23)",6,128,133,267,7,171,176,354
524,0.18,"(23, 27)","(29, 14)",6,123,128,257,3,81,111,195
525,0.08,"(17, 11)","(12, 1)",2,130,131,263,6,101,145,252
526,0.1,"(13, 26)","(19, 18)",16,94,109,219,13,61,77,151
527,0.16,"(19, 16)","(14, 16)",9,68,76,153,4,41,21,66
528,0.18,"(4, 24)","(29, 22)",5,104,108,217,5,81,205,291
529,0.1,"(12, 2)","(24, 9)",7,98,104,209,6,91,93,190
530,0.18,"(3, 26)","(6, 28)",9,74,82,165,5,41,24,70
531,0.16,"(15, 0)","(12, 24)",5,67,71,143,4,61,83,148
532,0.18,"(19, 15)","(26, 13)",5,168,172,345,5,81,142,228
533,0.14,"(0, 9)","(24, 7)",8,107,114,229,6,81,146,233
534,0.12,"(12, 13)","(7, 22)",4,71,74,149,3,51,84,138
535,0.06,"(25, 6)","(8, 22)",7,35,41,83,6,111,129,246
536,0.06,"(29, 29)","(11, 3)",10,129,138,277,12,91,133,236
537,0.16,"(19, 4)","(27, 14)",10,109,118,237,7,81,119,207
538,0.18,"(22, 13)","(3, 11)",9,137,145,291,6,81,141,228
539,0.2,"(24, 13)","(15, 26)",7,78,84,169,11,81,210,302
540,0.12,"(8, 25)","(21, 17)",10,96,105,211,11,41,105,157
541,0.06,"(17, 24)","(4, 24)",11,103,113,227,22,91,61,174
542,0.12,"(5, 10)","(6, 17)",4,60,63,127,18,101,91,210
543,0.1,"(19, 17)","(20, 9)",9,78,86,173,8,71,97,176
544,0.16,"(29, 15)","(26, 2)",5,42,46,93,11,81,219,311
545,0.04,"(5, 28)","(2, 8)",4,143,146,293,8,91,108,207
546,0.16,"(19, 25)","(13, 7)",3,65,67,135,7,111,252,370
547,0.08,"(13, 5)","(18, 4)",4,71,74,149,3,101,114,218
548,0.02,"(2, 2)","(20, 8)",11,189,199,399,8,131,156,295
549,0.16,"(27, 5)","(27, 28)",8,134,141,283,3,61,159,223
550,0.06,"(16, 29)","(11, 23)",3,66,68,137,6,101,80,187
551,0.12,"(14, 4)","(16, 26)",8,102,109,219,17,131,268,416
552,0.06,"(15, 7)","(18, 17)",5,179,183,367,17,121,172,310
553,0.08,"(20, 9)","(16, 27)",7,67,73,147,6,31,69,106
554,0.1,"(19, 22)","(11, 22)",7,14,20,41,8,11,16,35
555,0.14,"(22, 16)","(6, 12)",4,61,64,129,2,61,37,100
556,0.06,"(3, 29)","(16, 0)",4,71,74,149,6,41,97,144
557,0.08,"(17, 1)","(7, 26)",4,60,63,127,5,51,62,118
558,0.18,"(1, 7)","(17, 8)",10,118,127,255,7,81,209,297
559,0.12,"(5, 18)","(21, 25)",9,111,119,239,17,81,144,242
560,0.2,"(0, 29)","(7, 24)",2,123,124,249,6,91,246,343
561,0.02,"(14, 12)","(19, 17)",16,100,115,231,9,161,96,266
562,0.12,"(20, 21)","(8, 20)",4,118,121,243,13,71,37,121
563,0.18,"(10, 22)","(1, 0)",8,110,117,235,4,71,120,195
564,0.2,"(1, 17)","(21, 10)",3,110,112,225,3,71,190,264
565,0.02,"(6, 15)","(7, 17)",7,24,30,61,18,211,236,465
566,0.04,"(15, 12)","(12, 18)",3,120,122,245,13,81,63,157
567,0.14,"(28, 23)","(3, 9)",11,42,52,105,4,51,80,135
568,0.02,"(3, 12)","(29, 23)",5,150,154,309,11,31,65,107
569,0.14,"(4, 19)","(1, 14)",9,104,112,225,5,71,36,112
570,0.16,"(25, 11)","(0, 3)",11,92,102,205,11,91,234,336
571,0.16,"(14, 25)","(1, 19)",7,73,79,159,5,131,308,444
572,0.1,"(15, 10)","(11, 11)",6,33,38,77,6,41,18,65
573,0.12,"(9, 16)","(24, 16)",13,70,82,165,19,91,147,257
574,0.02,"(21, 9)","(23, 11)",5,193,197,395,6,61,22,89
575,0.04,"(6, 16)","(1, 11)",8,174,181,363,6,81,62,149
576,0.12,"(6, 25)","(1, 19)",7,112,118,237,7,61,26,94
577,0.18,"(27, 16)","(17, 20)",15,101,115,231,6,41,43,90
578,0.12,"(28, 12)","(16, 28)",5,122,126,253,8,61,123,192
579,0.18,"(9, 22)","(22, 29)",13,94,106,213,12,71,86,169
580,0.06,"(12, 17)","(17, 19)",3,100,102,205,5,111,174,290
581,0.16,"(0, 13)","(1, 27)",2,121,122,245,2,71,74,147
582,0.06,"(6, 24)","(24, 5)",13,44,56,113,6,161,134,301
583,0.06,"(15, 0)","(26, 29)",36,152,187,375,7,101,114,222
584,0.16,"(12, 5)","(20, 10)",10,77,86,173,9,81,136,226
585,0.06,"(16, 6)","(9, 15)",6,157,162,325,4,101,101,206
586,0.2,"(23, 7)","(22, 8)",10,179,188,377,6,81,70,157
587,0.1,"(16, 1)","(8, 28)",25,84,108,217,7,61,103,171
588,0.02,"(10, 25)","(25, 24)",5,159,163,327,9,161,207,377
589,0.02,"(4, 9)","(8, 28)",5,192,196,393,8,31,46,85
590,0.06,"(9, 12)","(22, 28)",10,61,70,141,9,101,161,271
591,0.04,"(15, 26)","(18, 24)",3,94,96,193,3,101,36,140
592,0.04,"(24, 5)","(16, 19)",10,82,91,183,8,111,93,212
593,0.04,"(17, 12)","(15, 25)",4,56,59,119,16,151,201,368
594,0.08,"(3, 25)","(21, 28)",5,26,30,61,7,51,87,145
595,0.02,"(9, 17)","(0, 23)",5,87,91,183,10,141,154,305
596,0.04,"(1, 14)","(17, 22)",6,114,119,239,4,71,87,162
597,0.12,"(5, 13)","(16, 16)",11,76,86,173,4,81,132,217
598,0.14,"(2, 14)","(27, 5)",5,79,83,167,4,71,137,212
599,0.02,"(5, 25)","(14, 0)",8,175,182,365,15,131,143,289
600,0.16,"(8, 11)","(11, 9)",8,110,117,235,14,121,202,337
601,0.18,"(1, 0)","(2, 8)",18,17,34,69,7,91,105,203
602,0.12,"(23, 9)","(27, 15)",4,55,58,117,17,41,78,136
603,0.14,"(25, 14)","(7, 22)",5,99,103,207,5,41,87,133
604,0.18,"(10, 17)","(18, 20)",9,49,57,115,8,91,138,237
605,0.02,"(22, 16)","(2, 14)",45,127,171,343,5,131,133,269
606,0.18,"(8, 28)","(12, 1)",11,95,105,211,9,101,174,284
607,0.04,"(8, 25)","(26, 2)",5,62,66,133,4,61,124,189
608,0.02,"(20, 25)","(22, 7)",5,80,84,169,5,131,206,342
609,0.16,"(0, 11)","(17, 0)",9,95,103,207,8,61,149,218
610,0.2,"(9, 3)","(12, 17)",6,118,123,247,8,51,57,116
611,0.04,"(15, 15)","(4, 17)",5,102,106,213,14,61,47,122
612,0.08,"(21, 2)","(9, 23)",6,110,115,231,9,91,137,237
613,0.02,"(7, 25)","(6, 12)",5,144,148,297,7,241,240,488
614,0.02,"(13, 10)","(12, 10)",7,56,62,125,7,21,10,38
615,0.1,"(12, 28)","(1, 1)",7,79,85,171,4,81,151,236
616,0.04,"(3, 25)","(18, 28)",3,148,150,301,4,81,119,204
617,0.18,"(16, 12)","(13, 3)",6,121,126,253,10,111,104,225
618,0.12,"(18, 23)","(24, 7)",3,143,145,291,4,61,81,146
619,0.1,"(26, 4)","(5, 23)",7,42,48,97,12,71,163,246
620,0.14,"(3, 29)","(29, 15)",3,107,109,219,3,41,110,154
621,0.06,"(6, 23)","(22, 22)",6,136,141,283,5,161,107,273
622,0.04,"(25, 16)","(0, 20)",6,92,97,195,6,91,76,173
623,0.08,"(0, 12)","(5, 20)",4,95,98,197,16,71,75,162
624,0.18,"(25, 25)","(15, 11)",4,74,77,155,7,101,216,324
625,0.18,"(12, 1)","(28, 3)",10,134,143,287,11,61,89,161
626,0.04,"(5, 23)","(19, 23)",4,64,67,135,4,121,110,235
627,0.04,"(27, 14)","(13, 25)",10,144,153,307,6,101,163,270
628,0.16,"(5, 15)","(12, 19)",9,147,155,311,5,121,104,230
629,0.2,"(1, 18)","(16, 0)",9,76,84,169,9,131,275,415
630,0.12,"(21, 21)","(19, 12)",5,114,118,237,4,71,44,119
631,0.08,"(3, 13)","(7, 10)",6,38,43,87,8,81,61,150
632,0.08,"(27, 2)","(17, 21)",4,81,84,169,5,81,161,247
633,0.08,"(21, 16)","(29, 0)",12,180,191,383,9,41,88,138
634,0.02,"(7, 28)","(22, 11)",17,146,162,325,7,71,128,206
635,0.04,"(4, 7)","(28, 4)",17,81,97,195,7,81,139,227
636,0.1,"(21, 13)","(2, 0)",7,85,91,183,7,31,83,121
637,0.18,"(7, 7)","(13, 13)",6,16,21,43,4,71,65,140
638,0.2,"(6, 25)","(29, 26)",5,89,93,187,8,61,158,227
639,0.16,"(11, 26)","(2, 25)",7,184,190,381,7,51,35,93
640,0.12,"(29, 27)","(22, 0)",7,87,93,187,8,141,161,310
641,0.02,"(11, 23)","(18, 22)",10,84,93,187,5,131,46,182
642,0.04,"(27, 22)","(7, 16)",6,201,206,413,9,201,163,373
643,0.1,"(6, 24)","(27, 18)",18,164,181,363,12,71,163,246
644,0.16,"(21, 22)","(28, 9)",6,102,107,215,15,41,110,166
645,0.04,"(11, 9)","(29, 26)",6,49,54,109,8,91,174,273
646,0.08,"(15, 0)","(23, 26)",11,162,172,345,5,51,93,149
647,0.06,"(0, 22)","(8, 8)",6,107,112,225,7,151,154,312
648,0.04,"(7, 12)","(14, 5)",19,88,106,213,4,211,169,384
649,0.02,"(9, 5)","(29, 3)",7,71,77,155,5,91,97,193
650,0.06,"(24, 22)","(14, 17)",3,33,35,71,6,61,67,134
651,0.2,"(4, 27)","(20, 17)",7,77,83,167,9,121,281,411
652,0.06,"(8, 18)","(13, 29)",7,198,204,409,10,101,90,201
653,0.14,"(12, 16)","(14, 4)",13,62,74,149,7,101,130,238
654,0.04,"(8, 1)","(16, 18)",23,24,46,93,5,101,116,222
655,0.1,"(22, 2)","(20, 5)",5,123,127,255,11,51,29,91
656,0.14,"(12, 11)","(17, 22)",8,75,82,165,6,111,81,198
657,0.1,"(6, 10)","(14, 19)",7,99,105,211,6,121,199,326
658,0.2,"(1, 27)","(15, 26)",5,99,103,207,6,101,156,263
659,0.12,"(5, 27)","(2, 16)",9,112,120,241,9,41,38,88
660,0.1,"(1, 11)","(6, 11)",10,70,79,159,7,91,53,151
661,0.06,"(4, 25)","(0, 10)",16,37,52,105,4,61,72,137
662,0.02,"(17, 8)","(12, 14)",4,169,172,345,6,181,117,304
663,0.1,"(8, 24)","(28, 13)",9,94,102,205,7,91,228,326
664,0.1,"(15, 17)","(9, 20)",6,97,102,205,6,81,66,153
665,0.14,"(4, 0)","(15, 9)",10,152,161,323,9,51,88,148
666,0.12,"(8, 1)","(19, 24)",7,35,41,83,13,61,98,172
667,0.12,"(26, 10)","(23, 7)",4,141,144,289,6,41,14,61
668,0.1,"(7, 25)","(27, 12)",4,67,70,141,9,61,104,174
669,0.12,"(1, 6)","(28, 3)",5,100,104,209,5,61,137,203
670,0.2,"(21, 10)","(15, 0)",5,107,111,223,3,71,115,189
671,0.02,"(5, 24)","(1, 1)",5,88,92,185,11,171,189,371
672,0.12,"(23, 29)","(14, 19)",10,136,145,291,18,111,168,297
673,0.1,"(7, 26)","(5, 0)",4,89,92,185,3,51,112,166
674,0.1,"(20, 13)","(24, 21)",24,82,105,211,4,101,94,199
675,0.04,"(16, 14)","(19, 29)",6,79,84,169,9,41,71,121
676,0.08,"(29, 18)","(21, 25)",4,119,122,245,3,111,179,293
677,0.02,"(2, 19)","(27, 4)",6,99,104,209,6,191,135,332
678,0.1,"(22, 26)","(24, 0)",10,102,111,223,11,81,140,232
679,0.02,"(28, 0)","(23, 18)",3,133,135,271,10,91,161,262
680,0.16,"(24, 12)","(12, 9)",9,18,26,53,8,81,148,237
681,0.18,"(17, 26)","(20, 9)",8,144,151,303,11,101,225,337
682,0.2,"(10, 6)","(14, 6)",6,93,98,197,5,61,54,120
683,0.14,"(6, 23)","(13, 8)",6,132,137,275,6,81,96,183
684,0.18,"(22, 2)","(2, 22)",12,97,108,217,9,31,75,115
685,0.1,"(17, 14)","(20, 22)",8,110,117,235,8,41,64,113
686,0.02,"(14, 10)","(0, 25)",6,176,181,363,10,51,90,151
687,0.02,"(1, 21)","(23, 0)",12,113,124,249,5,231,232,468
688,0.16,"(9, 25)","(11, 12)",3,108,110,221,5,131,202,338
689,0.1,"(23, 27)","(9, 10)",16,117,132,265,4,131,170,305
690,0.08,"(10, 25)","(27, 8)",3,73,75,151,4,151,143,298
691,0.16,"(21, 18)","(22, 20)",11,1,11,23,4,61,51,116
692,0.02,"(2, 12)","(18, 7)",3,157,159,319,4,231,189,424
693,0.16,"(26, 15)","(7, 5)",7,70,76,153,5,71,132,208
694,0.1,"(15, 23)","(20, 3)",11,72,82,165,6,91,162,259
695,0.1,"(12, 9)","(24, 2)",5,101,105,211,6,81,121,208
696,0.12,"(20, 2)","(29, 20)",10,94,103,207,7,41,100,148
697,0.16,"(29, 3)","(6, 20)",10,67,76,153,16,61,110,187
698,0.18,"(22, 29)","(10, 27)",8,109,116,233,6,81,197,284
699,0.16,"(3, 21)","(16, 11)",4,93,96,193,4,81,82,167
700,0.04,"(19, 16)","(20, 24)",8,115,122,245,4,101,108,213
701,0.2,"(11, 17)","(16, 10)",10,73,82,165,3,101,109,213
702,0.18,"(17, 5)","(10, 18)",26,64,89,179,11,71,117,199
703,0.12,"(13, 3)","(17, 24)",4,78,81,163,7,81,109,197
704,0.16,"(5, 29)","(9, 18)",11,109,119,239,15,101,248,364
705,0.06,"(3, 16)","(19, 16)",5,50,54,109,6,171,126,303
706,0.1,"(10, 20)","(0, 19)",9,105,113,227,6,41,43,90
707,0.12,"(0, 4)","(7, 14)",4,90,93,187,2,51,64,117
708,0.12,"(5, 17)","(9, 15)",13,8,20,41,6,61,54,121
709,0.14,"(26, 2)","(13, 0)",6,101,106,213,21,61,86,168
710,0.18,"(14, 12)","(4, 11)",8,79,86,173,6,31,23,60
711,0.18,"(22, 9)","(25, 8)",8,25,32,65,7,71,75,153
712,0.12,"(18, 15)","(15, 10)",5,77,81,163,5,31,30,66
713,0.08,"(23, 5)","(7, 22)",8,38,45,91,6,71,83,160
714,0.16,"(9, 29)","(1, 4)",5,90,94,189,5,51,97,153
715,0.1,"(23, 16)","(25, 15)",16,89,104,209,3,21,6,30
716,0.18,"(4, 20)","(27, 25)",13,100,112,225,11,81,118,210
717,0.12,"(24, 16)","(0, 21)",5,101,105,211,6,51,88,145
718,0.1,"(23, 10)","(15, 18)",11,125,135,271,5,81,96,182
719,0.14,"(3, 10)","(2, 6)",4,98,101,203,5,31,14,50
720,0.14,"(7, 11)","(14, 6)",5,123,127,255,12,101,104,217
721,0.2,"(7, 6)","(13, 29)",4,72,75,151,11,71,197,279
722,0.16,"(7, 15)","(6, 8)",6,55,60,121,3,61,27,91
723,0.04,"(25, 9)","(17, 4)",3,63,65,131,5,111,204,320
724,0.1,"(20, 16)","(17, 22)",10,70,79,159,5,51,58,114
725,0.08,"(9, 28)","(10, 4)",3,101,103,207,8,91,97,196
726,0.16,"(5, 27)","(2, 19)",11,95,105,211,17,21,39,77
727,0.06,"(21, 1)","(13, 9)",4,74,77,155,3,41,77,121
728,0.1,"(16, 14)","(25, 29)",5,89,93,187,5,91,138,234
729,0.02,"(22, 13)","(9, 23)",4,89,92,185,7,231,256,494
730,0.18,"(7, 22)","(3, 16)",7,91,97,195,4,101,199,304
731,0.16,"(6, 26)","(22, 8)",13,69,81,163,4,61,95,160
732,0.18,"(1, 9)","(19, 23)",4,69,72,145,7,111,214,332
733,0.06,"(18, 2)","(4, 4)",6,45,50,101,11,161,265,437
734,0.12,"(25, 0)","(21, 22)",4,142,145,291,6,111,115,232
735,0.14,"(13, 3)","(16, 23)",6,86,91,183,7,51,118,176
736,0.06,"(28, 28)","(3, 1)",4,71,74,149,6,141,121,268
737,0.1,"(15, 23)","(22, 7)",16,97,112,225,8,71,93,172
738,0.2,"(3, 18)","(3, 1)",5,83,87,175,5,71,198,274
739,0.02,"(24, 7)","(13, 24)",7,176,182,365,9,101,97,207
740,0.18,"(1, 6)","(21, 4)",7,139,145,291,13,71,125,209
741,0.12,"(29, 1)","(12, 0)",14,98,111,223,3,71,56,130
742,0.02,"(8, 7)","(17, 0)",9,91,99,199,4,141,130,275
743,0.16,"(24, 26)","(27, 16)",11,108,118,237,11,111,212,334
744,0.14,"(10, 27)","(8, 1)",5,115,119,239,2,81,155,238
745,0.18,"(11, 29)","(15, 23)",5,91,95,191,13,101,73,187
746,0.08,"(7, 19)","(17, 17)",11,59,69,139,10,111,138,259
747,0.12,"(1, 22)","(17, 7)",4,99,102,205,6,41,97,144
748,0.12,"(10, 5)","(24, 4)",9,78,86,173,14,131,186,331
749,0.16,"(20, 5)","(19, 7)",11,21,31,63,4,1,4,9
750,0.1,"(17, 22)","(10, 3)",9,88,96,193,6,41,63,110
751,0.2,"(16, 20)","(20, 26)",14,94,107,215,11,41,47,99
752,0.18,"(20, 9)","(4, 18)",9,62,70,141,4,61,78,143
753,0.06,"(10, 25)","(14, 16)",4,15,18,37,10,41,55,106
754,0.12,"(14, 13)","(7, 5)",8,90,97,195,6,61,40,107
755,0.08,"(20, 1)","(12, 14)",15,87,101,203,6,31,58,95
756,0.06,"(5, 21)","(29, 3)",6,55,60,121,7,91,175,273
757,0.12,"(17, 21)","(16, 3)",5,58,62,125,4,81,141,226
758,0.08,"(16, 7)","(14, 23)",8,101,108,217,6,91,79,176
759,0.18,"(11, 23)","(22, 29)",21,176,196,393,5,61,150,216
760,0.16,"(18, 21)","(9, 13)",6,20,25,51,6,61,41,108
761,0.06,"(2, 9)","(22, 17)",4,121,124,249,8,121,135,264
762,0.18,"(12, 12)","(7, 28)",4,144,147,295,11,51,77,139
763,0.18,"(13, 3)","(15, 9)",3,78,80,161,3,91,60,154
764,0.1,"(20, 14)","(18, 15)",8,56,63,127,5,41,15,61
765,0.12,"(17, 2)","(6, 26)",5,91,95,191,8,91,149,248
766,0.04,"(22, 25)","(4, 6)",5,37,41,83,6,191,194,391
767,0.02,"(19, 8)","(15, 3)",8,173,180,361,8,141,180,329
768,0.12,"(22, 1)","(0, 16)",7,71,77,155,5,51,97,153
769,0.16,"(22, 26)","(24, 24)",9,104,112,225,8,71,67,146
770,0.2,"(20, 7)","(10, 29)",26,67,92,185,5,101,239,345
771,0.16,"(0, 17)","(7, 18)",7,118,124,249,17,31,45,93
772,0.06,"(28, 10)","(23, 24)",9,132,140,281,6,71,132,209
773,0.12,"(29, 9)","(20, 22)",8,125,132,265,6,81,163,250
774,0.04,"(5, 20)","(0, 10)",19,114,132,265,14,11,32,57
775,0.1,"(27, 14)","(4, 6)",5,127,131,263,6,91,75,172
776,0.12,"(6, 14)","(25, 22)",3,85,87,175,5,71,145,221
777,0.1,"(18, 18)","(22, 11)",13,52,64,129,11,51,87,149
778,0.08,"(29, 12)","(29, 26)",2,99,100,201,2,121,120,243
779,0.14,"(24, 9)","(1, 23)",6,52,57,115,5,71,74,150
780,0.16,"(7, 9)","(16, 23)",53,75,127,255,10,141,175,326
781,0.08,"(12, 14)","(9, 20)",10,35,44,89,4,91,74,169
782,0.16,"(24, 29)","(3, 7)",18,46,63,127,17,61,90,168
783,0.16,"(9, 9)","(20, 19)",9,95,103,207,6,81,226,313
784,0.02,"(9, 17)","(10, 22)",5,82,86,173,6,151,61,218
785,0.18,"(8, 7)","(11, 18)",11,87,97,195,5,61,64,130
786,0.16,"(6, 9)","(29, 24)",14,60,73,147,6,41,67,114
787,0.1,"(29, 2)","(22, 22)",4,99,102,205,6,101,196,303
788,0.16,"(23, 27)","(21, 5)",6,171,176,353,13,101,157,271
789,0.12,"(13, 2)","(19, 26)",10,68,77,155,7,111,177,295
790,0.18,"(15, 18)","(22, 14)",6,137,142,285,3,101,243,347
791,0.02,"(28, 6)","(0, 11)",6,252,257,515,2,61,63,126
792,0.06,"(1, 29)","(21, 14)",5,97,101,203,11,101,104,216
793,0.06,"(24, 29)","(13, 25)",3,15,17,35,7,81,56,144
794,0.14,"(20, 4)","(18, 8)",9,122,130,261,16,61,43,120
795,0.1,"(28, 21)","(29, 25)",2,37,38,77,5,51,54,110
796,0.06,"(7, 22)","(15, 18)",5,112,116,233,4,111,135,250
797,0.04,"(16, 22)","(17, 15)",8,128,135,271,6,121,69,196
798,0.02,"(26, 13)","(13, 0)",16,178,193,387,5,41,83,129
799,0.1,"(0, 18)","(19, 13)",2,75,76,153,13,111,138,262
800,0.12,"(21, 20)","(4, 16)",11,67,77,155,7,81,126,214
801,0.1,"(11, 29)","(12, 15)",9,93,101,203,4,71,108,183
802,0.08,"(22, 8)","(29, 26)",5,90,94,189,6,41,76,123
803,0.08,"(22, 27)","(9, 15)",4,78,81,163,4,121,136,261
804,0.08,"(0, 17)","(27, 20)",4,107,110,221,3,101,131,235
805,0.04,"(29, 11)","(19, 25)",3,183,185,371,12,111,143,266
806,0.18,"(23, 22)","(0, 11)",12,61,72,145,12,41,73,126
807,0.02,"(11, 29)","(10, 5)",6,163,168,337,14,161,140,315
808,0.2,"(10, 29)","(24, 14)",4,91,94,189,2,81,189,272
809,0.02,"(11, 27)","(15, 26)",4,57,60,121,7,121,45,173
810,0.08,"(10, 0)","(29, 16)",3,151,153,307,7,111,113,231
811,0.1,"(13, 27)","(10, 12)",5,86,90,181,7,101,83,191
812,0.14,"(7, 13)","(23, 23)",9,108,116,233,10,121,231,362
813,0.18,"(21, 7)","(5, 24)",6,54,59,119,11,61,203,275
814,0.02,"(10, 1)","(9, 22)",7,121,127,255,9,161,271,441
815,0.02,"(20, 15)","(0, 19)",6,59,64,129,4,61,77,142
816,0.2,"(1, 17)","(27, 3)",14,41,54,109,4,41,81,126
817,0.14,"(6, 17)","(19, 1)",15,66,80,161,12,81,138,231
818,0.16,"(18, 20)","(12, 29)",8,73,80,161,9,41,41,91
819,0.1,"(4, 2)","(14, 0)",6,104,109,219,3,61,66,130
820,0.16,"(13, 15)","(6, 21)",14,94,107,215,5,101,130,236
821,0.18,"(29, 16)","(10, 19)",14,110,123,247,8,51,53,112
822,0.06,"(11, 27)","(14, 18)",9,41,49,99,5,81,89,175
823,0.08,"(15, 12)","(6, 3)",5,61,65,131,5,101,56,162
824,0.16,"(4, 9)","(22, 11)",15,113,127,255,14,61,207,282
825,0.1,"(25, 23)","(23, 5)",8,119,126,253,5,91,172,268
826,0.06,"(16, 1)","(9, 28)",9,84,92,185,6,71,83,160
827,0.1,"(21, 10)","(27, 5)",5,102,106,213,17,51,107,175
828,0.04,"(0, 7)","(5, 9)",4,88,91,183,6,51,50,107
829,0.12,"(16, 4)","(3, 12)",2,73,74,149,4,71,73,148
830,0.12,"(10, 21)","(8, 29)",14,115,128,257,8,81,201,290
831,0.06,"(15, 5)","(25, 0)",8,95,102,205,10,71,129,210
832,0.08,"(5, 9)","(11, 4)",11,145,155,311,12,81,94,187
833,0.2,"(1, 22)","(22, 22)",15,180,194,389,11,121,189,321
834,0.14,"(1, 19)","(25, 14)",5,65,69,139,7,61,112,180
835,0.02,"(10, 4)","(29, 24)",15,65,79,159,26,51,85,162
836,0.14,"(13, 10)","(17, 19)",5,58,62,125,9,51,71,131
837,0.18,"(9, 27)","(22, 15)",14,27,40,81,19,141,266,426
838,0.16,"(9, 29)","(15, 24)",5,90,94,189,15,81,97,193
839,0.04,"(15, 29)","(22, 1)",17,123,139,279,2,91,137,230
840,0.06,"(0, 2)","(8, 20)",11,89,99,199,6,111,127,244
841,0.02,"(13, 27)","(3, 3)",6,168,173,347,9,101,121,231
842,0.02,"(29, 20)","(7, 16)",7,223,229,459,10,131,182,323
843,0.2,"(26, 27)","(8, 18)",10,82,91,183,7,71,239,317
844,0.04,"(12, 0)","(10, 26)",9,56,64,129,6,41,54,101
845,0.18,"(10, 17)","(13, 8)",6,13,18,37,8,81,92,181
846,0.12,"(25, 13)","(6, 2)",7,81,87,175,6,51,100,157
847,0.1,"(4, 23)","(7, 13)",5,90,94,189,9,61,100,170
848,0.12,"(22, 8)","(27, 27)",4,107,110,221,5,61,168,234
849,0.04,"(28, 26)","(16, 27)",14,121,134,269,6,151,164,321
850,0.08,"(8, 3)","(27, 17)",10,68,77,155,4,61,89,154
851,0.1,"(3, 2)","(3, 8)",5,147,151,303,5,71,39,115
852,0.1,"(17, 6)","(8, 19)",9,95,103,207,22,91,116,229
853,0.06,"(13, 9)","(15, 13)",16,7,22,45,6,91,91,188
854,0.2,"(21, 7)","(22, 7)",11,15,25,51,9,61,27,97
855,0.2,"(6, 5)","(29, 14)",5,68,72,145,8,91,306,405
856,0.14,"(15, 5)","(22, 22)",6,87,92,185,4,71,127,202
857,0.1,"(12, 2)","(1, 9)",11,118,128,257,3,41,32,76
858,0.1,"(16, 17)","(24, 23)",13,60,72,145,5,51,87,143
859,0.16,"(4, 9)","(27, 17)",6,79,84,169,20,41,90,151
860,0.04,"(25, 4)","(17, 13)",7,77,83,167,7,101,131,239
861,0.1,"(26, 25)","(19, 0)",8,189,196,393,3,71,159,233
862,0.04,"(13, 4)","(7, 9)",5,203,207,415,8,181,123,312
863,0.14,"(29, 4)","(7, 27)",18,66,83,167,5,71,101,177
864,0.08,"(0, 6)","(25, 14)",5,128,132,265,11,81,161,253
865,0.1,"(21, 15)","(20, 2)",29,143,171,343,6,101,109,216
866,0.14,"(3, 9)","(17, 9)",7,90,96,193,11,81,183,275
867,0.14,"(6, 13)","(12, 10)",13,106,118,237,9,31,53,93
868,0.06,"(5, 24)","(14, 15)",21,80,100,201,11,121,114,246
869,0.04,"(7, 9)","(10, 12)",29,154,182,365,11,131,202,344
870,0.04,"(21, 11)","(27, 15)",3,140,142,285,8,81,65,154
871,0.04,"(6, 2)","(22, 2)",14,108,121,243,14,141,195,350
872,0.2,"(17, 6)","(2, 13)",6,189,194,389,4,71,192,267
873,0.06,"(3, 2)","(2, 20)",9,117,125,251,6,81,88,175
874,0.12,"(17, 3)","(29, 0)",8,103,110,221,7,31,98,136
875,0.04,"(24, 12)","(28, 7)",5,120,124,249,8,61,44,113
876,0.06,"(10, 18)","(27, 10)",9,65,73,147,5,111,181,297
877,0.12,"(22, 0)","(23, 13)",4,128,131,263,12,31,72,115
878,0.08,"(1, 20)","(11, 25)",9,122,130,261,7,141,188,336
879,0.08,"(9, 16)","(24, 28)",8,88,95,191,11,41,47,99
880,0.2,"(12, 4)","(18, 19)",4,62,65,131,4,71,155,230
881,0.2,"(1, 28)","(9, 27)",8,106,113,227,3,31,49,83
882,0.14,"(16, 11)","(21, 9)",7,128,134,269,9,81,95,185
883,0.12,"(6, 18)","(27, 1)",12,43,54,109,7,21,55,83
884,0.12,"(22, 18)","(10, 24)",14,94,107,215,4,41,79,124
885,0.16,"(4, 22)","(27, 29)",6,103,108,217,8,41,101,150
886,0.1,"(2, 23)","(23, 10)",15,105,119,239,12,51,99,162
887,0.2,"(25, 15)","(2, 21)",3,119,121,243,5,61,89,155
888,0.16,"(8, 1)","(10, 23)",4,110,113,227,5,61,107,173
889,0.06,"(22, 8)","(19, 12)",4,67,70,141,6,41,38,85
890,0.14,"(23, 22)","(29, 17)",6,108,113,227,8,61,77,146
891,0.08,"(11, 7)","(9, 15)",12,12,23,47,5,111,158,274
892,0.04,"(5, 19)","(6, 17)",4,29,32,65,4,91,38,133
893,0.08,"(4, 24)","(20, 12)",3,121,123,247,5,81,132,218
894,0.06,"(10, 6)","(9, 2)",9,121,129,259,14,51,22,87
895,0.12,"(1, 7)","(20, 9)",6,121,126,253,6,101,149,256
896,0.2,"(3, 25)","(15, 15)",7,85,91,183,9,91,227,327
897,0.06,"(7, 5)","(17, 5)",11,169,179,359,5,111,75,191
898,0.16,"(0, 24)","(14, 29)",6,131,136,273,15,61,152,228
899,0.04,"(22, 24)","(28, 0)",8,143,150,301,20,151,187,358
900,0.2,"(7, 23)","(9, 28)",4,142,145,291,9,61,59,129
901,0.02,"(19, 4)","(24, 14)",10,97,106,213,5,171,134,310
902,0.04,"(5, 3)","(28, 10)",7,96,102,205,5,121,159,285
903,0.18,"(9, 6)","(1, 11)",9,114,122,245,31,81,75,187
904,0.18,"(5, 14)","(4, 2)",7,130,136,273,11,91,227,329
905,0.16,"(24, 14)","(16, 6)",5,82,86,173,5,61,81,147
906,0.06,"(28, 28)","(26, 14)",7,70,76,153,6,91,121,218
907,0.04,"(10, 20)","(24, 2)",3,77,79,159,8,131,96,235
908,0.06,"(5, 21)","(11, 10)",13,79,91,183,6,171,160,337
909,0.1,"(1, 11)","(27, 17)",7,69,75,151,16,91,112,219
910,0.04,"(15, 22)","(27, 13)",5,116,120,241,7,111,124,242
911,0.18,"(1, 4)","(10, 10)",3,102,104,209,4,71,68,143
912,0.02,"(17, 4)","(25, 1)",5,74,78,157,3,211,286,500
913,0.2,"(8, 23)","(18, 11)",5,76,80,161,6,41,176,223
914,0.2,"(24, 9)","(16, 12)",6,64,69,139,6,51,27,84
915,0.04,"(14, 27)","(26, 21)",5,100,104,209,3,81,84,168
916,0.16,"(16, 18)","(10, 13)",8,70,77,155,7,101,259,367
917,0.12,"(27, 13)","(16, 29)",5,63,67,135,10,61,126,197
918,0.08,"(26, 18)","(3, 17)",6,107,112,225,4,51,54,109
919,0.08,"(0, 21)","(25, 27)",6,150,155,311,12,101,113,226
920,0.04,"(15, 7)","(11, 5)",6,52,57,115,6,71,37,114
921,0.14,"(19, 10)","(10, 27)",13,86,98,197,7,91,87,185
922,0.14,"(23, 29)","(12, 5)",5,108,112,225,14,101,128,243
923,0.14,"(1, 14)","(5, 16)",17,34,50,101,7,91,69,167
924,0.2,"(17, 22)","(26, 26)",9,135,143,287,3,71,83,157
925,0.06,"(16, 3)","(11, 0)",5,90,94,189,5,111,95,211
926,0.08,"(17, 3)","(24, 17)",9,165,173,347,5,41,97,143
927,0.14,"(21, 24)","(15, 19)",11,100,110,221,5,71,109,185
928,0.2,"(14, 0)","(4, 23)",5,92,96,193,4,111,171,286
929,0.06,"(2, 6)","(12, 7)",5,99,103,207,10,101,138,249
930,0.08,"(15, 20)","(23, 29)",4,91,94,189,9,91,122,222
931,0.12,"(22, 28)","(10, 27)",8,49,56,113,7,91,74,172
932,0.14,"(29, 20)","(0, 5)",6,90,95,191,11,51,78,140
933,0.04,"(24, 29)","(14, 11)",12,86,97,195,3,101,106,210
934,0.06,"(11, 4)","(19, 9)",4,92,95,191,6,51,68,125
935,0.08,"(20, 24)","(17, 13)",6,90,95,191,5,161,207,373
936,0.2,"(19, 26)","(4, 15)",4,69,72,145,4,121,228,353
937,0.18,"(25, 17)","(17, 11)",7,16,22,45,6,61,57,124
938,0.04,"(5, 1)","(9, 10)",6,84,89,179,7,91,137,235
939,0.02,"(26, 26)","(29, 2)",5,128,132,265,6,51,91,148
940,0.12,"(24, 6)","(26, 28)",5,149,153,307,7,91,122,220
941,0.08,"(8, 0)","(2, 6)",3,120,122,245,9,61,59,129
942,0.06,"(12, 28)","(8, 25)",6,35,40,81,10,11,17,38
943,0.04,"(16, 23)","(23, 27)",7,124,130,261,6,131,98,235
944,0.1,"(20, 20)","(21, 20)",9,2,10,21,7,1,7,15
945,0.1,"(13, 12)","(24, 14)",12,112,123,247,8,91,84,183
946,0.16,"(15, 11)","(18, 10)",8,83,90,181,5,61,66,132
947,0.04,"(29, 9)","(29, 21)",11,138,148,297,12,71,63,146
948,0.06,"(0, 29)","(6, 15)",8,84,91,183,17,61,145,223
949,0.06,"(10, 28)","(5, 9)",4,82,85,171,4,91,79,174
950,0.18,"(26, 21)","(4, 23)",8,111,118,237,5,71,129,205
951,0.1,"(22, 15)","(26, 13)",9,65,73,147,18,91,85,194
952,0.2,"(10, 6)","(5, 10)",17,102,118,237,7,71,90,168
953,0.08,"(0, 19)","(18, 20)",4,115,118,237,4,101,159,264
954,0.2,"(21, 0)","(28, 8)",13,159,171,343,13,81,210,304
955,0.08,"(21, 14)","(23, 10)",10,92,101,203,5,141,114,260
956,0.14,"(26, 23)","(12, 9)",5,71,75,151,5,51,96,152
957,0.2,"(12, 10)","(2, 1)",6,99,104,209,5,101,195,301
958,0.08,"(23, 3)","(18, 7)",5,99,103,207,7,41,35,83
959,0.14,"(23, 18)","(17, 5)",5,67,71,143,8,81,70,159
960,0.02,"(3, 23)","(7, 24)",17,118,134,269,12,141,220,373
961,0.16,"(27, 13)","(3, 3)",9,95,103,207,4,71,109,184
962,0.08,"(25, 12)","(17, 16)",20,72,91,183,9,81,59,149
963,0.12,"(10, 14)","(7, 29)",5,118,122,245,17,81,141,239
964,0.16,"(16, 9)","(26, 19)",7,107,113,227,4,91,64,159
965,0.16,"(22, 20)","(23, 18)",9,140,148,297,9,61,45,115
966,0.2,"(3, 20)","(8, 11)",6,89,94,189,4,71,69,144
967,0.2,"(24, 2)","(15, 24)",6,74,79,159,4,81,147,232
968,0.2,"(17, 22)","(28, 8)",4,90,93,187,4,51,92,147
969,0.06,"(16, 24)","(24, 22)",4,121,124,249,4,41,70,115
970,0.18,"(8, 18)","(21, 1)",15,53,67,135,11,81,112,204
971,0.18,"(7, 25)","(20, 29)",8,100,107,215,17,41,73,131
972,0.14,"(18, 18)","(0, 12)",8,54,61,123,3,31,52,86
973,0.04,"(21, 22)","(25, 19)",6,85,90,181,16,61,40,117
974,0.08,"(3, 13)","(1, 8)",4,76,79,159,4,71,80,155
975,0.04,"(20, 19)","(10, 18)",11,191,201,403,8,201,210,419
976,0.12,"(26, 8)","(24, 19)",5,87,91,183,15,91,93,199
977,0.1,"(18, 18)","(29, 1)",6,129,134,269,5,61,137,203
978,0.04,"(15, 18)","(29, 24)",4,136,139,279,7,111,160,278
979,0.08,"(19, 11)","(11, 7)",6,91,96,193,10,81,67,158
980,0.06,"(5, 3)","(2, 1)",7,46,52,105,6,71,75,152
981,0.02,"(3, 7)","(23, 19)",12,70,81,163,7,221,178,406
982,0.16,"(27, 19)","(1, 28)",4,111,114,229,6,51,104,161
983,0.14,"(12, 27)","(0, 15)",11,153,163,327,12,71,152,235
984,0.12,"(26, 8)","(10, 3)",12,109,120,241,7,61,168,236
985,0.14,"(21, 26)","(8, 10)",3,70,72,145,4,111,131,246
986,0.1,"(28, 6)","(25, 29)",19,108,126,253,12,71,130,213
987,0.06,"(26, 3)","(16, 9)",4,87,90,181,8,91,95,194
988,0.14,"(17, 6)","(12, 0)",5,146,150,301,3,51,51,105
989,0.04,"(12, 21)","(24, 8)",7,93,99,199,10,121,176,307
990,0.04,"(22, 14)","(24, 23)",6,22,27,55,13,151,121,285
991,0.18,"(0, 0)","(21, 14)",4,101,104,209,6,101,162,269
992,0.12,"(24, 16)","(23, 29)",10,128,137,275,4,61,116,181
993,0.14,"(17, 17)","(13, 16)",16,104,119,239,10,81,81,172
994,0.06,"(26, 2)","(21, 10)",6,64,69,139,7,41,54,102
995,0.04,"(25, 13)","(27, 25)",41,110,150,301,10,111,129,250
996,0.08,"(3, 6)","(16, 8)",6,127,132,265,11,41,74,126
997,0.06,"(23, 21)","(16, 21)",17,104,120,241,7,61,36,104
998,0.16,"(14, 9)","(18, 16)",6,8,13,27,6,111,277,394
999,0.12,"(18, 2)","(23, 20)",4,88,91,183,5,61,91,157
