0,0.06,"(21, 29)","(10, 0)",7,97,89,193,3,107,74,184
1,0.02,"(19, 29)","(12, 28)",6,25,16,47,12,65,33,110
2,0.16,"(5, 17)","(23, 24)",11,103,99,213,11,79,59,149
3,0.1,"(14, 6)","(23, 25)",10,110,105,225,4,114,93,211
4,0.12,"(14, 15)","(0, 3)",8,84,77,169,16,149,151,316
5,0.2,"(15, 18)","(13, 15)",5,26,16,47,7,79,53,139
6,0.12,"(9, 13)","(21, 5)",7,66,58,131,10,184,161,355
7,0.1,"(26, 4)","(24, 0)",7,97,89,193,7,72,58,137
8,0.2,"(7, 23)","(14, 16)",10,93,88,191,9,65,50,124
9,0.16,"(16, 28)","(28, 21)",4,117,106,227,5,72,63,140
10,0.12,"(17, 11)","(7, 29)",5,95,85,185,21,114,103,238
11,0.14,"(18, 9)","(1, 22)",10,45,40,95,16,135,122,273
12,0.14,"(10, 11)","(19, 0)",12,150,147,309,21,100,106,227
13,0.14,"(12, 3)","(2, 14)",7,228,220,455,5,86,60,151
14,0.1,"(5, 2)","(27, 19)",6,94,85,185,4,149,124,277
15,0.02,"(21, 14)","(23, 20)",6,155,146,307,6,114,76,196
16,0.1,"(13, 18)","(0, 10)",4,44,33,81,8,30,25,63
17,0.1,"(9, 20)","(0, 7)",4,57,46,107,4,44,31,79
18,0.12,"(19, 7)","(26, 26)",13,118,116,247,4,51,46,101
19,0.18,"(1, 19)","(16, 29)",6,116,107,229,12,121,98,231
20,0.14,"(25, 17)","(19, 5)",21,93,99,213,10,107,96,213
21,0.04,"(27, 27)","(9, 19)",8,68,61,137,5,142,97,244
22,0.06,"(2, 23)","(0, 5)",8,106,99,213,12,114,105,231
23,0.16,"(13, 25)","(12, 26)",6,1,6,13,5,37,23,65
24,0.08,"(9, 17)","(16, 15)",4,66,55,125,4,79,53,136
25,0.1,"(6, 28)","(3, 15)",21,48,54,123,7,79,56,142
26,0.2,"(6, 3)","(25, 24)",7,81,73,161,3,170,148,321
27,0.06,"(14, 0)","(19, 16)",12,90,87,189,11,107,75,193
28,0.02,"(9, 19)","(3, 0)",4,121,110,235,5,142,124,271
29,0.06,"(11, 13)","(1, 14)",4,34,23,61,4,100,83,187
30,0.2,"(25, 28)","(13, 23)",2,80,67,149,12,107,101,220
31,0.08,"(8, 29)","(3, 18)",17,62,64,143,8,23,22,53
32,0.08,"(3, 20)","(27, 3)",8,102,95,205,6,156,133,295
33,0.02,"(25, 9)","(0, 7)",4,171,160,335,3,142,87,232
34,0.02,"(1, 6)","(24, 15)",3,241,229,473,2,86,78,166
35,0.14,"(23, 16)","(4, 13)",13,40,38,91,7,72,56,135
36,0.08,"(7, 28)","(7, 6)",8,59,52,119,7,86,66,159
37,0.02,"(28, 8)","(7, 18)",4,72,61,137,3,86,47,136
38,0.1,"(15, 2)","(2, 0)",5,111,101,217,21,100,73,194
39,0.06,"(21, 26)","(19, 13)",5,161,151,317,6,121,93,220
40,0.1,"(3, 14)","(7, 24)",10,97,92,199,6,58,43,107
41,0.14,"(22, 19)","(2, 7)",4,74,63,141,6,135,114,255
42,0.02,"(6, 20)","(25, 2)",6,115,106,227,6,93,85,184
43,0.06,"(4, 1)","(19, 15)",4,102,91,197,13,142,110,265
44,0.2,"(9, 17)","(4, 0)",6,119,110,235,10,156,152,318
45,0.2,"(7, 1)","(0, 22)",5,130,120,255,6,93,74,173
46,0.2,"(5, 7)","(7, 19)",6,54,45,105,3,86,73,162
47,0.04,"(17, 23)","(8, 23)",11,87,83,181,7,107,58,172
48,0.12,"(22, 3)","(13, 5)",6,49,40,95,16,51,54,121
49,0.08,"(7, 2)","(2, 3)",19,24,28,71,9,72,62,143
50,0.06,"(26, 25)","(24, 11)",7,103,95,205,5,86,71,162
51,0.04,"(4, 26)","(25, 23)",4,120,109,233,5,170,113,288
52,0.02,"(17, 16)","(5, 23)",6,159,150,315,5,128,106,239
53,0.08,"(13, 6)","(23, 14)",8,125,118,251,5,100,69,174
54,0.16,"(4, 29)","(26, 10)",6,86,77,169,7,142,120,269
55,0.06,"(24, 22)","(4, 12)",10,92,87,189,6,156,114,276
56,0.12,"(29, 18)","(5, 21)",8,85,78,171,4,107,78,189
57,0.06,"(8, 18)","(6, 19)",4,55,44,103,8,51,20,79
58,0.18,"(4, 12)","(20, 19)",4,37,26,67,10,86,59,155
59,0.2,"(6, 18)","(13, 14)",11,75,71,157,5,72,64,141
60,0.14,"(1, 7)","(19, 2)",3,143,131,277,13,79,71,163
61,0.12,"(28, 1)","(10, 0)",6,71,62,139,5,128,87,220
62,0.2,"(18, 26)","(1, 28)",6,98,89,193,3,107,79,189
63,0.16,"(0, 10)","(11, 24)",10,138,133,281,3,86,72,161
64,0.16,"(23, 21)","(17, 4)",9,95,89,193,10,107,88,205
65,0.1,"(15, 20)","(28, 19)",15,75,75,165,20,149,140,309
66,0.18,"(22, 16)","(15, 14)",16,28,29,73,11,44,45,100
67,0.14,"(6, 24)","(19, 27)",5,80,70,155,7,93,70,170
68,0.08,"(29, 25)","(18, 19)",20,83,88,191,3,72,56,131
69,0.08,"(24, 8)","(4, 22)",6,139,130,275,13,107,70,190
70,0.2,"(7, 3)","(26, 10)",10,172,167,349,4,93,72,169
71,0.08,"(15, 19)","(25, 27)",5,143,133,281,8,86,68,162
72,0.18,"(26, 28)","(23, 1)",19,102,106,227,8,100,92,200
73,0.14,"(27, 23)","(8, 7)",11,48,44,103,9,86,68,163
74,0.2,"(6, 17)","(28, 5)",13,70,68,151,5,114,105,224
75,0.08,"(11, 5)","(3, 5)",8,33,26,67,6,65,28,99
76,0.08,"(19, 18)","(19, 8)",6,118,109,233,4,163,143,310
77,0.1,"(14, 17)","(4, 13)",20,55,60,135,6,79,73,158
78,0.1,"(21, 7)","(25, 3)",7,82,74,163,6,100,70,176
79,0.14,"(7, 21)","(27, 14)",8,98,91,197,5,93,80,178
80,0.16,"(12, 17)","(4, 10)",3,40,28,71,7,37,27,71
81,0.18,"(8, 23)","(28, 9)",6,93,84,183,6,93,76,175
82,0.18,"(0, 5)","(7, 13)",9,63,57,129,9,44,36,89
83,0.08,"(19, 17)","(9, 29)",12,98,95,205,9,100,72,181
84,0.1,"(8, 24)","(19, 25)",6,80,71,157,5,51,41,97
85,0.12,"(8, 11)","(12, 4)",7,106,98,211,14,100,76,190
86,0.16,"(2, 18)","(9, 25)",7,77,69,153,8,37,36,81
87,0.06,"(7, 22)","(11, 0)",6,107,98,211,4,58,38,100
88,0.16,"(6, 16)","(26, 10)",13,67,65,145,8,58,53,119
89,0.18,"(2, 24)","(29, 1)",5,68,58,131,11,107,92,210
90,0.06,"(5, 19)","(27, 5)",14,64,63,141,7,128,106,241
91,0.08,"(14, 13)","(9, 11)",3,89,77,169,4,44,30,78
92,0.1,"(20, 11)","(14, 6)",16,31,32,79,6,44,30,80
93,0.02,"(15, 14)","(6, 8)",6,74,65,145,6,135,95,236
94,0.2,"(19, 17)","(13, 4)",19,167,171,357,10,100,85,195
95,0.18,"(25, 29)","(19, 29)",5,41,31,77,4,30,14,48
96,0.1,"(3, 4)","(14, 21)",10,81,76,167,9,114,85,208
97,0.02,"(26, 17)","(19, 0)",7,160,152,319,4,149,141,294
98,0.08,"(24, 11)","(4, 9)",3,62,50,115,3,114,86,203
99,0.18,"(17, 0)","(10, 7)",6,92,83,181,14,44,38,96
100,0.1,"(26, 2)","(10, 23)",4,115,104,223,7,142,123,272
101,0.12,"(29, 1)","(16, 12)",26,78,89,193,4,58,48,110
102,0.02,"(4, 9)","(16, 0)",10,128,123,261,16,93,91,200
103,0.2,"(23, 24)","(1, 23)",9,200,194,403,7,149,136,292
104,0.04,"(0, 1)","(11, 4)",2,63,50,115,10,100,66,176
105,0.16,"(7, 22)","(17, 18)",5,52,42,99,10,107,84,201
106,0.14,"(5, 25)","(20, 9)",4,119,108,231,4,72,59,135
107,0.16,"(26, 23)","(25, 9)",7,100,92,199,10,156,134,300
108,0.12,"(19, 22)","(22, 22)",4,29,18,51,20,51,33,104
109,0.16,"(12, 29)","(0, 28)",12,23,20,55,8,37,30,75
110,0.02,"(19, 27)","(23, 5)",8,146,139,293,8,114,70,192
111,0.12,"(6, 5)","(18, 8)",10,78,73,161,13,37,41,91
112,0.18,"(21, 11)","(5, 27)",15,80,80,175,5,86,58,149
113,0.02,"(23, 9)","(27, 24)",16,147,148,311,7,72,70,149
114,0.08,"(10, 21)","(8, 9)",12,72,69,153,6,107,80,193
115,0.1,"(9, 25)","(3, 19)",7,47,39,93,9,30,24,63
116,0.04,"(24, 11)","(11, 25)",5,86,76,167,7,58,56,121
117,0.18,"(0, 10)","(4, 16)",20,24,29,73,3,51,24,78
118,0.06,"(20, 22)","(0, 0)",9,59,53,121,4,142,128,274
119,0.06,"(7, 11)","(3, 27)",6,88,79,173,12,163,136,311
120,0.16,"(5, 9)","(23, 6)",4,162,151,317,11,121,88,220
121,0.14,"(10, 20)","(1, 29)",8,123,116,247,3,142,131,276
122,0.08,"(2, 26)","(29, 21)",8,129,122,259,5,93,87,185
123,0.04,"(22, 19)","(4, 10)",7,99,91,197,7,51,33,91
124,0.12,"(26, 28)","(13, 6)",5,52,42,99,5,149,140,294
125,0.1,"(13, 5)","(19, 17)",8,96,89,193,13,142,116,271
126,0.16,"(11, 11)","(20, 9)",5,86,76,167,9,72,64,145
127,0.18,"(15, 12)","(20, 6)",52,50,87,189,18,65,69,152
128,0.02,"(5, 19)","(5, 4)",10,163,158,331,7,233,151,391
129,0.02,"(25, 16)","(24, 19)",7,103,95,205,12,58,27,97
130,0.16,"(5, 9)","(13, 23)",10,83,78,171,10,107,99,216
131,0.14,"(10, 25)","(3, 1)",10,107,102,219,17,114,120,251
132,0.04,"(8, 0)","(13, 22)",4,175,164,343,6,205,134,345
133,0.16,"(12, 3)","(13, 17)",6,78,69,153,7,65,52,124
134,0.14,"(24, 20)","(22, 3)",5,100,90,195,10,51,40,101
135,0.02,"(0, 29)","(8, 29)",8,42,35,85,2,170,98,270
136,0.14,"(12, 22)","(5, 17)",12,66,63,141,5,72,37,114
137,0.1,"(16, 11)","(19, 10)",11,67,63,141,4,114,69,187
138,0.04,"(28, 9)","(2, 14)",6,83,74,163,8,114,75,197
139,0.16,"(5, 8)","(29, 23)",6,84,75,165,10,58,53,121
140,0.06,"(20, 17)","(1, 18)",6,45,36,87,6,86,71,163
141,0.14,"(19, 2)","(22, 26)",15,188,188,391,4,58,51,113
142,0.12,"(11, 16)","(6, 17)",4,21,10,35,6,30,15,51
143,0.04,"(20, 17)","(12, 7)",5,65,55,125,20,58,54,132
144,0.08,"(8, 4)","(27, 23)",8,124,117,249,4,86,60,150
145,0.1,"(14, 2)","(6, 22)",8,127,120,255,7,72,53,132
146,0.04,"(17, 7)","(14, 12)",3,73,61,137,5,142,129,276
147,0.2,"(16, 0)","(6, 9)",7,120,112,239,12,65,60,137
148,0.18,"(2, 2)","(0, 10)",5,27,17,49,6,44,21,71
149,0.2,"(12, 27)","(24, 5)",4,101,90,195,5,79,60,144
150,0.2,"(29, 4)","(10, 12)",20,96,101,217,7,51,44,102
151,0.14,"(18, 3)","(29, 10)",16,91,92,199,8,121,120,249
152,0.14,"(23, 24)","(2, 21)",7,50,42,99,7,79,68,154
153,0.18,"(27, 10)","(10, 1)",5,134,124,263,5,128,108,241
154,0.1,"(29, 2)","(24, 26)",4,110,99,213,6,128,99,233
155,0.02,"(7, 17)","(11, 23)",6,174,165,345,7,107,59,173
156,0.1,"(11, 7)","(24, 10)",6,71,62,139,6,114,87,207
157,0.08,"(25, 14)","(13, 19)",3,135,123,261,6,100,88,194
158,0.08,"(27, 27)","(29, 17)",3,152,140,295,3,65,37,105
159,0.1,"(5, 6)","(26, 26)",5,76,66,147,6,114,70,190
160,0.02,"(3, 20)","(3, 25)",5,88,78,171,5,198,149,352
161,0.12,"(0, 10)","(27, 1)",5,123,113,241,7,121,98,226
162,0.16,"(0, 10)","(1, 24)",5,71,61,137,3,79,70,152
163,0.08,"(4, 18)","(21, 9)",5,67,57,129,8,79,68,155
164,0.08,"(29, 20)","(25, 8)",11,91,87,189,3,72,44,119
165,0.06,"(23, 2)","(15, 17)",17,73,75,165,11,198,137,346
166,0.1,"(13, 0)","(11, 10)",5,130,120,255,7,58,49,114
167,0.16,"(12, 9)","(10, 15)",7,112,104,223,11,72,48,131
168,0.16,"(25, 21)","(0, 3)",21,68,74,163,7,65,52,124
169,0.1,"(23, 29)","(29, 18)",8,60,53,121,2,107,87,196
170,0.02,"(18, 13)","(24, 19)",4,101,90,195,10,79,64,153
171,0.18,"(10, 8)","(9, 9)",4,73,62,139,4,51,36,91
172,0.08,"(4, 12)","(20, 21)",4,84,73,161,5,100,83,188
173,0.02,"(21, 0)","(19, 3)",5,121,111,237,4,198,100,302
174,0.2,"(18, 0)","(14, 15)",3,124,112,239,5,72,55,132
175,0.06,"(5, 4)","(7, 13)",2,43,30,75,5,79,51,135
176,0.06,"(0, 18)","(7, 5)",7,47,39,93,11,114,81,206
177,0.06,"(10, 1)","(28, 9)",10,135,130,275,10,93,88,191
178,0.08,"(0, 13)","(3, 23)",18,74,77,169,4,100,65,169
179,0.12,"(14, 26)","(19, 8)",14,101,100,215,10,100,62,172
180,0.16,"(0, 4)","(14, 6)",6,180,171,357,5,72,67,144
181,0.18,"(20, 20)","(29, 8)",6,130,121,257,4,93,87,184
182,0.12,"(22, 29)","(13, 23)",4,62,51,117,3,58,26,87
183,0.14,"(4, 1)","(21, 29)",3,169,157,329,9,142,133,284
184,0.14,"(0, 8)","(24, 5)",9,105,99,213,9,93,85,187
185,0.04,"(22, 10)","(21, 20)",18,76,79,173,3,79,50,132
186,0.16,"(4, 26)","(22, 4)",3,89,77,169,11,86,62,159
187,0.08,"(25, 0)","(15, 21)",5,128,118,251,5,93,76,174
188,0.14,"(22, 24)","(26, 5)",9,133,127,269,5,128,115,248
189,0.12,"(16, 28)","(7, 1)",9,80,74,163,6,156,141,303
190,0.1,"(14, 25)","(25, 15)",13,118,116,247,8,156,143,307
191,0.16,"(14, 26)","(15, 6)",12,85,82,179,12,44,47,103
192,0.02,"(3, 13)","(6, 7)",4,69,58,131,8,51,48,107
193,0.16,"(13, 12)","(27, 0)",4,138,127,269,9,79,64,152
194,0.16,"(3, 26)","(28, 1)",8,69,62,139,3,121,109,233
195,0.1,"(21, 14)","(21, 3)",6,97,88,191,4,86,56,146
196,0.1,"(9, 18)","(20, 29)",7,200,192,399,14,184,172,370
197,0.06,"(0, 8)","(9, 10)",11,82,78,171,10,114,72,196
198,0.16,"(5, 7)","(18, 29)",10,49,44,103,16,93,86,195
199,0.2,"(4, 12)","(5, 26)",4,178,167,349,8,135,134,277
200,0.04,"(2, 7)","(20, 23)",6,72,63,141,8,135,134,277
201,0.06,"(1, 20)","(22, 18)",9,119,113,241,6,58,54,118
202,0.18,"(21, 20)","(3, 27)",3,173,161,337,6,100,85,191
203,0.04,"(12, 0)","(9, 5)",10,21,16,47,23,58,55,136
204,0.06,"(2, 29)","(18, 3)",4,130,119,253,6,163,118,287
205,0.02,"(21, 12)","(4, 14)",3,113,101,217,3,149,91,243
206,0.14,"(9, 13)","(12, 3)",8,69,62,139,22,58,62,142
207,0.16,"(23, 4)","(28, 1)",4,59,48,111,8,79,52,139
208,0.08,"(23, 13)","(29, 6)",9,132,126,267,8,121,115,244
209,0.08,"(4, 11)","(21, 13)",4,104,93,201,13,72,64,149
210,0.12,"(11, 29)","(6, 19)",8,83,76,167,12,142,119,273
211,0.1,"(12, 5)","(14, 0)",10,66,61,137,5,114,73,192
212,0.1,"(16, 27)","(27, 25)",26,61,72,159,7,72,57,136
213,0.1,"(27, 13)","(15, 29)",6,131,122,259,5,121,97,223
214,0.16,"(21, 29)","(3, 28)",5,141,131,277,3,114,88,205
215,0.1,"(27, 27)","(23, 16)",7,88,80,175,11,37,39,87
216,0.04,"(27, 25)","(16, 13)",5,163,153,321,4,58,47,109
217,0.12,"(1, 29)","(17, 25)",6,83,74,163,5,142,121,268
218,0.18,"(11, 9)","(17, 28)",6,86,77,169,7,93,73,173
219,0.04,"(20, 16)","(27, 28)",31,114,130,275,12,128,113,253
220,0.02,"(7, 0)","(3, 11)",12,130,127,269,4,128,73,205
221,0.02,"(27, 24)","(10, 24)",7,132,124,263,4,282,204,490
222,0.12,"(12, 14)","(17, 20)",11,106,102,219,15,114,97,226
223,0.16,"(27, 9)","(0, 16)",6,74,65,145,4,86,74,164
224,0.02,"(12, 25)","(26, 23)",17,80,82,179,11,79,64,154
225,0.16,"(3, 26)","(20, 26)",8,127,120,255,6,135,109,250
226,0.12,"(16, 23)","(8, 12)",12,78,75,165,11,114,98,223
227,0.16,"(11, 0)","(9, 7)",21,48,54,123,14,72,57,143
228,0.14,"(17, 12)","(5, 16)",16,60,61,137,15,86,64,165
229,0.18,"(2, 15)","(15, 12)",12,105,102,219,36,51,72,159
230,0.08,"(14, 17)","(29, 9)",5,103,93,201,8,107,93,208
231,0.18,"(19, 3)","(16, 5)",3,39,27,69,4,44,28,76
232,0.14,"(21, 9)","(0, 19)",19,80,84,183,13,128,112,253
233,0.16,"(9, 15)","(21, 0)",15,68,68,151,8,86,68,162
234,0.1,"(0, 29)","(29, 10)",7,92,84,183,5,107,85,197
235,0.16,"(26, 2)","(5, 18)",7,108,100,215,3,86,67,156
236,0.04,"(16, 12)","(19, 1)",7,113,105,225,13,93,79,185
237,0.12,"(20, 16)","(12, 23)",7,51,43,101,9,65,65,139
238,0.06,"(7, 15)","(17, 24)",13,96,94,203,9,86,63,158
239,0.16,"(19, 18)","(29, 28)",3,92,80,175,3,128,106,237
240,0.06,"(4, 12)","(26, 23)",9,70,64,143,9,114,77,200
241,0.2,"(7, 0)","(1, 17)",9,130,124,263,5,128,108,241
242,0.06,"(6, 7)","(25, 17)",13,135,133,281,6,93,85,184
243,0.16,"(3, 6)","(14, 27)",4,96,85,185,16,107,90,213
244,0.2,"(10, 0)","(27, 6)",7,123,115,245,4,191,163,358
245,0.02,"(17, 21)","(5, 14)",5,87,77,169,3,233,167,403
246,0.18,"(23, 25)","(19, 4)",6,103,94,203,10,65,54,129
247,0.1,"(14, 6)","(19, 24)",3,116,104,223,13,114,102,229
248,0.2,"(2, 23)","(29, 9)",11,80,76,167,6,156,137,299
249,0.12,"(10, 13)","(1, 13)",4,23,12,39,7,51,35,93
250,0.08,"(12, 11)","(2, 29)",20,97,102,219,10,100,86,196
251,0.02,"(11, 23)","(22, 15)",9,87,81,177,12,254,211,477
252,0.06,"(15, 17)","(19, 20)",9,88,82,179,11,86,63,160
253,0.12,"(14, 10)","(23, 27)",4,69,58,131,9,128,103,240
254,0.04,"(19, 29)","(8, 22)",8,121,114,243,5,149,86,240
255,0.04,"(11, 4)","(6, 21)",8,69,62,139,8,93,64,165
256,0.16,"(5, 7)","(2, 10)",10,44,39,93,11,37,35,83
257,0.18,"(1, 7)","(2, 22)",12,29,26,67,3,100,66,169
258,0.08,"(4, 9)","(4, 15)",11,38,34,83,17,44,41,102
259,0.14,"(11, 0)","(13, 26)",5,99,89,193,3,114,90,207
260,0.06,"(11, 15)","(18, 5)",5,140,130,275,6,58,51,115
261,0.1,"(11, 8)","(17, 21)",6,100,91,197,6,58,42,106
262,0.02,"(25, 3)","(22, 3)",30,66,81,177,26,100,99,225
263,0.08,"(23, 21)","(10, 17)",6,65,56,127,4,107,64,175
264,0.14,"(14, 10)","(21, 12)",4,93,82,179,10,93,89,192
265,0.2,"(9, 8)","(11, 22)",6,65,56,127,6,72,42,120
266,0.04,"(22, 12)","(27, 15)",6,57,48,111,11,86,68,165
267,0.16,"(2, 11)","(8, 14)",9,67,61,137,15,79,61,155
268,0.02,"(1, 5)","(26, 19)",5,103,93,201,7,135,104,246
269,0.02,"(7, 6)","(22, 14)",4,102,91,197,4,184,111,299
270,0.08,"(5, 27)","(16, 15)",11,141,137,289,7,79,68,154
271,0.1,"(29, 7)","(7, 7)",7,63,55,125,9,86,68,163
272,0.1,"(22, 18)","(1, 6)",10,68,63,141,3,114,84,201
273,0.04,"(16, 13)","(10, 28)",7,63,55,125,15,114,99,228
274,0.12,"(25, 13)","(4, 23)",9,60,54,123,7,86,66,159
275,0.14,"(18, 12)","(29, 24)",5,149,139,293,9,254,253,516
276,0.14,"(5, 25)","(7, 5)",9,134,128,271,15,72,54,141
277,0.14,"(21, 26)","(13, 4)",15,82,82,179,5,86,67,158
278,0.02,"(5, 12)","(2, 23)",5,49,39,93,7,121,87,215
279,0.02,"(7, 27)","(25, 24)",5,125,115,245,7,93,72,172
280,0.12,"(9, 9)","(17, 7)",6,109,100,215,5,65,47,117
281,0.04,"(23, 19)","(1, 11)",6,82,73,161,6,72,69,147
282,0.14,"(21, 24)","(23, 3)",12,126,123,261,6,93,66,165
283,0.16,"(25, 29)","(3, 11)",9,91,85,185,8,114,91,213
284,0.08,"(28, 3)","(10, 14)",3,121,109,233,5,163,105,273
285,0.04,"(25, 4)","(21, 29)",12,125,122,259,23,156,143,322
286,0.04,"(27, 8)","(27, 3)",24,37,46,107,16,79,47,142
287,0.18,"(23, 6)","(17, 4)",4,33,22,59,12,30,28,70
288,0.1,"(29, 7)","(23, 2)",14,66,65,145,5,51,36,92
289,0.18,"(6, 2)","(1, 24)",12,120,117,249,23,79,82,184
290,0.04,"(24, 12)","(17, 1)",4,91,80,175,5,100,79,184
291,0.1,"(14, 23)","(9, 20)",14,90,89,193,6,30,17,53
292,0.1,"(7, 4)","(4, 28)",20,60,65,145,9,86,73,168
293,0.16,"(24, 23)","(28, 21)",12,81,78,171,6,51,38,95
294,0.1,"(11, 2)","(28, 14)",7,115,107,229,4,79,57,140
295,0.02,"(12, 15)","(1, 21)",25,96,106,227,10,121,93,224
296,0.18,"(18, 15)","(29, 28)",6,136,127,269,6,177,148,331
297,0.12,"(19, 10)","(24, 21)",8,104,97,209,6,107,88,201
298,0.06,"(6, 16)","(28, 9)",5,154,144,303,5,156,125,286
299,0.1,"(20, 15)","(25, 28)",23,82,90,195,39,184,194,417
300,0.04,"(19, 4)","(20, 8)",23,91,99,213,4,51,36,91
301,0.02,"(12, 20)","(21, 17)",7,150,142,299,4,128,82,214
302,0.04,"(18, 23)","(27, 25)",4,62,51,117,7,121,109,237
303,0.06,"(1, 3)","(0, 16)",7,33,25,65,11,51,35,97
304,0.06,"(15, 9)","(10, 17)",7,101,93,201,6,107,79,192
305,0.16,"(16, 15)","(7, 4)",17,58,60,135,18,79,85,182
306,0.14,"(8, 26)","(5, 7)",5,150,140,295,5,107,93,205
307,0.08,"(10, 5)","(1, 21)",8,67,60,135,5,107,93,205
308,0.16,"(0, 10)","(27, 5)",2,104,91,197,5,149,128,282
309,0.1,"(20, 11)","(1, 3)",19,113,117,249,10,135,105,250
310,0.04,"(16, 2)","(4, 15)",9,49,43,101,8,268,231,507
311,0.08,"(0, 8)","(11, 24)",3,64,52,119,10,79,55,144
312,0.08,"(18, 28)","(4, 27)",9,78,72,159,7,121,108,236
313,0.04,"(5, 23)","(24, 18)",12,177,174,363,3,79,63,145
314,0.2,"(4, 0)","(13, 18)",5,109,99,213,10,65,58,133
315,0.18,"(2, 28)","(13, 25)",6,81,72,159,15,37,37,89
316,0.04,"(14, 14)","(21, 2)",10,141,136,287,7,86,73,166
317,0.2,"(4, 28)","(19, 17)",15,123,123,261,6,100,71,177
318,0.02,"(23, 3)","(20, 13)",7,129,121,257,25,212,138,375
319,0.14,"(15, 19)","(17, 0)",7,160,152,319,24,114,114,252
320,0.02,"(11, 16)","(21, 27)",5,85,75,165,5,128,112,245
321,0.2,"(8, 28)","(3, 19)",13,42,40,95,15,58,55,128
322,0.04,"(28, 4)","(27, 17)",4,78,67,149,5,86,53,144
323,0.2,"(29, 26)","(13, 12)",7,95,87,189,5,51,39,95
324,0.06,"(10, 3)","(1, 9)",11,86,82,179,4,51,26,81
325,0.12,"(4, 20)","(20, 16)",15,70,70,155,10,51,49,110
326,0.2,"(1, 21)","(4, 17)",5,28,18,51,4,51,35,90
327,0.12,"(22, 16)","(11, 29)",5,107,97,209,12,93,70,175
328,0.14,"(4, 28)","(16, 7)",6,89,80,175,3,86,63,152
329,0.06,"(21, 3)","(10, 6)",5,50,40,95,11,44,42,97
330,0.14,"(18, 10)","(28, 5)",8,99,92,199,7,72,60,139
331,0.2,"(18, 20)","(16, 24)",3,30,18,51,8,79,61,148
332,0.08,"(14, 18)","(7, 28)",12,64,61,137,7,79,66,152
333,0.2,"(24, 26)","(24, 29)",9,20,14,43,5,44,33,82
334,0.2,"(6, 2)","(4, 28)",4,94,83,181,7,107,94,208
335,0.08,"(27, 2)","(8, 27)",4,85,74,163,6,86,75,167
336,0.02,"(6, 28)","(19, 14)",5,98,88,191,10,79,71,160
337,0.2,"(5, 9)","(0, 28)",8,168,161,337,8,191,181,380
338,0.12,"(7, 21)","(13, 19)",6,58,49,113,5,86,69,160
339,0.18,"(19, 2)","(29, 9)",4,152,141,297,4,58,51,113
340,0.06,"(21, 11)","(27, 19)",6,93,84,183,10,51,46,107
341,0.14,"(15, 21)","(15, 22)",12,32,29,73,24,44,39,107
342,0.04,"(6, 1)","(19, 5)",6,138,129,273,9,163,108,280
343,0.14,"(0, 23)","(2, 16)",14,25,24,63,6,16,13,35
344,0.16,"(9, 6)","(24, 4)",15,115,115,245,4,72,58,134
345,0.02,"(13, 26)","(0, 2)",6,99,90,195,10,149,109,268
346,0.18,"(17, 1)","(6, 22)",3,75,63,141,6,128,93,227
347,0.16,"(29, 1)","(14, 4)",2,43,30,75,3,37,21,61
348,0.08,"(17, 23)","(27, 14)",10,101,96,207,12,114,89,215
349,0.04,"(17, 1)","(16, 18)",5,143,133,281,12,177,158,347
350,0.04,"(18, 28)","(27, 19)",5,99,89,193,4,163,125,292
351,0.12,"(1, 22)","(21, 29)",3,147,135,285,4,107,82,193
352,0.2,"(15, 16)","(27, 18)",14,111,110,235,10,72,69,151
353,0.18,"(28, 6)","(22, 4)",9,56,50,115,6,23,15,44
354,0.02,"(3, 11)","(28, 24)",6,70,61,137,10,100,83,193
355,0.06,"(14, 4)","(4, 7)",9,111,105,225,9,30,29,68
356,0.08,"(11, 14)","(22, 6)",3,115,103,221,8,93,73,174
357,0.06,"(3, 24)","(17, 13)",12,126,123,261,6,135,100,241
358,0.04,"(19, 10)","(14, 8)",5,163,153,321,16,72,42,130
359,0.02,"(7, 8)","(24, 21)",3,96,84,183,14,121,110,245
360,0.02,"(13, 8)","(26, 20)",8,105,98,211,6,226,171,403
361,0.02,"(18, 11)","(13, 14)",8,36,29,73,6,51,29,86
362,0.14,"(29, 5)","(15, 6)",24,77,86,187,15,58,44,117
363,0.02,"(19, 5)","(3, 16)",5,80,70,155,13,51,43,107
364,0.06,"(18, 2)","(12, 2)",6,20,11,37,3,100,49,152
365,0.02,"(14, 0)","(2, 27)",14,68,67,149,15,156,101,272
366,0.04,"(20, 27)","(21, 16)",13,113,111,237,5,107,65,177
367,0.12,"(4, 0)","(7, 5)",4,36,25,65,12,44,34,90
368,0.04,"(15, 7)","(17, 20)",3,80,68,151,3,100,56,159
369,0.06,"(18, 6)","(18, 15)",6,126,117,249,15,135,122,272
370,0.18,"(2, 7)","(22, 17)",5,116,106,227,7,72,58,137
371,0.18,"(3, 11)","(12, 15)",15,123,123,261,7,93,74,174
372,0.1,"(0, 0)","(4, 6)",4,23,12,39,5,30,15,50
373,0.16,"(10, 14)","(8, 6)",8,70,63,141,4,79,55,138
374,0.14,"(12, 13)","(26, 28)",15,153,153,321,6,114,103,223
375,0.16,"(2, 0)","(9, 11)",8,42,35,85,23,58,58,139
376,0.18,"(1, 21)","(13, 12)",10,101,96,207,5,114,100,219
377,0.12,"(23, 22)","(28, 20)",9,60,54,123,15,58,43,116
378,0.2,"(18, 16)","(2, 14)",9,79,73,161,12,58,41,111
379,0.18,"(23, 7)","(15, 13)",6,51,42,99,5,44,35,84
380,0.18,"(20, 29)","(0, 5)",5,57,47,109,9,135,122,266
381,0.14,"(0, 20)","(25, 18)",6,96,87,189,5,121,104,230
382,0.08,"(21, 28)","(9, 2)",6,158,149,313,8,128,109,245
383,0.12,"(8, 17)","(20, 8)",102,140,227,469,39,86,96,221
384,0.08,"(13, 8)","(15, 8)",5,59,49,113,6,65,38,109
385,0.18,"(21, 26)","(19, 6)",11,128,124,263,7,107,99,213
386,0.1,"(5, 9)","(21, 10)",5,84,74,163,7,51,43,101
387,0.12,"(17, 25)","(12, 4)",7,93,85,185,6,86,77,169
388,0.2,"(8, 23)","(11, 14)",17,73,75,165,15,100,99,214
389,0.14,"(2, 12)","(22, 4)",5,106,96,207,7,93,75,175
390,0.16,"(11, 12)","(8, 12)",15,23,23,61,11,51,48,110
391,0.18,"(5, 23)","(0, 10)",13,45,43,101,8,128,117,253
392,0.08,"(7, 1)","(23, 22)",6,112,103,221,14,93,68,175
393,0.1,"(12, 20)","(29, 9)",7,122,114,243,11,93,82,186
394,0.06,"(26, 5)","(0, 22)",4,79,68,151,4,107,87,198
395,0.02,"(23, 23)","(14, 22)",15,83,83,181,9,142,92,243
396,0.18,"(13, 29)","(15, 10)",5,132,122,259,6,58,51,115
397,0.12,"(19, 16)","(28, 26)",8,120,113,241,6,156,137,299
398,0.16,"(5, 19)","(1, 15)",9,29,23,61,7,16,14,37
399,0.2,"(17, 29)","(21, 13)",6,99,90,195,6,93,80,179
400,0.16,"(25, 13)","(22, 3)",14,47,46,107,18,100,73,191
401,0.12,"(20, 4)","(7, 22)",5,86,76,167,5,93,75,173
402,0.16,"(1, 17)","(14, 5)",7,128,120,255,7,86,72,165
403,0.02,"(0, 19)","(16, 22)",5,99,89,193,11,219,163,393
404,0.18,"(26, 4)","(5, 14)",9,97,91,197,4,86,49,139
405,0.16,"(19, 5)","(12, 10)",4,42,31,77,9,44,29,82
406,0.04,"(19, 16)","(29, 28)",4,107,96,207,5,142,131,278
407,0.1,"(23, 0)","(4, 6)",5,121,111,237,4,44,36,84
408,0.2,"(29, 19)","(1, 16)",6,85,76,167,2,100,78,180
409,0.14,"(21, 25)","(6, 9)",3,78,66,147,8,93,89,190
410,0.08,"(16, 5)","(4, 28)",5,141,131,277,5,86,71,162
411,0.08,"(21, 1)","(6, 11)",4,70,59,133,3,100,88,191
412,0.02,"(4, 4)","(7, 27)",9,70,64,143,13,51,55,119
413,0.1,"(19, 13)","(22, 23)",12,81,78,171,19,65,75,159
414,0.14,"(11, 7)","(15, 12)",6,78,69,153,19,79,75,173
415,0.08,"(25, 5)","(14, 6)",20,28,33,81,6,100,74,180
416,0.04,"(26, 20)","(17, 29)",19,119,123,261,10,170,170,350
417,0.06,"(25, 17)","(16, 16)",4,129,118,251,5,107,53,165
418,0.14,"(24, 18)","(0, 23)",5,124,114,243,8,65,57,130
419,0.04,"(0, 11)","(25, 10)",5,105,95,205,6,93,81,180
420,0.12,"(23, 14)","(23, 5)",5,79,69,153,20,79,69,168
421,0.18,"(0, 3)","(4, 20)",4,102,91,197,5,65,43,113
422,0.04,"(29, 14)","(4, 12)",5,164,154,323,5,212,173,390
423,0.04,"(0, 0)","(19, 20)",4,182,171,357,8,93,68,169
424,0.14,"(25, 23)","(21, 3)",9,115,109,233,8,51,50,109
425,0.02,"(0, 20)","(21, 12)",11,81,77,169,18,247,213,478
426,0.02,"(22, 10)","(15, 19)",7,209,201,417,8,156,110,274
427,0.18,"(22, 22)","(6, 26)",10,48,43,101,6,72,44,122
428,0.16,"(27, 10)","(12, 14)",9,107,101,217,10,86,60,156
429,0.08,"(9, 6)","(19, 8)",13,89,87,189,7,58,43,108
430,0.06,"(16, 4)","(15, 25)",4,74,63,141,3,100,66,169
431,0.14,"(20, 27)","(5, 9)",6,89,80,175,4,135,95,234
432,0.18,"(26, 3)","(5, 15)",11,110,106,227,4,128,115,247
433,0.1,"(9, 11)","(3, 2)",4,52,41,97,4,142,110,256
434,0.12,"(7, 7)","(20, 11)",36,104,125,265,9,121,104,234
435,0.18,"(29, 22)","(17, 2)",39,99,123,261,9,65,48,122
436,0.2,"(12, 9)","(3, 0)",9,86,80,175,10,51,44,105
437,0.06,"(2, 25)","(21, 13)",6,129,120,255,3,107,78,188
438,0.2,"(5, 10)","(9, 7)",5,68,58,131,6,51,39,96
439,0.06,"(1, 27)","(13, 20)",4,96,85,185,7,93,77,177
440,0.04,"(14, 20)","(0, 13)",21,42,48,111,9,142,120,271
441,0.1,"(20, 26)","(23, 21)",7,69,61,137,5,51,32,88
442,0.06,"(26, 21)","(27, 7)",15,55,55,125,7,72,70,149
443,0.1,"(23, 8)","(22, 1)",4,87,76,167,11,44,35,90
444,0.04,"(23, 20)","(25, 29)",5,54,44,103,11,100,91,202
445,0.1,"(16, 10)","(24, 13)",4,106,95,205,5,58,32,95
446,0.2,"(6, 12)","(1, 20)",9,109,103,221,8,100,82,190
447,0.08,"(7, 15)","(7, 27)",6,165,156,327,17,240,226,483
448,0.2,"(7, 6)","(26, 1)",6,174,165,345,9,198,183,390
449,0.04,"(6, 15)","(29, 19)",8,172,165,345,7,100,84,191
450,0.14,"(19, 20)","(4, 6)",7,74,66,147,3,107,84,194
451,0.18,"(23, 2)","(27, 7)",9,57,51,117,12,107,95,214
452,0.14,"(11, 9)","(28, 11)",9,114,108,231,5,107,97,209
453,0.16,"(16, 26)","(5, 8)",8,171,164,343,8,72,55,135
454,0.14,"(29, 3)","(8, 23)",16,85,86,187,35,107,127,269
455,0.12,"(21, 29)","(7, 25)",4,69,58,131,5,100,62,167
456,0.16,"(11, 6)","(26, 19)",13,113,111,237,11,114,86,211
457,0.08,"(24, 28)","(21, 5)",6,122,113,241,10,65,49,124
458,0.02,"(9, 18)","(28, 21)",19,125,129,273,5,156,116,277
459,0.14,"(14, 9)","(19, 7)",11,43,39,93,10,79,69,158
460,0.18,"(9, 11)","(0, 25)",10,106,101,217,5,184,169,358
461,0.18,"(27, 9)","(8, 17)",10,100,95,205,8,86,64,158
462,0.06,"(10, 23)","(12, 6)",6,101,92,199,14,86,76,176
463,0.06,"(27, 19)","(5, 3)",9,56,50,115,7,100,71,178
464,0.02,"(19, 29)","(6, 8)",5,121,111,237,5,170,143,318
465,0.06,"(14, 14)","(26, 9)",9,86,80,175,4,121,83,208
466,0.04,"(22, 11)","(28, 13)",4,99,88,191,8,86,67,161
467,0.16,"(22, 27)","(21, 9)",18,68,71,157,15,79,81,175
468,0.1,"(4, 27)","(28, 15)",7,106,98,211,10,114,92,216
469,0.14,"(6, 16)","(14, 1)",4,89,78,171,4,65,60,129
470,0.2,"(4, 16)","(13, 6)",3,97,85,185,27,72,78,177
471,0.18,"(2, 28)","(4, 0)",4,107,96,207,3,198,192,393
472,0.14,"(1, 13)","(24, 23)",8,130,123,261,6,142,112,260
473,0.12,"(11, 18)","(8, 6)",9,80,74,163,5,93,58,156
474,0.2,"(25, 18)","(0, 24)",3,95,83,181,5,149,141,295
475,0.08,"(22, 14)","(12, 11)",4,94,83,181,9,72,56,137
476,0.02,"(13, 28)","(12, 11)",4,108,97,209,8,100,90,198
477,0.2,"(29, 18)","(9, 14)",8,155,148,311,5,100,89,194
478,0.16,"(29, 2)","(5, 9)",8,139,132,279,4,121,96,221
479,0.06,"(5, 3)","(19, 25)",5,101,91,197,6,135,100,241
480,0.08,"(8, 4)","(15, 18)",5,75,65,145,7,72,58,137
481,0.2,"(22, 26)","(20, 15)",16,147,148,311,11,79,51,141
482,0.02,"(25, 7)","(13, 16)",12,74,71,157,12,170,103,285
483,0.06,"(17, 20)","(18, 6)",7,91,83,181,8,93,68,169
484,0.14,"(8, 2)","(18, 23)",4,80,69,153,6,121,97,224
485,0.14,"(29, 12)","(24, 22)",8,75,68,151,4,58,50,112
486,0.12,"(24, 19)","(4, 22)",6,72,63,141,6,86,77,169
487,0.06,"(24, 2)","(22, 27)",7,117,109,233,6,191,144,341
488,0.14,"(11, 23)","(12, 21)",6,20,11,37,19,72,66,157
489,0.04,"(18, 24)","(8, 15)",7,87,79,173,6,156,117,279
490,0.2,"(7, 1)","(22, 7)",11,125,121,257,5,79,68,152
491,0.1,"(25, 12)","(17, 12)",4,59,48,111,6,65,45,116
492,0.2,"(27, 1)","(7, 28)",9,109,103,221,9,79,71,159
493,0.02,"(20, 15)","(29, 18)",12,106,103,221,6,128,75,209
494,0.2,"(22, 13)","(18, 29)",6,120,111,237,5,86,72,163
495,0.12,"(8, 14)","(24, 16)",4,115,104,223,11,51,47,109
496,0.04,"(4, 27)","(3, 8)",5,106,96,207,5,128,90,223
497,0.02,"(3, 12)","(16, 22)",13,111,109,233,8,212,181,401
498,0.02,"(9, 12)","(21, 24)",4,68,57,129,9,100,98,207
499,0.1,"(6, 23)","(25, 5)",4,82,71,157,5,149,120,274
500,0.14,"(4, 5)","(14, 0)",9,106,100,215,3,79,48,130
501,0.1,"(7, 11)","(14, 9)",10,53,48,111,9,121,90,220
502,0.06,"(10, 29)","(7, 4)",7,88,80,175,8,72,71,151
503,0.1,"(12, 24)","(17, 29)",21,108,114,243,7,135,125,267
504,0.18,"(9, 24)","(27, 23)",8,165,158,331,13,79,69,161
505,0.1,"(25, 18)","(7, 9)",4,106,95,205,5,100,60,165
506,0.18,"(16, 29)","(13, 23)",5,78,68,151,4,79,55,138
507,0.06,"(3, 0)","(16, 8)",9,82,76,167,4,100,73,177
508,0.18,"(16, 23)","(2, 2)",8,75,68,151,12,72,70,154
509,0.16,"(17, 8)","(17, 17)",9,90,84,183,9,37,37,83
510,0.1,"(0, 5)","(9, 11)",5,76,66,147,6,51,39,96
511,0.18,"(13, 9)","(23, 23)",4,135,124,263,3,93,67,163
512,0.02,"(24, 2)","(25, 11)",3,121,109,233,8,79,65,152
513,0.18,"(3, 17)","(16, 27)",7,154,146,307,6,65,45,116
514,0.12,"(13, 25)","(20, 24)",3,129,117,249,9,65,54,128
515,0.08,"(29, 29)","(28, 19)",6,72,63,141,11,51,32,94
516,0.08,"(0, 20)","(4, 8)",7,59,51,117,4,58,44,106
517,0.2,"(13, 1)","(10, 8)",16,84,85,185,5,86,72,163
518,0.02,"(21, 1)","(0, 29)",3,130,118,251,3,121,92,216
519,0.08,"(29, 5)","(5, 18)",6,110,101,217,18,121,106,245
520,0.16,"(23, 5)","(1, 13)",21,81,87,189,6,149,137,292
521,0.16,"(1, 29)","(17, 25)",3,78,66,147,3,79,73,155
522,0.04,"(29, 17)","(5, 22)",12,134,131,277,3,135,86,224
523,0.16,"(22, 18)","(7, 16)",4,34,23,61,3,51,29,83
524,0.14,"(13, 9)","(1, 27)",5,129,119,253,4,93,72,169
525,0.1,"(26, 5)","(11, 24)",4,93,82,179,4,121,98,223
526,0.2,"(3, 9)","(16, 2)",3,129,117,249,3,107,88,198
527,0.04,"(23, 14)","(1, 11)",8,92,85,185,5,198,140,343
528,0.2,"(19, 1)","(29, 25)",2,98,85,185,3,184,158,345
529,0.14,"(3, 11)","(17, 7)",4,137,126,267,8,135,118,261
530,0.2,"(19, 11)","(28, 17)",7,215,207,429,14,177,170,361
531,0.1,"(3, 24)","(16, 2)",4,89,78,171,4,128,107,239
532,0.04,"(7, 11)","(1, 12)",5,73,63,141,10,16,17,43
533,0.14,"(1, 5)","(0, 7)",5,45,35,85,5,23,8,36
534,0.16,"(20, 5)","(14, 19)",6,142,133,281,9,142,106,257
535,0.12,"(19, 16)","(3, 11)",6,166,157,329,4,93,70,167
536,0.1,"(9, 21)","(8, 13)",9,86,80,175,5,44,29,78
537,0.16,"(22, 18)","(9, 1)",10,101,96,207,4,65,49,118
538,0.1,"(23, 21)","(20, 18)",13,20,18,51,4,72,26,102
539,0.06,"(8, 5)","(2, 9)",7,86,78,171,15,58,37,110
540,0.18,"(3, 10)","(1, 16)",6,82,73,161,10,58,56,124
541,0.04,"(24, 29)","(26, 17)",8,119,112,239,13,170,110,293
542,0.14,"(28, 9)","(28, 16)",6,161,152,319,6,65,43,114
543,0.1,"(28, 4)","(17, 7)",7,33,25,65,11,79,59,149
544,0.12,"(5, 16)","(29, 28)",10,140,135,285,7,100,97,204
545,0.04,"(13, 4)","(17, 21)",9,185,179,373,6,135,121,262
546,0.08,"(21, 6)","(15, 15)",28,89,102,219,3,93,68,164
547,0.18,"(14, 15)","(26, 28)",4,89,78,171,3,65,49,117
548,0.04,"(0, 2)","(0, 9)",8,29,22,59,11,86,54,151
549,0.04,"(4, 15)","(14, 22)",6,168,159,333,5,51,44,100
550,0.12,"(10, 24)","(23, 8)",3,115,103,221,5,121,96,222
551,0.06,"(1, 22)","(5, 1)",10,96,91,197,21,86,81,188
552,0.12,"(11, 15)","(23, 26)",12,182,179,373,9,93,82,184
553,0.1,"(10, 27)","(24, 12)",5,79,69,153,4,93,79,176
554,0.14,"(8, 21)","(10, 6)",3,144,132,279,7,86,78,171
555,0.12,"(8, 18)","(19, 9)",6,110,101,217,7,100,79,186
556,0.06,"(0, 7)","(18, 5)",3,147,135,285,3,100,62,165
557,0.04,"(0, 10)","(0, 8)",25,36,46,107,8,72,35,115
558,0.16,"(21, 26)","(8, 23)",5,40,30,75,3,79,61,143
559,0.12,"(14, 15)","(25, 0)",4,107,96,207,6,114,83,203
560,0.2,"(11, 27)","(15, 25)",5,47,37,89,8,44,29,81
561,0.06,"(24, 12)","(7, 21)",3,146,134,283,3,72,54,129
562,0.02,"(8, 16)","(2, 9)",10,26,21,57,11,79,31,121
563,0.08,"(24, 3)","(24, 11)",13,63,61,137,10,65,51,126
564,0.14,"(8, 16)","(8, 22)",3,54,42,99,6,65,56,127
565,0.18,"(14, 3)","(6, 5)",5,48,38,91,9,37,31,77
566,0.14,"(16, 29)","(22, 27)",7,46,38,91,8,100,76,184
567,0.08,"(21, 9)","(7, 10)",13,108,106,227,7,100,62,169
568,0.1,"(26, 25)","(27, 2)",12,83,80,175,5,44,40,89
569,0.18,"(26, 23)","(25, 11)",12,80,77,169,16,79,77,172
570,0.14,"(2, 9)","(28, 6)",7,189,181,377,17,93,84,194
571,0.18,"(5, 6)","(12, 16)",31,76,92,199,21,65,71,157
572,0.12,"(23, 20)","(3, 0)",6,73,64,143,5,233,213,451
573,0.18,"(17, 13)","(5, 0)",5,88,78,171,11,65,67,143
574,0.06,"(20, 18)","(27, 5)",15,161,161,337,13,128,109,250
575,0.02,"(25, 29)","(23, 29)",6,18,9,33,5,30,10,45
576,0.1,"(5, 5)","(24, 4)",6,101,92,199,11,86,80,177
577,0.06,"(3, 22)","(5, 0)",10,57,52,119,7,114,104,225
578,0.14,"(16, 21)","(18, 29)",9,122,116,247,12,58,48,118
579,0.14,"(19, 4)","(2, 20)",6,101,92,199,4,107,88,199
580,0.06,"(18, 9)","(5, 19)",3,114,102,219,6,114,76,196
581,0.14,"(6, 27)","(26, 7)",3,87,75,165,6,135,90,231
582,0.2,"(1, 20)","(29, 20)",9,124,118,251,4,128,108,240
583,0.14,"(9, 9)","(8, 5)",17,22,24,63,18,23,26,67
584,0.12,"(29, 5)","(21, 6)",3,44,32,79,4,51,35,90
585,0.1,"(4, 8)","(5, 18)",13,61,59,133,12,79,56,147
586,0.06,"(11, 4)","(10, 19)",17,154,156,327,5,170,130,305
587,0.1,"(19, 1)","(2, 3)",5,40,30,75,7,128,114,249
588,0.18,"(3, 16)","(8, 11)",7,45,37,89,4,72,56,132
589,0.04,"(28, 17)","(12, 22)",5,76,66,147,4,107,81,192
590,0.06,"(25, 6)","(4, 24)",6,69,60,135,14,86,65,165
591,0.2,"(7, 22)","(24, 15)",4,94,83,181,4,79,47,130
592,0.06,"(19, 7)","(25, 28)",4,107,96,207,7,79,71,157
593,0.12,"(12, 28)","(19, 28)",5,83,73,161,7,51,38,96
594,0.16,"(21, 6)","(21, 26)",8,88,81,177,8,142,126,276
595,0.18,"(18, 4)","(4, 12)",14,143,142,299,10,72,56,138
596,0.2,"(20, 2)","(17, 2)",7,18,10,35,7,16,9,32
597,0.04,"(1, 13)","(17, 24)",6,88,79,173,7,128,100,235
598,0.06,"(6, 8)","(4, 14)",10,44,39,93,8,65,47,120
599,0.08,"(23, 17)","(7, 10)",8,93,86,187,7,128,69,204
600,0.1,"(28, 25)","(25, 21)",4,61,50,115,9,107,88,204
601,0.1,"(18, 10)","(10, 3)",5,90,80,175,12,51,52,115
602,0.02,"(6, 10)","(13, 18)",5,60,50,115,4,65,57,126
603,0.1,"(4, 19)","(26, 17)",4,108,97,209,5,72,51,128
604,0.16,"(7, 8)","(8, 11)",12,25,22,59,8,37,25,70
605,0.06,"(22, 9)","(27, 29)",14,104,103,221,14,177,157,348
606,0.08,"(7, 17)","(16, 6)",22,104,111,237,7,100,98,205
607,0.18,"(15, 13)","(19, 7)",9,71,65,145,8,114,83,205
608,0.02,"(3, 27)","(0, 10)",23,124,132,279,46,72,82,200
609,0.08,"(28, 24)","(16, 4)",8,160,153,321,7,100,85,192
610,0.14,"(25, 18)","(19, 0)",5,126,116,247,7,107,90,204
611,0.02,"(7, 22)","(14, 21)",6,154,145,305,16,65,56,137
612,0.2,"(10, 24)","(14, 9)",5,95,85,185,5,163,148,316
613,0.1,"(22, 28)","(22, 14)",9,69,63,141,12,100,69,181
614,0.18,"(13, 24)","(15, 21)",4,59,48,111,4,51,46,101
615,0.1,"(11, 29)","(22, 28)",10,68,63,141,8,65,49,122
616,0.16,"(26, 12)","(9, 16)",7,59,51,117,8,79,66,153
617,0.12,"(24, 14)","(11, 14)",14,30,29,73,10,135,116,261
618,0.14,"(3, 15)","(12, 27)",14,105,104,223,5,72,58,135
619,0.1,"(29, 5)","(1, 3)",9,57,51,117,7,86,77,170
620,0.06,"(10, 15)","(28, 1)",8,235,228,471,5,93,76,174
621,0.2,"(0, 21)","(10, 10)",4,82,71,157,8,93,79,180
622,0.14,"(8, 2)","(24, 29)",9,63,57,129,8,107,82,197
623,0.14,"(0, 15)","(25, 13)",16,96,97,209,2,135,107,244
624,0.18,"(7, 22)","(7, 28)",6,89,80,175,3,58,40,101
625,0.1,"(6, 17)","(19, 28)",14,89,88,191,12,86,69,167
626,0.14,"(12, 24)","(15, 18)",13,64,62,139,5,79,55,139
627,0.2,"(19, 6)","(23, 23)",4,152,141,297,5,226,222,453
628,0.06,"(4, 12)","(17, 19)",4,123,112,239,3,51,34,88
629,0.1,"(13, 6)","(28, 2)",5,104,94,203,11,79,65,155
630,0.18,"(7, 5)","(0, 10)",6,28,19,53,12,30,27,69
631,0.06,"(19, 24)","(6, 7)",9,129,123,261,9,65,65,139
632,0.08,"(20, 15)","(20, 10)",19,49,53,121,9,86,59,154
633,0.12,"(2, 3)","(24, 28)",10,65,60,135,5,247,227,479
634,0.12,"(2, 27)","(3, 14)",17,127,129,273,5,86,52,143
635,0.18,"(14, 7)","(26, 28)",5,50,40,95,5,156,143,304
636,0.02,"(20, 11)","(21, 9)",4,22,11,37,7,135,82,224
637,0.06,"(25, 2)","(18, 14)",4,73,62,139,9,79,52,140
638,0.1,"(15, 13)","(4, 22)",4,89,78,171,5,100,75,180
639,0.04,"(4, 2)","(2, 5)",3,43,31,77,3,44,31,78
640,0.06,"(7, 11)","(3, 13)",6,79,70,155,7,16,14,37
641,0.04,"(20, 0)","(16, 29)",3,85,73,161,4,128,72,204
642,0.2,"(0, 28)","(22, 25)",4,152,141,297,3,205,197,405
643,0.06,"(14, 2)","(5, 25)",21,72,78,171,9,184,158,351
644,0.08,"(27, 2)","(9, 23)",7,86,78,171,5,177,148,330
645,0.14,"(5, 27)","(5, 15)",4,64,53,121,5,86,70,161
646,0.18,"(29, 8)","(25, 21)",8,214,207,429,6,58,44,108
647,0.2,"(0, 9)","(22, 7)",9,117,111,237,5,163,142,310
648,0.08,"(2, 11)","(19, 15)",3,96,84,183,5,149,111,265
649,0.06,"(5, 16)","(2, 27)",3,41,29,73,7,135,101,243
650,0.06,"(27, 21)","(20, 23)",6,30,21,57,5,44,28,77
651,0.16,"(26, 14)","(15, 7)",5,76,66,147,3,142,118,263
652,0.14,"(27, 9)","(20, 22)",5,100,90,195,15,114,96,225
653,0.1,"(6, 6)","(6, 7)",4,16,5,25,3,30,17,50
654,0.2,"(11, 10)","(19, 15)",4,105,94,203,17,58,61,136
655,0.12,"(5, 13)","(22, 18)",8,114,107,229,12,79,71,162
656,0.1,"(28, 4)","(11, 23)",4,101,90,195,7,79,71,157
657,0.08,"(23, 26)","(0, 7)",46,141,172,359,52,191,200,443
658,0.2,"(23, 5)","(17, 5)",11,23,19,53,12,30,22,64
659,0.16,"(6, 28)","(11, 20)",6,122,113,241,3,79,61,143
660,0.08,"(3, 10)","(5, 28)",4,87,76,167,18,58,50,126
661,0.14,"(4, 16)","(26, 7)",11,90,86,187,8,135,119,262
662,0.2,"(23, 19)","(27, 4)",3,139,127,269,4,107,85,196
663,0.18,"(23, 11)","(22, 16)",10,27,22,59,12,51,34,97
664,0.12,"(19, 15)","(19, 7)",12,79,76,167,19,114,122,255
665,0.08,"(17, 0)","(25, 21)",2,125,112,239,9,100,79,188
666,0.04,"(25, 3)","(3, 10)",7,92,84,183,3,135,84,222
667,0.2,"(10, 29)","(21, 6)",6,78,69,153,9,51,51,111
668,0.08,"(21, 6)","(26, 4)",5,53,43,101,4,72,42,118
669,0.12,"(15, 2)","(14, 11)",4,89,78,171,4,30,24,58
670,0.06,"(16, 13)","(8, 7)",2,151,138,291,3,72,48,123
671,0.16,"(22, 10)","(14, 23)",5,84,74,163,6,65,44,115
672,0.04,"(1, 7)","(14, 19)",7,123,115,245,5,121,73,199
673,0.02,"(19, 1)","(14, 26)",8,117,110,235,6,72,63,141
674,0.12,"(16, 15)","(19, 23)",12,179,176,367,14,86,83,183
675,0.04,"(2, 0)","(25, 16)",3,163,151,317,6,93,80,179
676,0.04,"(24, 15)","(5, 0)",7,92,84,183,15,86,91,192
677,0.04,"(25, 21)","(12, 18)",11,49,45,105,6,184,167,357
678,0.18,"(12, 8)","(4, 3)",10,113,108,231,10,79,65,154
679,0.1,"(11, 29)","(11, 26)",2,28,15,45,3,37,16,56
680,0.18,"(16, 26)","(23, 13)",12,117,114,243,9,107,86,202
681,0.02,"(26, 26)","(0, 20)",8,93,86,187,21,135,140,296
682,0.1,"(27, 2)","(10, 1)",7,47,39,93,9,72,67,148
683,0.08,"(20, 18)","(29, 29)",5,91,81,177,10,107,84,201
684,0.14,"(12, 21)","(26, 23)",3,83,71,157,11,65,62,138
685,0.06,"(0, 4)","(24, 28)",15,71,71,157,3,72,51,126
686,0.06,"(4, 29)","(17, 9)",6,72,63,141,6,107,79,192
687,0.12,"(2, 20)","(23, 11)",6,127,118,251,9,58,56,123
688,0.06,"(20, 2)","(0, 16)",5,75,65,145,10,79,75,164
689,0.18,"(25, 14)","(4, 7)",11,112,108,231,7,58,53,118
690,0.18,"(13, 29)","(2, 6)",1,165,151,317,1,121,105,227
691,0.18,"(24, 25)","(27, 17)",9,57,51,117,5,93,74,172
692,0.04,"(14, 18)","(15, 22)",5,39,29,73,6,79,60,145
693,0.16,"(10, 8)","(27, 4)",6,98,89,193,9,86,76,171
694,0.12,"(5, 4)","(14, 25)",17,137,139,293,12,65,68,145
695,0.2,"(27, 11)","(17, 24)",10,92,87,189,12,58,42,112
696,0.16,"(21, 11)","(26, 12)",7,68,60,135,3,58,30,91
697,0.14,"(22, 23)","(25, 2)",7,143,135,285,6,65,61,132
698,0.04,"(28, 2)","(22, 19)",9,135,129,273,5,205,174,384
699,0.14,"(3, 11)","(27, 4)",5,96,86,187,4,142,116,262
700,0.02,"(10, 16)","(15, 23)",8,123,116,247,4,135,88,227
701,0.16,"(0, 8)","(5, 11)",6,42,33,81,7,51,32,90
702,0.04,"(20, 20)","(28, 21)",6,109,100,215,20,100,101,221
703,0.12,"(2, 14)","(23, 29)",14,50,49,113,7,121,108,236
704,0.04,"(21, 4)","(24, 9)",5,74,64,143,4,51,38,93
705,0.14,"(10, 14)","(26, 18)",15,113,113,241,4,72,49,125
706,0.06,"(23, 28)","(4, 2)",5,142,132,279,4,65,60,129
707,0.16,"(13, 7)","(3, 23)",8,92,85,185,5,93,72,170
708,0.02,"(19, 16)","(17, 0)",4,192,181,377,11,184,124,319
709,0.14,"(6, 13)","(6, 21)",13,55,53,121,8,72,57,137
710,0.18,"(14, 19)","(13, 9)",10,132,127,269,8,86,57,151
711,0.16,"(8, 13)","(12, 15)",3,28,16,47,5,30,22,57
712,0.14,"(17, 17)","(23, 14)",4,138,127,269,7,135,133,275
713,0.16,"(29, 12)","(28, 7)",7,36,28,71,7,44,27,78
714,0.04,"(9, 22)","(21, 22)",4,104,93,201,6,100,63,169
715,0.14,"(29, 29)","(6, 24)",18,152,155,325,14,100,87,201
716,0.18,"(11, 14)","(3, 20)",5,108,98,211,5,100,87,192
717,0.16,"(27, 2)","(29, 4)",7,37,29,73,8,30,20,58
718,0.08,"(3, 5)","(9, 9)",13,49,47,109,8,44,36,88
719,0.12,"(26, 12)","(16, 23)",5,77,67,149,9,58,41,108
720,0.16,"(0, 19)","(1, 6)",17,89,91,197,4,205,172,381
721,0.2,"(15, 4)","(24, 19)",8,188,181,377,5,86,74,165
722,0.02,"(18, 10)","(22, 19)",6,198,189,393,6,121,84,211
723,0.04,"(24, 0)","(13, 25)",8,165,158,331,2,184,140,326
724,0.12,"(0, 13)","(28, 10)",12,125,122,259,6,86,63,155
725,0.04,"(24, 29)","(17, 11)",11,97,93,201,9,198,128,335
726,0.2,"(24, 16)","(1, 25)",9,104,98,211,9,79,72,160
727,0.14,"(11, 10)","(18, 9)",13,79,77,169,8,58,48,114
728,0.14,"(6, 20)","(14, 29)",7,85,77,169,7,149,128,284
729,0.06,"(17, 27)","(8, 13)",9,73,67,149,5,79,41,125
730,0.06,"(4, 26)","(24, 24)",4,80,69,153,11,86,79,176
731,0.12,"(11, 0)","(18, 28)",5,80,70,155,6,107,92,205
732,0.04,"(23, 1)","(15, 25)",10,114,109,233,10,170,144,324
733,0.06,"(19, 21)","(23, 4)",4,78,67,149,8,149,123,280
734,0.18,"(0, 28)","(21, 4)",3,81,69,153,5,79,59,143
735,0.12,"(29, 5)","(28, 19)",5,118,108,231,5,44,32,81
736,0.12,"(10, 20)","(24, 20)",3,81,69,153,5,156,125,286
737,0.08,"(9, 28)","(15, 9)",6,143,134,283,4,100,90,194
738,0.04,"(13, 4)","(27, 3)",9,70,64,143,5,100,78,183
739,0.06,"(12, 3)","(9, 1)",18,84,87,189,6,51,20,77
740,0.02,"(4, 26)","(27, 24)",5,108,98,211,13,163,131,307
741,0.02,"(17, 13)","(16, 21)",4,44,33,81,6,86,43,135
742,0.12,"(21, 17)","(13, 17)",17,66,68,151,3,51,35,89
743,0.06,"(3, 7)","(23, 17)",4,125,114,243,6,135,98,239
744,0.12,"(11, 21)","(15, 11)",11,88,84,183,4,79,62,145
745,0.2,"(22, 26)","(28, 23)",3,54,42,99,6,163,157,326
746,0.06,"(23, 23)","(26, 7)",10,81,76,167,7,93,74,174
747,0.04,"(15, 10)","(15, 3)",4,108,97,209,5,149,116,270
748,0.12,"(23, 20)","(10, 16)",8,49,42,99,6,58,44,108
749,0.2,"(23, 10)","(12, 16)",4,82,71,157,18,121,113,252
750,0.02,"(4, 29)","(20, 15)",5,127,117,249,9,149,110,268
751,0.16,"(5, 13)","(9, 21)",8,59,52,119,11,72,68,151
752,0.1,"(20, 7)","(19, 26)",7,172,164,343,4,156,112,272
753,0.2,"(7, 0)","(27, 18)",3,81,69,153,4,58,50,112
754,0.02,"(21, 18)","(26, 13)",12,131,128,271,7,107,89,203
755,0.14,"(1, 2)","(3, 6)",8,51,44,103,6,30,21,57
756,0.2,"(2, 29)","(8, 18)",6,68,59,133,9,79,62,150
757,0.2,"(26, 7)","(15, 20)",7,104,96,207,7,65,52,124
758,0.08,"(7, 0)","(1, 19)",7,107,99,213,7,170,140,317
759,0.14,"(20, 1)","(0, 21)",7,56,48,111,6,121,100,227
760,0.18,"(20, 17)","(4, 7)",10,42,37,89,7,65,45,117
761,0.04,"(0, 23)","(19, 23)",10,125,120,255,23,51,59,133
762,0.18,"(11, 6)","(28, 13)",4,151,140,295,10,65,54,129
763,0.04,"(27, 11)","(25, 1)",9,192,186,387,13,93,51,157
764,0.12,"(20, 3)","(0, 7)",15,75,75,165,7,100,91,198
765,0.1,"(22, 2)","(27, 10)",7,53,45,105,3,51,39,93
766,0.02,"(18, 26)","(29, 22)",11,97,93,201,7,177,134,318
767,0.16,"(24, 4)","(26, 3)",6,77,68,151,8,51,47,106
768,0.02,"(3, 28)","(6, 0)",5,233,223,461,3,93,83,179
769,0.06,"(21, 15)","(14, 22)",9,48,42,99,22,51,64,137
770,0.1,"(13, 19)","(8, 20)",15,22,22,59,12,93,52,157
771,0.16,"(12, 17)","(13, 5)",6,50,41,97,6,79,68,153
772,0.18,"(19, 17)","(18, 9)",4,55,44,103,15,44,38,97
773,0.06,"(22, 9)","(7, 23)",5,88,78,171,6,72,46,124
774,0.18,"(5, 7)","(0, 4)",11,31,27,69,13,30,24,67
775,0.1,"(22, 28)","(22, 7)",5,116,106,227,8,86,56,150
776,0.06,"(22, 22)","(28, 21)",11,82,78,171,11,51,51,113
777,0.16,"(16, 7)","(24, 25)",13,167,165,345,8,86,71,165
778,0.2,"(14, 6)","(4, 28)",6,59,50,115,5,121,94,220
779,0.18,"(7, 1)","(8, 24)",8,111,104,223,3,135,113,251
780,0.06,"(12, 24)","(15, 18)",11,102,98,211,9,170,117,296
781,0.1,"(28, 16)","(28, 18)",4,39,28,71,3,51,31,85
782,0.12,"(10, 18)","(12, 24)",4,63,52,119,11,72,72,155
783,0.16,"(25, 13)","(15, 5)",5,142,132,279,8,58,38,104
784,0.2,"(2, 27)","(17, 2)",7,95,87,189,7,86,78,171
785,0.08,"(5, 23)","(23, 27)",9,85,79,173,5,93,80,178
786,0.1,"(4, 18)","(13, 18)",7,81,73,161,6,93,64,163
787,0.1,"(2, 3)","(14, 13)",6,81,72,159,11,86,65,162
788,0.18,"(15, 18)","(24, 1)",11,109,105,225,3,58,40,101
789,0.02,"(25, 18)","(22, 25)",3,57,45,105,3,142,90,235
790,0.18,"(14, 4)","(8, 8)",13,79,77,169,9,100,87,196
791,0.14,"(28, 0)","(12, 19)",10,97,92,199,5,114,93,212
792,0.08,"(25, 8)","(26, 6)",15,67,67,149,6,58,42,106
793,0.12,"(11, 1)","(14, 9)",7,61,53,121,8,51,38,97
794,0.18,"(24, 13)","(20, 19)",10,68,63,141,8,37,36,81
795,0.02,"(18, 18)","(26, 4)",11,219,215,445,8,58,45,111
796,0.16,"(18, 14)","(10, 5)",5,88,78,171,33,79,91,203
797,0.06,"(5, 16)","(6, 14)",12,22,19,53,15,37,37,89
798,0.18,"(20, 21)","(24, 8)",5,96,86,187,7,93,88,188
799,0.16,"(29, 11)","(15, 8)",4,54,43,101,13,79,71,163
800,0.1,"(20, 12)","(27, 12)",8,68,61,137,8,44,35,87
801,0.02,"(2, 25)","(13, 28)",6,151,142,299,7,107,64,178
802,0.1,"(13, 25)","(27, 13)",12,113,110,235,9,93,79,181
803,0.18,"(21, 3)","(5, 27)",8,74,67,149,3,107,87,197
804,0.1,"(1, 4)","(19, 14)",5,76,66,147,6,65,41,112
805,0.16,"(11, 29)","(25, 9)",9,81,75,165,14,86,72,172
806,0.08,"(22, 9)","(16, 15)",9,56,50,115,6,128,113,247
807,0.18,"(2, 6)","(8, 12)",21,87,93,201,6,37,22,65
808,0.04,"(29, 4)","(29, 5)",6,23,14,43,9,1,9,19
809,0.2,"(15, 9)","(18, 3)",8,124,117,249,12,79,81,172
810,0.14,"(27, 20)","(5, 19)",5,108,98,211,6,128,107,241
811,0.04,"(8, 12)","(19, 18)",13,77,75,165,5,142,98,245
812,0.14,"(23, 0)","(0, 14)",17,148,150,315,12,79,74,165
813,0.14,"(1, 3)","(14, 27)",4,94,83,181,4,100,57,161
814,0.06,"(27, 3)","(1, 23)",3,64,52,119,7,100,70,177
815,0.18,"(22, 6)","(25, 1)",10,69,64,143,11,51,38,100
816,0.2,"(11, 15)","(15, 9)",3,46,34,83,3,86,53,142
817,0.14,"(8, 21)","(18, 8)",48,104,137,289,5,44,36,85
818,0.1,"(2, 0)","(4, 11)",8,52,45,105,2,79,62,143
819,0.04,"(15, 13)","(3, 0)",6,193,184,383,6,163,129,298
820,0.1,"(1, 5)","(7, 6)",10,56,51,117,10,65,52,127
821,0.16,"(22, 11)","(16, 6)",5,127,117,249,13,44,37,94
822,0.04,"(10, 9)","(19, 11)",7,131,123,261,6,100,70,176
823,0.1,"(11, 6)","(17, 1)",7,68,60,135,7,114,76,197
824,0.02,"(29, 29)","(2, 29)",11,193,189,393,3,163,107,273
825,0.1,"(12, 27)","(6, 21)",10,58,53,121,10,79,46,135
826,0.16,"(1, 20)","(14, 11)",20,112,117,249,35,100,116,251
827,0.02,"(21, 23)","(9, 25)",6,33,24,63,7,86,47,140
828,0.1,"(12, 6)","(16, 29)",4,118,107,229,11,121,99,231
829,0.04,"(29, 11)","(26, 3)",6,88,79,173,7,107,79,193
830,0.16,"(12, 13)","(4, 6)",8,108,101,217,8,72,56,136
831,0.06,"(16, 1)","(13, 13)",4,72,61,137,7,65,51,123
832,0.14,"(25, 20)","(18, 7)",5,64,54,123,5,86,53,144
833,0.04,"(9, 27)","(9, 5)",10,75,70,155,17,65,63,145
834,0.2,"(13, 1)","(26, 1)",5,124,114,243,9,58,50,117
835,0.08,"(4, 20)","(28, 6)",3,128,116,247,4,135,96,235
836,0.2,"(21, 8)","(23, 14)",7,66,58,131,5,51,34,90
837,0.04,"(2, 7)","(20, 1)",8,100,93,201,7,79,65,151
838,0.02,"(21, 1)","(22, 11)",7,115,107,229,4,100,50,154
839,0.06,"(13, 23)","(26, 15)",11,84,80,175,13,107,85,205
840,0.2,"(29, 23)","(26, 19)",13,58,56,127,6,79,43,128
841,0.1,"(27, 6)","(18, 19)",8,84,77,169,4,107,91,202
842,0.1,"(5, 18)","(12, 8)",12,60,57,129,8,86,58,152
843,0.18,"(5, 9)","(8, 18)",13,112,110,235,16,79,84,179
844,0.2,"(0, 1)","(19, 24)",7,84,76,167,10,100,88,198
845,0.1,"(24, 16)","(7, 0)",3,127,115,245,10,128,117,255
846,0.14,"(27, 21)","(21, 10)",24,104,113,241,13,107,97,217
847,0.04,"(1, 7)","(18, 11)",4,157,146,307,3,114,86,203
848,0.04,"(1, 3)","(23, 1)",7,88,80,175,3,219,176,398
849,0.1,"(23, 0)","(27, 4)",3,61,49,113,3,65,43,111
850,0.1,"(18, 19)","(24, 24)",4,96,85,185,8,107,93,208
851,0.06,"(24, 1)","(17, 4)",7,45,37,89,16,23,28,67
852,0.1,"(21, 24)","(16, 1)",6,120,111,237,9,65,58,132
853,0.1,"(3, 10)","(0, 21)",12,112,109,233,12,100,82,194
854,0.18,"(13, 9)","(13, 0)",14,60,59,133,5,156,148,309
855,0.14,"(20, 5)","(6, 29)",7,69,61,137,4,135,114,253
856,0.2,"(21, 1)","(7, 8)",5,92,82,179,12,44,41,97
857,0.06,"(26, 16)","(10, 9)",4,102,91,197,7,121,108,236
858,0.12,"(8, 14)","(7, 19)",8,59,52,119,3,37,28,68
859,0.1,"(24, 1)","(24, 7)",5,88,78,171,6,58,34,98
860,0.18,"(10, 6)","(10, 4)",4,26,15,45,7,30,19,56
861,0.1,"(12, 22)","(7, 25)",14,54,53,121,7,93,80,180
862,0.04,"(12, 5)","(7, 27)",7,147,139,293,20,100,73,193
863,0.04,"(22, 19)","(3, 26)",5,127,117,249,6,86,70,162
864,0.02,"(6, 10)","(29, 22)",4,223,212,439,6,135,96,237
865,0.02,"(4, 17)","(27, 21)",11,101,97,209,12,177,134,323
866,0.18,"(24, 15)","(27, 19)",8,36,29,73,7,86,70,163
867,0.08,"(0, 24)","(2, 21)",14,26,25,65,8,37,23,68
868,0.02,"(4, 21)","(23, 10)",5,155,145,305,8,226,132,366
869,0.18,"(5, 4)","(20, 17)",7,147,139,293,8,58,41,107
870,0.18,"(6, 1)","(6, 28)",10,96,91,197,3,93,76,172
871,0.12,"(13, 9)","(29, 21)",7,181,173,361,5,79,75,159
872,0.18,"(22, 10)","(29, 10)",8,90,83,181,7,79,63,149
873,0.12,"(0, 21)","(18, 22)",9,119,113,241,3,79,64,146
874,0.02,"(0, 8)","(14, 10)",8,76,69,153,6,128,87,221
875,0.14,"(5, 28)","(10, 24)",8,52,45,105,14,65,59,138
876,0.14,"(2, 20)","(14, 0)",4,192,181,377,2,58,39,99
877,0.1,"(24, 28)","(12, 24)",11,30,26,67,4,86,55,145
878,0.12,"(5, 0)","(26, 29)",7,64,56,127,5,93,78,176
879,0.02,"(5, 1)","(3, 14)",4,41,30,75,3,79,48,130
880,0.02,"(28, 0)","(28, 17)",3,158,146,307,3,128,85,216
881,0.16,"(4, 18)","(0, 19)",7,101,93,201,8,163,140,311
882,0.16,"(15, 26)","(29, 4)",4,66,55,125,8,128,115,251
883,0.08,"(24, 14)","(20, 23)",9,45,39,93,6,79,64,149
884,0.16,"(11, 17)","(1, 15)",16,81,82,179,6,128,117,251
885,0.04,"(2, 26)","(15, 28)",8,160,153,321,7,58,50,115
886,0.2,"(8, 14)","(13, 3)",6,120,111,237,3,44,32,79
887,0.18,"(18, 7)","(25, 6)",5,70,60,135,10,44,45,99
888,0.18,"(1, 8)","(14, 20)",8,101,94,203,8,121,102,231
889,0.06,"(8, 20)","(28, 15)",17,125,127,269,22,156,108,286
890,0.14,"(24, 20)","(14, 10)",7,146,138,291,13,93,77,183
891,0.06,"(3, 21)","(25, 18)",15,109,109,233,14,149,125,288
892,0.08,"(23, 28)","(26, 15)",9,124,118,251,6,86,56,148
893,0.12,"(14, 15)","(19, 0)",7,142,134,283,5,121,104,230
894,0.2,"(26, 22)","(25, 25)",4,36,25,65,5,1,5,11
895,0.12,"(29, 27)","(17, 14)",10,139,134,283,3,65,57,125
896,0.1,"(29, 5)","(0, 19)",8,61,54,123,6,65,49,120
897,0.14,"(16, 0)","(23, 7)",9,91,85,185,6,58,47,111
898,0.06,"(13, 6)","(10, 11)",10,78,73,161,6,58,44,108
899,0.08,"(9, 17)","(13, 29)",4,116,105,225,13,107,108,228
900,0.12,"(27, 23)","(20, 8)",25,79,89,193,8,93,68,169
901,0.16,"(17, 23)","(13, 27)",9,73,67,149,10,44,25,79
902,0.1,"(21, 25)","(12, 25)",16,84,85,185,9,107,78,194
903,0.18,"(10, 29)","(19, 13)",4,92,81,177,10,107,89,206
904,0.18,"(3, 22)","(21, 12)",9,112,106,227,19,86,77,182
905,0.08,"(4, 29)","(16, 0)",10,102,97,209,3,107,85,195
906,0.12,"(17, 26)","(17, 27)",9,21,15,45,9,79,46,134
907,0.18,"(6, 3)","(14, 16)",8,68,61,137,7,72,54,133
908,0.18,"(3, 28)","(15, 2)",10,132,127,269,5,65,49,119
909,0.18,"(17, 26)","(9, 1)",9,134,128,271,7,156,142,305
910,0.08,"(14, 22)","(14, 21)",7,21,13,41,6,16,7,29
911,0.04,"(18, 2)","(25, 12)",5,195,185,385,11,240,192,443
912,0.16,"(12, 29)","(24, 15)",7,94,86,187,11,142,136,289
913,0.08,"(17, 27)","(27, 2)",4,122,111,237,7,86,66,159
914,0.14,"(14, 20)","(18, 14)",15,64,64,143,6,100,67,173
915,0.14,"(12, 24)","(26, 8)",6,70,61,137,9,86,86,181
916,0.04,"(17, 18)","(28, 24)",5,109,99,213,12,121,114,247
917,0.04,"(8, 2)","(2, 0)",7,24,16,47,9,23,17,49
918,0.08,"(28, 29)","(27, 19)",7,92,84,183,11,37,32,80
919,0.18,"(29, 8)","(25, 29)",20,169,174,363,8,79,75,162
920,0.16,"(25, 10)","(1, 29)",9,63,57,129,10,163,153,326
921,0.06,"(23, 2)","(2, 7)",4,121,110,235,17,58,54,129
922,0.2,"(11, 10)","(29, 7)",17,79,81,177,6,93,83,182
923,0.02,"(7, 12)","(10, 18)",18,284,287,589,4,114,64,182
924,0.02,"(17, 24)","(18, 3)",11,180,176,367,11,135,105,251
925,0.1,"(19, 5)","(5, 15)",5,56,46,107,6,93,84,183
926,0.14,"(10, 2)","(17, 27)",10,113,108,231,4,107,84,195
927,0.12,"(9, 16)","(0, 21)",6,48,39,93,31,58,67,156
928,0.1,"(16, 19)","(14, 2)",4,100,89,193,3,79,48,130
929,0.04,"(26, 22)","(25, 0)",17,126,128,271,6,156,131,293
930,0.06,"(11, 21)","(17, 27)",10,85,80,175,8,93,59,160
931,0.08,"(28, 29)","(25, 25)",3,57,45,105,8,149,134,291
932,0.06,"(27, 11)","(9, 21)",6,80,71,157,14,100,63,177
933,0.12,"(11, 19)","(5, 22)",13,29,27,69,5,30,21,56
934,0.04,"(11, 23)","(15, 21)",16,80,81,177,10,86,60,156
935,0.2,"(15, 25)","(20, 18)",6,70,61,137,4,79,64,147
936,0.1,"(2, 0)","(25, 9)",4,102,91,197,15,135,123,273
937,0.1,"(2, 14)","(2, 2)",10,80,75,165,5,44,38,87
938,0.2,"(13, 23)","(22, 22)",10,71,66,147,7,93,78,178
939,0.02,"(13, 6)","(5, 29)",6,107,98,211,3,135,123,261
940,0.2,"(16, 1)","(24, 11)",3,85,73,161,8,128,120,256
941,0.18,"(21, 10)","(8, 24)",14,79,78,171,9,37,37,83
942,0.04,"(28, 7)","(2, 27)",10,73,68,151,11,86,63,160
943,0.06,"(4, 21)","(9, 1)",4,116,105,225,7,114,92,213
944,0.14,"(21, 5)","(6, 27)",13,94,92,199,24,72,75,171
945,0.02,"(13, 2)","(25, 14)",5,161,151,317,3,128,90,221
946,0.06,"(20, 27)","(26, 19)",4,73,62,139,5,86,57,148
947,0.04,"(6, 8)","(2, 17)",13,79,77,169,8,170,100,278
948,0.14,"(3, 4)","(24, 14)",3,90,78,171,10,86,63,159
949,0.06,"(5, 1)","(17, 11)",5,112,102,219,3,107,95,205
950,0.04,"(23, 24)","(8, 4)",3,123,111,237,6,233,168,407
951,0.04,"(26, 29)","(19, 25)",3,93,81,177,10,65,42,117
952,0.16,"(19, 6)","(0, 13)",7,107,99,213,6,86,64,156
953,0.1,"(7, 2)","(18, 28)",6,101,92,199,11,142,115,268
954,0.18,"(8, 10)","(22, 4)",7,104,96,207,6,79,70,155
955,0.18,"(2, 13)","(14, 21)",8,92,85,185,12,149,146,307
956,0.06,"(6, 19)","(18, 26)",9,168,162,339,6,93,54,153
957,0.1,"(14, 15)","(10, 21)",5,37,27,69,5,65,33,103
958,0.16,"(16, 9)","(8, 1)",5,192,182,379,12,114,98,224
959,0.08,"(8, 3)","(15, 24)",7,64,56,127,7,114,106,227
960,0.12,"(24, 17)","(14, 5)",19,131,135,285,13,79,77,169
961,0.18,"(5, 13)","(9, 5)",9,58,52,119,6,72,59,137
962,0.1,"(25, 8)","(3, 12)",10,108,103,221,7,58,50,115
963,0.14,"(11, 7)","(25, 7)",4,144,133,281,8,93,76,177
964,0.1,"(5, 23)","(29, 26)",17,94,96,207,9,93,70,172
965,0.04,"(4, 17)","(22, 28)",11,112,108,231,3,142,88,233
966,0.06,"(29, 3)","(16, 11)",22,80,87,189,12,44,35,91
967,0.16,"(6, 11)","(2, 28)",11,44,40,95,12,149,152,313
968,0.18,"(12, 11)","(7, 10)",4,19,8,31,5,51,22,78
969,0.14,"(18, 21)","(6, 20)",6,86,77,169,4,51,41,96
970,0.2,"(24, 27)","(9, 14)",6,114,105,225,5,128,108,241
971,0.1,"(7, 29)","(17, 23)",9,121,115,245,2,65,38,105
972,0.14,"(15, 10)","(5, 21)",18,91,94,203,4,72,53,129
973,0.08,"(3, 0)","(25, 26)",2,88,75,165,10,121,101,232
974,0.12,"(14, 0)","(16, 23)",7,119,111,237,6,93,67,166
975,0.1,"(29, 22)","(24, 5)",7,83,75,165,6,107,96,209
976,0.16,"(7, 0)","(20, 11)",4,85,74,163,9,65,42,116
977,0.12,"(25, 12)","(0, 29)",4,59,48,111,10,79,71,160
978,0.04,"(2, 0)","(5, 27)",7,118,110,235,8,72,61,141
979,0.16,"(14, 18)","(5, 7)",11,135,131,277,6,100,85,191
980,0.18,"(11, 1)","(23, 28)",15,78,78,171,7,72,68,147
981,0.16,"(0, 14)","(7, 13)",11,65,61,137,7,86,69,162
982,0.12,"(4, 9)","(29, 26)",8,59,52,119,7,121,114,242
983,0.1,"(28, 19)","(17, 11)",4,104,93,201,4,37,22,63
984,0.18,"(9, 2)","(8, 28)",5,102,92,199,8,100,84,192
985,0.16,"(12, 14)","(11, 17)",11,35,31,77,9,30,19,58
986,0.12,"(19, 20)","(18, 29)",4,126,115,245,3,58,46,107
987,0.1,"(26, 14)","(11, 17)",9,54,48,111,6,93,63,162
988,0.14,"(11, 7)","(7, 10)",8,44,37,89,8,30,29,67
989,0.2,"(17, 10)","(22, 23)",7,99,91,197,21,121,124,266
990,0.02,"(0, 28)","(28, 8)",4,115,104,223,6,114,95,215
991,0.18,"(4, 24)","(10, 8)",8,105,98,211,4,135,107,246
992,0.18,"(2, 5)","(11, 0)",9,141,135,285,7,114,98,219
993,0.08,"(28, 23)","(13, 2)",8,122,115,245,9,100,94,203
994,0.06,"(24, 27)","(29, 21)",17,91,93,201,4,72,44,120
995,0.16,"(13, 7)","(18, 7)",5,87,77,169,4,44,36,84
996,0.08,"(15, 17)","(14, 23)",4,47,36,87,8,79,62,149
997,0.18,"(20, 24)","(0, 19)",7,84,76,167,7,107,94,208
998,0.18,"(7, 13)","(17, 15)",6,75,66,147,8,107,89,204
999,0.16,"(23, 5)","(27, 7)",20,68,73,161,3,72,43,118
,,,,8.439,93.726,87.179,189.344,8.13,96.421,77.373,181.924
