0,0.18,"(3, 29)","(29, 3)",4,43,77,124,13,16,85,114
1,0.08,"(10, 29)","(7, 9)",3,78,122,203,10,103,341,454
2,0.14,"(26, 9)","(22, 29)",8,78,169,255,7,25,160,192
3,0.16,"(4, 8)","(26, 5)",10,85,138,233,6,28,159,193
4,0.12,"(19, 27)","(4, 29)",6,43,167,216,6,28,89,123
5,0.04,"(8, 9)","(22, 28)",11,57,66,134,5,13,61,79
6,0.1,"(3, 26)","(2, 18)",8,64,84,156,21,19,46,86
7,0.04,"(0, 27)","(7, 3)",26,127,158,311,27,97,219,343
8,0.06,"(2, 3)","(28, 3)",13,64,145,222,12,13,82,107
9,0.14,"(10, 20)","(24, 19)",6,78,124,208,7,22,67,96
10,0.14,"(8, 2)","(27, 19)",8,43,92,143,5,43,330,378
11,0.06,"(19, 20)","(28, 14)",16,99,189,304,14,52,462,528
12,0.02,"(19, 7)","(2, 24)",6,141,115,262,4,22,51,77
13,0.02,"(3, 13)","(27, 11)",27,141,186,354,18,82,217,317
14,0.14,"(18, 12)","(4, 22)",17,78,182,277,6,46,262,314
15,0.16,"(18, 29)","(9, 3)",7,64,145,216,8,34,118,160
16,0.14,"(3, 24)","(3, 28)",9,50,40,99,11,19,29,59
17,0.12,"(1, 2)","(9, 8)",7,64,54,125,4,46,283,333
18,0.16,"(18, 12)","(16, 29)",15,71,169,255,5,31,347,383
19,0.2,"(3, 29)","(7, 0)",4,106,290,400,6,25,136,167
20,0.02,"(28, 6)","(17, 5)",9,71,57,137,4,85,217,306
21,0.14,"(16, 11)","(8, 28)",5,57,105,167,5,22,106,133
22,0.1,"(7, 18)","(12, 1)",11,57,107,175,9,49,149,207
23,0.06,"(23, 13)","(0, 8)",6,99,103,208,10,10,64,84
24,0.04,"(13, 19)","(0, 0)",5,8,42,55,5,4,43,52
25,0.16,"(29, 14)","(15, 14)",7,71,183,261,3,28,64,95
26,0.2,"(19, 3)","(3, 10)",4,71,191,266,10,25,314,349
27,0.2,"(28, 8)","(11, 10)",4,113,361,478,7,67,499,573
28,0.12,"(21, 6)","(1, 8)",10,64,194,268,7,40,72,119
29,0.12,"(21, 10)","(22, 24)",13,85,133,231,3,49,239,291
30,0.08,"(16, 5)","(22, 28)",8,71,143,222,11,22,133,166
31,0.1,"(18, 11)","(20, 8)",5,22,37,64,10,25,45,80
32,0.08,"(9, 25)","(16, 24)",10,113,125,248,9,64,153,226
33,0.14,"(21, 2)","(22, 20)",8,64,189,261,5,52,261,318
34,0.18,"(20, 6)","(2, 23)",6,43,69,118,4,49,415,468
35,0.1,"(28, 14)","(6, 10)",7,50,91,148,9,46,193,248
36,0.2,"(17, 26)","(29, 5)",3,15,81,99,3,7,77,87
37,0.02,"(0, 11)","(25, 0)",3,85,107,195,6,31,124,161
38,0.12,"(10, 16)","(28, 8)",4,36,58,98,5,40,183,228
39,0.08,"(24, 25)","(10, 4)",6,78,142,226,7,34,125,166
40,0.02,"(6, 11)","(24, 5)",10,64,209,283,3,121,348,472
41,0.16,"(12, 3)","(20, 19)",9,36,94,139,4,61,395,460
42,0.1,"(13, 2)","(22, 29)",14,50,89,153,5,19,81,105
43,0.04,"(3, 22)","(8, 22)",5,64,48,117,7,94,126,227
44,0.12,"(25, 6)","(21, 13)",5,29,63,97,13,43,287,343
45,0.12,"(19, 25)","(29, 13)",6,64,126,196,16,28,204,248
46,0.08,"(27, 28)","(25, 20)",6,57,70,133,5,64,140,209
47,0.04,"(28, 11)","(20, 25)",9,57,122,188,10,25,100,135
48,0.14,"(8, 26)","(11, 19)",13,29,56,98,12,25,201,238
49,0.18,"(11, 29)","(0, 22)",8,29,35,72,3,19,215,237
50,0.16,"(24, 4)","(18, 20)",5,57,229,291,13,55,224,292
51,0.14,"(18, 0)","(28, 5)",4,78,234,316,4,16,52,72
52,0.02,"(27, 0)","(1, 18)",6,71,112,189,6,40,107,153
53,0.06,"(3, 21)","(6, 23)",10,29,18,57,11,16,36,63
54,0.16,"(20, 22)","(0, 13)",8,78,253,339,7,28,92,127
55,0.06,"(1, 28)","(3, 15)",3,57,78,138,6,37,71,114
56,0.16,"(23, 16)","(28, 22)",14,78,154,246,3,22,50,75
57,0.1,"(12, 20)","(12, 10)",5,78,121,204,23,70,175,268
58,0.12,"(10, 9)","(27, 28)",4,78,164,246,9,10,47,66
59,0.02,"(5, 6)","(4, 15)",8,99,136,243,20,148,398,566
60,0.06,"(7, 25)","(6, 28)",5,57,31,93,13,1,13,27
61,0.06,"(8, 29)","(17, 14)",16,92,184,292,3,52,154,209
62,0.14,"(10, 11)","(27, 17)",6,92,221,319,8,34,267,309
63,0.02,"(16, 6)","(0, 18)",13,106,107,226,5,55,111,171
64,0.12,"(1, 22)","(9, 6)",11,57,90,158,6,22,147,175
65,0.02,"(10, 16)","(29, 22)",8,57,100,165,12,133,409,554
66,0.02,"(10, 4)","(2, 14)",5,50,41,96,7,46,99,152
67,0.2,"(10, 20)","(19, 7)",7,71,224,302,7,31,196,234
68,0.08,"(19, 20)","(19, 7)",8,50,60,118,46,55,233,334
69,0.1,"(27, 22)","(18, 2)",5,71,178,254,6,43,224,273
70,0.14,"(27, 9)","(2, 22)",7,43,75,125,10,46,181,237
71,0.02,"(24, 26)","(20, 17)",10,148,328,486,8,79,161,248
72,0.2,"(1, 4)","(27, 28)",21,29,83,133,6,31,103,140
73,0.2,"(16, 3)","(21, 0)",4,50,30,84,10,40,367,417
74,0.02,"(1, 29)","(16, 18)",8,155,303,466,6,148,460,614
75,0.18,"(19, 4)","(8, 4)",15,8,35,58,8,67,301,376
76,0.14,"(4, 14)","(29, 16)",5,57,265,327,4,22,142,168
77,0.2,"(29, 22)","(15, 13)",8,64,188,260,8,31,202,241
78,0.2,"(25, 25)","(23, 20)",12,141,349,502,5,70,473,548
79,0.08,"(5, 4)","(13, 22)",36,78,227,341,9,37,177,223
80,0.08,"(25, 4)","(18, 13)",17,71,189,277,10,46,239,295
81,0.16,"(12, 22)","(6, 15)",8,50,85,143,7,49,265,321
82,0.08,"(15, 23)","(14, 14)",14,78,102,194,7,64,196,267
83,0.04,"(23, 2)","(10, 12)",9,92,155,256,6,55,205,266
84,0.06,"(1, 16)","(3, 8)",5,57,76,138,7,31,68,106
85,0.08,"(1, 2)","(15, 3)",6,64,73,143,4,31,189,224
86,0.1,"(10, 15)","(7, 25)",9,71,55,135,3,58,174,235
87,0.2,"(20, 17)","(16, 29)",12,43,199,254,7,61,536,604
88,0.16,"(15, 28)","(21, 20)",5,50,96,151,6,28,184,218
89,0.06,"(10, 3)","(29, 18)",9,50,110,169,6,25,159,190
90,0.04,"(14, 19)","(18, 5)",17,99,230,346,8,16,47,71
91,0.04,"(27, 7)","(8, 24)",7,169,166,342,7,52,216,275
92,0.06,"(1, 0)","(26, 0)",7,64,114,185,7,25,164,196
93,0.04,"(9, 10)","(14, 2)",3,36,66,105,8,88,412,508
94,0.14,"(9, 7)","(29, 29)",9,8,52,69,6,4,48,58
95,0.18,"(21, 24)","(4, 10)",5,64,85,154,5,31,234,270
96,0.1,"(23, 13)","(10, 10)",5,43,48,96,5,64,118,187
97,0.18,"(17, 0)","(3, 12)",6,50,150,206,5,40,193,238
98,0.06,"(3, 18)","(11, 24)",7,71,95,173,7,40,145,192
99,0.2,"(15, 18)","(5, 22)",16,64,194,274,8,49,265,322
100,0.16,"(7, 16)","(4, 0)",5,29,155,189,15,46,165,226
101,0.04,"(6, 20)","(13, 13)",12,78,121,211,11,19,82,112
102,0.18,"(27, 4)","(24, 9)",7,92,88,187,13,37,67,117
103,0.14,"(12, 18)","(14, 1)",12,71,106,189,4,34,105,143
104,0.16,"(24, 17)","(26, 7)",11,113,395,519,8,34,363,405
105,0.02,"(8, 20)","(28, 11)",6,92,98,196,5,52,103,160
106,0.08,"(28, 6)","(9, 16)",8,120,198,326,8,40,184,232
107,0.06,"(17, 23)","(20, 16)",7,106,161,274,6,55,86,147
108,0.2,"(25, 16)","(8, 0)",6,22,71,99,6,49,404,459
109,0.12,"(28, 1)","(22, 18)",4,99,304,407,8,64,262,334
110,0.14,"(21, 3)","(20, 24)",20,92,182,294,4,61,376,441
111,0.14,"(19, 13)","(16, 22)",15,50,100,165,8,31,260,299
112,0.2,"(5, 6)","(19, 8)",4,92,94,190,4,55,357,416
113,0.14,"(8, 18)","(21, 10)",4,78,257,339,6,43,103,152
114,0.14,"(15, 18)","(20, 3)",8,78,129,215,9,31,312,352
115,0.16,"(11, 15)","(0, 15)",5,36,41,82,9,58,469,536
116,0.14,"(17, 25)","(17, 16)",11,50,70,131,4,25,54,83
117,0.04,"(29, 22)","(17, 12)",14,36,107,157,5,88,218,311
118,0.1,"(10, 24)","(14, 2)",4,127,325,456,7,37,193,237
119,0.06,"(20, 1)","(20, 25)",8,120,186,314,5,61,335,401
120,0.16,"(18, 29)","(13, 9)",11,85,240,336,6,19,200,225
121,0.18,"(29, 20)","(15, 14)",6,57,98,161,8,40,235,283
122,0.2,"(22, 25)","(0, 18)",20,78,181,279,10,46,406,462
123,0.04,"(1, 9)","(13, 18)",10,15,66,91,6,43,248,297
124,0.2,"(12, 27)","(6, 10)",4,57,121,182,6,40,366,412
125,0.06,"(8, 23)","(9, 9)",9,162,158,329,4,79,247,330
126,0.16,"(7, 27)","(28, 21)",6,78,167,251,8,73,369,450
127,0.08,"(24, 28)","(21, 16)",3,134,231,368,4,28,53,85
128,0.1,"(0, 11)","(7, 0)",14,71,165,250,8,31,268,307
129,0.1,"(3, 29)","(11, 29)",7,22,50,79,9,31,103,143
130,0.14,"(5, 11)","(24, 4)",3,29,115,147,14,46,186,246
131,0.04,"(2, 21)","(21, 4)",3,50,165,218,10,58,151,219
132,0.04,"(20, 23)","(16, 5)",8,127,219,354,6,49,103,158
133,0.16,"(20, 28)","(8, 2)",5,85,180,270,6,40,263,309
134,0.04,"(6, 14)","(23, 12)",6,106,177,289,11,58,227,296
135,0.06,"(28, 1)","(29, 0)",14,22,19,55,6,10,10,26
136,0.02,"(16, 14)","(20, 17)",19,281,257,557,5,139,382,526
137,0.08,"(7, 24)","(8, 0)",8,99,172,279,4,46,136,186
138,0.12,"(27, 1)","(0, 7)",11,57,117,185,4,22,189,215
139,0.2,"(9, 24)","(10, 27)",5,36,27,68,6,16,29,51
140,0.2,"(19, 29)","(12, 13)",13,85,254,352,7,25,194,226
141,0.16,"(18, 28)","(8, 0)",3,43,107,153,4,28,111,143
142,0.16,"(5, 11)","(20, 5)",7,71,118,196,6,46,163,215
143,0.08,"(3, 5)","(11, 2)",29,57,100,186,11,43,131,185
144,0.06,"(26, 25)","(21, 0)",15,43,126,184,16,52,182,250
145,0.06,"(26, 7)","(8, 19)",11,29,83,123,6,49,147,202
146,0.04,"(14, 13)","(3, 28)",11,43,65,119,5,37,72,114
147,0.1,"(28, 17)","(14, 20)",4,43,46,93,12,31,85,128
148,0.12,"(7, 12)","(17, 22)",7,36,85,128,10,25,85,120
149,0.12,"(24, 15)","(19, 29)",8,92,144,244,6,46,248,300
150,0.2,"(11, 9)","(8, 14)",7,29,21,57,10,19,43,72
151,0.08,"(16, 27)","(4, 27)",8,22,35,65,6,46,97,149
152,0.2,"(8, 28)","(13, 8)",10,113,266,389,7,28,202,237
153,0.18,"(26, 7)","(24, 23)",25,36,191,252,5,31,203,239
154,0.06,"(24, 16)","(15, 17)",14,113,148,275,20,28,49,97
155,0.16,"(24, 22)","(14, 26)",9,43,58,110,4,43,345,392
156,0.18,"(11, 14)","(26, 9)",6,29,78,113,7,28,132,167
157,0.04,"(22, 11)","(20, 2)",5,148,80,233,5,67,242,314
158,0.18,"(23, 22)","(7, 10)",13,71,217,301,3,31,134,168
159,0.12,"(12, 21)","(22, 17)",9,85,212,306,6,43,351,400
160,0.04,"(8, 17)","(16, 20)",8,155,128,291,7,160,267,434
161,0.06,"(17, 19)","(3, 12)",5,78,151,234,4,61,156,221
162,0.18,"(16, 9)","(24, 27)",12,43,133,188,17,58,321,396
163,0.14,"(20, 22)","(18, 25)",7,57,45,109,3,16,41,60
164,0.08,"(10, 10)","(2, 12)",9,29,30,68,7,49,94,150
165,0.02,"(24, 25)","(6, 7)",3,99,123,225,4,94,215,313
166,0.04,"(22, 12)","(4, 14)",9,148,259,416,4,121,448,573
167,0.1,"(26, 10)","(0, 26)",12,36,68,116,9,94,589,692
168,0.02,"(22, 28)","(16, 0)",8,57,149,214,20,109,269,398
169,0.2,"(15, 7)","(20, 27)",7,106,187,300,6,46,277,329
170,0.14,"(14, 24)","(18, 17)",6,64,133,203,4,25,53,82
171,0.14,"(14, 29)","(11, 21)",8,78,231,317,11,34,119,164
172,0.06,"(2, 15)","(2, 29)",5,78,83,166,26,31,221,278
173,0.02,"(4, 28)","(9, 16)",12,43,80,135,7,58,343,408
174,0.1,"(29, 9)","(11, 13)",16,85,106,207,8,40,176,224
175,0.08,"(26, 21)","(20, 22)",7,57,48,112,4,10,17,31
176,0.02,"(6, 22)","(2, 22)",8,113,91,212,4,16,13,33
177,0.12,"(22, 23)","(23, 8)",22,50,118,190,4,40,148,192
178,0.12,"(12, 13)","(5, 5)",13,78,104,195,6,40,384,430
179,0.16,"(29, 18)","(22, 15)",11,15,32,58,12,19,44,75
180,0.06,"(14, 20)","(28, 19)",6,85,115,206,9,31,157,197
181,0.12,"(6, 19)","(19, 29)",17,50,141,208,6,19,71,96
182,0.1,"(12, 15)","(9, 20)",5,57,87,149,11,70,238,319
183,0.16,"(4, 9)","(8, 14)",6,43,63,112,9,25,49,83
184,0.02,"(6, 10)","(11, 16)",7,43,51,101,5,61,256,322
185,0.04,"(3, 13)","(15, 28)",7,36,54,97,8,46,189,243
186,0.2,"(21, 23)","(23, 6)",8,92,255,355,7,34,207,248
187,0.02,"(28, 27)","(13, 28)",5,92,67,164,4,58,166,228
188,0.02,"(23, 8)","(6, 2)",3,99,221,323,5,49,108,162
189,0.04,"(12, 14)","(5, 14)",11,85,75,171,13,169,473,655
190,0.14,"(29, 19)","(26, 16)",6,29,20,55,12,67,147,226
191,0.16,"(18, 5)","(0, 27)",9,22,57,88,10,13,62,85
192,0.12,"(28, 4)","(9, 23)",6,113,256,375,3,31,110,144
193,0.2,"(14, 15)","(21, 0)",6,50,231,287,4,19,64,87
194,0.12,"(8, 16)","(26, 22)",3,99,188,290,6,10,58,74
195,0.2,"(29, 11)","(27, 21)",7,36,78,121,12,31,86,129
196,0.06,"(21, 12)","(7, 13)",11,92,101,204,4,73,330,407
197,0.04,"(29, 21)","(6, 6)",3,113,147,263,3,127,469,599
198,0.04,"(22, 4)","(14, 3)",6,8,19,33,7,25,67,99
199,0.14,"(14, 29)","(24, 18)",4,71,211,286,5,37,95,137
200,0.2,"(18, 10)","(3, 29)",5,29,56,90,18,10,66,94
201,0.14,"(13, 11)","(23, 19)",4,92,291,387,8,49,178,235
202,0.08,"(28, 25)","(8, 23)",8,92,180,280,5,28,49,82
203,0.02,"(22, 12)","(24, 2)",10,85,84,179,4,73,354,431
204,0.04,"(10, 0)","(14, 22)",6,92,187,285,15,103,450,568
205,0.04,"(17, 28)","(27, 23)",9,78,109,196,4,40,114,158
206,0.18,"(24, 6)","(2, 9)",5,92,192,289,8,49,209,266
207,0.12,"(14, 12)","(0, 18)",3,57,101,161,10,10,104,124
208,0.12,"(10, 25)","(26, 25)",6,29,79,114,10,31,101,142
209,0.06,"(20, 19)","(26, 27)",7,57,135,199,5,97,396,498
210,0.2,"(5, 8)","(3, 19)",4,64,188,256,3,46,287,336
211,0.1,"(12, 24)","(7, 22)",16,64,83,163,8,10,20,38
212,0.16,"(11, 29)","(24, 0)",11,64,122,197,10,22,69,101
213,0.14,"(27, 9)","(12, 18)",4,92,182,278,4,13,187,204
214,0.08,"(8, 17)","(8, 22)",8,36,21,65,8,64,160,232
215,0.08,"(1, 15)","(4, 10)",6,50,51,107,5,16,24,45
216,0.12,"(25, 29)","(23, 7)",5,29,74,108,13,19,135,167
217,0.06,"(12, 28)","(26, 6)",4,85,128,217,5,76,247,328
218,0.16,"(29, 11)","(15, 1)",8,50,130,188,5,40,229,274
219,0.16,"(13, 9)","(18, 28)",7,43,68,118,3,25,72,100
220,0.12,"(25, 3)","(29, 12)",6,36,139,181,3,31,212,246
221,0.16,"(28, 8)","(19, 11)",11,99,317,427,3,22,49,74
222,0.12,"(15, 6)","(4, 3)",5,43,108,156,6,28,204,238
223,0.1,"(12, 24)","(25, 17)",5,57,108,170,10,67,223,300
224,0.16,"(9, 23)","(7, 27)",16,71,75,162,7,13,14,34
225,0.02,"(29, 6)","(17, 2)",9,78,141,228,24,31,112,167
226,0.08,"(13, 13)","(21, 3)",11,43,81,135,9,70,222,301
227,0.04,"(3, 24)","(1, 19)",9,43,105,157,8,73,414,495
228,0.18,"(15, 21)","(17, 9)",8,85,111,204,9,55,294,358
229,0.02,"(7, 29)","(2, 16)",4,43,30,77,6,61,87,154
230,0.14,"(0, 27)","(1, 7)",30,43,89,162,15,46,190,251
231,0.2,"(4, 20)","(17, 14)",4,106,257,367,7,25,132,164
232,0.2,"(14, 19)","(1, 1)",4,29,41,74,10,13,47,70
233,0.06,"(27, 10)","(6, 17)",7,71,83,161,18,97,388,503
234,0.1,"(20, 29)","(11, 18)",12,64,124,200,6,34,275,315
235,0.16,"(3, 0)","(27, 13)",14,57,161,232,17,28,173,218
236,0.04,"(29, 9)","(17, 15)",3,106,176,285,7,49,326,382
237,0.06,"(0, 21)","(13, 28)",17,57,108,182,3,28,128,159
238,0.08,"(15, 18)","(3, 11)",8,50,56,114,2,49,65,116
239,0.1,"(15, 9)","(4, 10)",3,43,31,77,2,37,159,198
240,0.08,"(18, 28)","(13, 3)",7,99,137,243,4,34,166,204
241,0.18,"(27, 29)","(3, 16)",5,64,125,194,7,34,253,294
242,0.16,"(5, 26)","(28, 20)",8,71,242,321,6,46,368,420
243,0.12,"(19, 24)","(20, 9)",8,43,70,121,3,61,184,248
244,0.16,"(11, 8)","(10, 26)",5,64,137,206,7,40,260,307
245,0.04,"(8, 3)","(24, 17)",5,64,124,193,4,64,135,203
246,0.1,"(21, 22)","(26, 27)",9,57,64,130,4,37,248,289
247,0.02,"(8, 0)","(28, 18)",2,43,69,114,6,37,183,226
248,0.06,"(4, 4)","(17, 20)",9,43,72,124,5,58,205,268
249,0.2,"(15, 9)","(26, 17)",4,64,240,308,3,46,345,394
250,0.1,"(17, 9)","(13, 29)",9,78,137,224,7,49,195,251
251,0.2,"(23, 19)","(2, 22)",6,57,138,201,8,52,344,404
252,0.06,"(2, 18)","(15, 0)",8,78,96,182,22,61,153,236
253,0.2,"(16, 26)","(5, 10)",14,106,348,468,7,34,151,192
254,0.12,"(6, 27)","(24, 10)",5,50,207,262,5,40,187,232
255,0.16,"(1, 1)","(20, 26)",6,29,88,123,4,73,438,515
256,0.08,"(0, 24)","(0, 20)",4,8,9,21,3,25,26,54
257,0.14,"(21, 20)","(25, 8)",8,92,134,234,4,37,347,388
258,0.06,"(28, 0)","(11, 23)",3,141,236,380,4,73,331,408
259,0.08,"(8, 17)","(21, 15)",7,99,201,307,6,73,207,286
260,0.2,"(17, 27)","(16, 20)",4,29,27,60,5,73,656,734
261,0.2,"(17, 21)","(23, 7)",8,64,277,349,5,34,286,325
262,0.2,"(16, 8)","(12, 26)",14,71,152,237,12,43,129,184
263,0.12,"(22, 21)","(25, 17)",4,71,109,184,3,37,45,85
264,0.08,"(10, 27)","(27, 26)",9,92,256,357,7,52,250,309
265,0.08,"(2, 7)","(7, 17)",4,78,252,334,8,28,43,79
266,0.08,"(26, 17)","(24, 13)",10,99,84,193,6,70,149,225
267,0.16,"(28, 18)","(6, 26)",10,99,230,339,17,22,116,155
268,0.2,"(1, 4)","(23, 8)",5,92,280,377,7,43,168,218
269,0.08,"(25, 23)","(24, 4)",3,64,194,261,4,58,254,316
270,0.18,"(27, 27)","(24, 0)",19,50,207,276,8,19,160,187
271,0.16,"(13, 25)","(13, 7)",4,64,109,177,9,55,321,385
272,0.18,"(2, 13)","(2, 3)",5,29,36,70,13,37,193,243
273,0.18,"(16, 4)","(26, 28)",19,57,201,277,13,61,311,385
274,0.16,"(12, 17)","(20, 19)",12,50,109,171,5,55,426,486
275,0.18,"(15, 5)","(13, 17)",2,64,137,203,6,34,261,301
276,0.02,"(25, 25)","(19, 19)",3,176,207,386,4,73,257,334
277,0.2,"(13, 15)","(27, 17)",24,78,133,235,11,52,512,575
278,0.1,"(3, 17)","(1, 21)",15,36,31,82,5,13,17,35
279,0.2,"(20, 17)","(13, 4)",18,78,157,253,8,31,252,291
280,0.18,"(3, 19)","(17, 1)",5,113,372,490,8,43,330,381
281,0.12,"(21, 14)","(27, 23)",9,50,89,148,9,37,188,234
282,0.18,"(19, 21)","(14, 8)",10,50,248,308,6,37,156,199
283,0.02,"(13, 20)","(0, 17)",5,113,312,430,13,64,163,240
284,0.08,"(25, 2)","(13, 8)",20,106,108,234,5,43,110,158
285,0.02,"(3, 27)","(0, 29)",10,43,19,72,21,55,104,180
286,0.1,"(28, 16)","(13, 9)",6,64,232,302,6,52,198,256
287,0.04,"(10, 29)","(15, 1)",5,36,134,175,5,79,411,495
288,0.12,"(5, 0)","(4, 22)",5,57,137,199,8,22,132,162
289,0.08,"(28, 28)","(7, 13)",10,78,134,222,3,37,266,306
290,0.04,"(19, 16)","(18, 21)",7,85,141,233,4,82,279,365
291,0.06,"(27, 23)","(13, 25)",3,127,137,267,4,22,128,154
292,0.12,"(15, 28)","(2, 12)",6,64,143,213,5,49,188,242
293,0.2,"(16, 5)","(0, 6)",3,36,149,188,5,46,84,135
294,0.14,"(5, 1)","(22, 9)",7,64,206,277,28,40,233,301
295,0.1,"(22, 26)","(8, 19)",3,36,61,100,5,55,343,403
296,0.14,"(12, 26)","(3, 12)",9,57,113,179,5,28,112,145
297,0.14,"(19, 20)","(26, 0)",4,106,136,246,9,22,159,190
298,0.06,"(25, 1)","(14, 23)",5,78,171,254,6,79,242,327
299,0.06,"(12, 27)","(25, 27)",20,57,69,146,18,52,99,169
300,0.14,"(2, 7)","(12, 1)",5,22,56,83,8,19,215,242
301,0.1,"(7, 26)","(11, 13)",8,78,75,161,9,28,134,171
302,0.14,"(28, 1)","(23, 5)",3,92,246,341,3,64,422,489
303,0.06,"(23, 2)","(24, 2)",4,36,14,54,14,16,32,62
304,0.04,"(5, 18)","(27, 12)",10,57,100,167,9,49,183,241
305,0.14,"(5, 27)","(15, 6)",8,71,227,306,7,43,280,330
306,0.2,"(0, 15)","(1, 26)",5,29,51,85,27,22,78,127
307,0.04,"(25, 20)","(8, 15)",4,50,89,143,6,16,88,110
308,0.16,"(25, 16)","(25, 23)",7,50,72,129,9,61,308,378
309,0.12,"(6, 29)","(6, 27)",7,50,35,92,4,10,9,23
310,0.02,"(14, 14)","(0, 28)",7,57,125,189,4,7,94,105
311,0.1,"(9, 15)","(18, 28)",10,85,209,304,6,22,67,95
312,0.16,"(28, 2)","(1, 28)",6,15,60,81,6,7,59,72
313,0.16,"(24, 25)","(7, 7)",6,85,164,255,5,40,259,304
314,0.12,"(8, 2)","(28, 5)",4,43,157,204,8,40,184,232
315,0.2,"(14, 12)","(11, 13)",6,29,15,50,7,19,35,61
316,0.04,"(3, 6)","(18, 6)",5,120,147,272,5,43,159,207
317,0.2,"(16, 22)","(10, 25)",12,22,41,75,4,46,121,171
318,0.1,"(16, 23)","(29, 1)",4,29,125,158,4,58,263,325
319,0.16,"(15, 16)","(28, 22)",3,57,165,225,7,40,215,262
320,0.02,"(11, 14)","(26, 9)",8,169,182,359,6,88,204,298
321,0.12,"(0, 20)","(20, 7)",5,85,140,230,3,46,358,407
322,0.12,"(25, 21)","(19, 17)",6,71,69,146,13,58,235,306
323,0.16,"(19, 15)","(8, 0)",10,64,129,203,13,16,97,126
324,0.14,"(10, 17)","(16, 27)",11,78,137,226,7,19,61,87
325,0.18,"(10, 4)","(19, 29)",16,22,115,153,7,103,895,1005
326,0.1,"(18, 28)","(26, 26)",24,29,62,115,19,34,65,118
327,0.1,"(21, 13)","(16, 17)",3,64,78,145,10,52,160,222
328,0.02,"(3, 10)","(23, 4)",4,211,210,425,3,40,126,169
329,0.04,"(28, 29)","(21, 23)",2,120,85,207,4,19,40,63
330,0.16,"(24, 1)","(6, 1)",21,71,200,292,7,19,198,224
331,0.04,"(5, 2)","(4, 10)",6,57,49,112,14,91,175,280
332,0.2,"(22, 12)","(5, 11)",6,99,302,407,6,46,323,375
333,0.08,"(13, 29)","(15, 23)",9,78,61,148,7,82,152,241
334,0.2,"(23, 16)","(18, 9)",3,50,75,128,4,49,206,259
335,0.1,"(14, 5)","(1, 0)",15,29,154,198,9,13,146,168
336,0.08,"(22, 5)","(3, 11)",12,92,177,281,7,31,150,188
337,0.12,"(28, 26)","(21, 7)",44,92,266,402,8,52,290,350
338,0.2,"(19, 24)","(28, 28)",18,43,74,135,12,34,95,141
339,0.16,"(18, 6)","(9, 8)",12,113,445,570,6,61,360,427
340,0.1,"(15, 13)","(4, 18)",7,85,117,209,11,37,128,176
341,0.18,"(17, 25)","(4, 28)",6,64,101,171,6,31,196,233
342,0.12,"(12, 7)","(12, 29)",3,36,73,112,5,25,141,171
343,0.2,"(19, 29)","(13, 20)",7,106,244,357,5,43,245,293
344,0.18,"(26, 7)","(19, 14)",8,85,226,319,9,49,468,526
345,0.1,"(26, 29)","(16, 15)",3,57,190,250,8,16,185,209
346,0.02,"(5, 10)","(24, 0)",4,57,164,225,6,199,455,660
347,0.02,"(10, 2)","(27, 25)",4,113,85,202,5,97,535,637
348,0.12,"(22, 20)","(26, 13)",8,50,108,166,5,64,196,265
349,0.1,"(26, 2)","(14, 5)",8,57,61,126,4,40,81,125
350,0.16,"(24, 16)","(28, 16)",13,57,168,238,9,52,234,295
351,0.08,"(7, 16)","(29, 2)",10,64,106,180,3,34,148,185
352,0.18,"(14, 19)","(12, 0)",10,64,128,202,30,46,372,448
353,0.16,"(29, 25)","(4, 9)",6,22,87,115,6,58,344,408
354,0.08,"(25, 29)","(24, 3)",8,50,102,160,2,55,150,207
355,0.06,"(8, 23)","(18, 15)",5,64,74,143,4,31,80,115
356,0.02,"(8, 27)","(21, 24)",21,57,85,163,9,133,203,345
357,0.18,"(4, 29)","(29, 18)",2,78,158,238,5,40,357,402
358,0.2,"(20, 8)","(7, 7)",7,29,46,82,7,49,318,374
359,0.18,"(21, 12)","(20, 27)",17,64,80,161,7,34,300,341
360,0.18,"(4, 18)","(5, 28)",17,43,106,166,13,28,147,188
361,0.2,"(22, 19)","(22, 24)",31,29,52,112,7,25,85,117
362,0.02,"(3, 14)","(25, 22)",14,64,106,184,12,118,281,411
363,0.18,"(12, 25)","(19, 17)",5,92,295,392,4,25,70,99
364,0.14,"(22, 23)","(8, 28)",19,71,168,258,5,40,234,279
365,0.2,"(0, 21)","(11, 21)",4,29,48,81,14,58,429,501
366,0.08,"(23, 19)","(1, 21)",7,71,75,153,10,73,163,246
367,0.2,"(17, 18)","(0, 16)",9,50,212,271,6,40,325,371
368,0.08,"(25, 13)","(11, 25)",30,106,212,348,10,61,343,414
369,0.04,"(16, 20)","(10, 11)",11,127,133,271,16,16,49,81
370,0.1,"(13, 12)","(20, 12)",5,92,128,225,10,82,421,513
371,0.16,"(24, 4)","(27, 14)",4,36,47,87,10,52,198,260
372,0.08,"(27, 16)","(0, 10)",5,43,92,140,10,31,93,134
373,0.14,"(3, 27)","(6, 8)",6,64,141,211,12,25,144,181
374,0.2,"(20, 7)","(15, 9)",11,50,51,112,7,79,526,612
375,0.06,"(7, 4)","(19, 4)",5,78,79,162,7,22,174,203
376,0.2,"(4, 3)","(16, 10)",7,106,277,390,5,37,235,277
377,0.2,"(20, 4)","(20, 29)",10,36,134,180,12,40,310,362
378,0.02,"(20, 26)","(3, 21)",5,120,143,268,8,43,128,179
379,0.14,"(28, 3)","(6, 1)",6,78,182,266,4,25,123,152
380,0.04,"(16, 25)","(26, 2)",5,57,113,175,5,94,216,315
381,0.18,"(5, 29)","(13, 27)",22,57,85,164,7,73,406,486
382,0.18,"(21, 14)","(19, 21)",9,22,43,74,11,16,56,83
383,0.02,"(14, 15)","(19, 9)",14,141,179,334,12,115,385,512
384,0.18,"(13, 4)","(26, 26)",5,29,66,100,8,13,63,84
385,0.2,"(6, 8)","(0, 8)",14,8,20,42,26,25,97,148
386,0.1,"(4, 23)","(17, 21)",5,50,96,151,6,73,322,401
387,0.1,"(2, 19)","(16, 23)",13,64,108,185,6,64,290,360
388,0.08,"(29, 27)","(2, 17)",4,134,255,393,6,34,119,159
389,0.1,"(1, 10)","(12, 19)",6,71,218,295,7,70,421,498
390,0.02,"(13, 17)","(1, 16)",4,106,124,234,5,106,281,392
391,0.06,"(9, 2)","(10, 1)",14,64,28,106,4,52,74,130
392,0.02,"(20, 1)","(6, 13)",3,190,399,592,17,151,361,529
393,0.14,"(6, 2)","(20, 24)",4,85,260,349,8,28,135,171
394,0.12,"(19, 6)","(21, 10)",8,22,38,68,5,40,153,198
395,0.1,"(28, 4)","(6, 3)",37,64,230,331,7,40,133,180
396,0.12,"(17, 26)","(22, 21)",3,43,53,99,25,64,185,274
397,0.1,"(8, 14)","(19, 10)",6,64,212,282,6,55,223,284
398,0.18,"(5, 23)","(1, 23)",12,22,31,65,5,19,32,56
399,0.06,"(25, 15)","(10, 28)",11,50,141,202,7,34,164,205
400,0.02,"(0, 5)","(28, 22)",6,64,132,202,8,106,237,351
401,0.1,"(10, 9)","(23, 21)",4,99,194,297,7,40,120,167
402,0.04,"(25, 19)","(8, 29)",3,120,145,268,9,52,213,274
403,0.2,"(4, 1)","(14, 5)",4,50,57,111,6,58,340,404
404,0.2,"(22, 6)","(23, 10)",22,22,38,82,29,52,172,253
405,0.02,"(11, 19)","(26, 22)",4,92,182,278,4,94,222,320
406,0.08,"(14, 27)","(20, 23)",6,36,110,152,4,61,398,463
407,0.04,"(21, 11)","(29, 3)",3,78,145,226,4,22,133,159
408,0.1,"(17, 14)","(29, 1)",10,36,137,183,9,13,143,165
409,0.16,"(11, 27)","(13, 11)",12,78,199,289,10,25,191,226
410,0.04,"(28, 14)","(23, 8)",3,78,57,138,6,106,305,417
411,0.18,"(16, 6)","(11, 20)",9,50,233,292,4,31,166,201
412,0.14,"(3, 14)","(10, 4)",7,64,115,186,4,31,318,353
413,0.08,"(25, 24)","(9, 19)",12,99,171,282,4,34,103,141
414,0.08,"(15, 8)","(25, 1)",6,22,95,123,3,43,150,196
415,0.08,"(22, 27)","(1, 8)",17,22,81,120,8,49,106,163
416,0.04,"(14, 4)","(12, 19)",5,155,206,366,13,82,198,293
417,0.14,"(3, 27)","(20, 20)",7,43,98,148,10,49,268,327
418,0.12,"(23, 27)","(21, 9)",4,85,201,290,8,43,105,156
419,0.1,"(21, 7)","(8, 23)",17,43,96,156,43,49,154,246
420,0.02,"(11, 28)","(6, 29)",9,78,123,210,6,43,46,95
421,0.16,"(8, 4)","(9, 22)",4,64,103,171,3,70,294,367
422,0.04,"(29, 16)","(21, 0)",4,183,228,415,12,16,114,142
423,0.1,"(25, 5)","(24, 27)",7,50,102,159,17,67,274,358
424,0.2,"(28, 17)","(12, 22)",5,78,131,214,3,40,218,261
425,0.12,"(0, 18)","(21, 4)",5,43,116,164,5,67,311,383
426,0.1,"(15, 7)","(6, 11)",14,57,75,146,9,43,328,380
427,0.12,"(24, 6)","(26, 15)",7,57,55,119,6,61,385,452
428,0.08,"(3, 26)","(20, 28)",4,57,52,113,7,49,210,266
429,0.12,"(20, 17)","(17, 16)",6,15,9,30,9,49,162,220
430,0.06,"(5, 13)","(17, 1)",5,64,111,180,11,37,144,192
431,0.12,"(12, 8)","(2, 11)",13,57,79,149,12,49,237,298
432,0.06,"(2, 19)","(3, 5)",6,57,45,108,10,52,121,183
433,0.06,"(8, 8)","(2, 13)",5,50,185,240,8,52,215,275
434,0.1,"(26, 9)","(0, 12)",8,29,72,109,12,49,155,216
435,0.04,"(20, 12)","(22, 4)",13,99,134,246,9,52,180,241
436,0.08,"(23, 10)","(19, 19)",9,50,80,139,7,25,40,72
437,0.12,"(17, 0)","(26, 26)",4,106,173,283,6,31,135,172
438,0.06,"(26, 7)","(22, 23)",3,57,115,175,9,61,224,294
439,0.16,"(2, 13)","(0, 13)",13,15,17,45,14,31,66,111
440,0.16,"(8, 4)","(11, 22)",8,29,68,105,6,37,210,253
441,0.04,"(27, 26)","(6, 17)",5,92,127,224,5,43,158,206
442,0.12,"(28, 2)","(2, 24)",5,22,96,123,13,49,167,229
443,0.18,"(22, 24)","(17, 1)",10,71,293,374,3,22,250,275
444,0.18,"(7, 14)","(22, 20)",25,106,306,437,9,46,259,314
445,0.2,"(16, 25)","(17, 22)",17,43,56,116,16,7,33,56
446,0.18,"(3, 21)","(25, 25)",5,71,188,264,6,34,137,177
447,0.18,"(9, 26)","(23, 28)",7,78,190,275,9,46,189,244
448,0.02,"(19, 13)","(9, 3)",5,197,246,448,9,61,160,230
449,0.16,"(27, 6)","(12, 10)",5,71,216,292,10,70,313,393
450,0.2,"(22, 7)","(25, 23)",10,57,114,181,5,40,207,252
451,0.1,"(9, 15)","(27, 19)",11,64,125,200,8,22,120,150
452,0.06,"(26, 7)","(26, 28)",5,71,129,205,5,40,181,226
453,0.08,"(21, 5)","(29, 4)",8,57,52,117,9,73,204,286
454,0.02,"(27, 5)","(2, 16)",8,183,212,403,8,70,184,262
455,0.02,"(8, 20)","(19, 7)",6,141,199,346,11,46,134,191
456,0.02,"(19, 11)","(27, 21)",8,127,116,251,7,49,231,287
457,0.04,"(29, 8)","(1, 5)",5,71,122,198,5,67,222,294
458,0.06,"(18, 20)","(15, 10)",10,92,155,257,11,43,104,158
459,0.04,"(21, 21)","(29, 6)",6,134,180,320,7,61,327,395
460,0.2,"(1, 24)","(10, 15)",8,99,285,392,11,43,303,357
461,0.04,"(2, 20)","(17, 16)",4,148,248,400,16,37,213,266
462,0.1,"(2, 1)","(15, 8)",5,57,106,168,6,55,222,283
463,0.06,"(11, 26)","(6, 19)",10,36,42,88,4,97,281,382
464,0.14,"(11, 22)","(25, 28)",14,57,167,238,5,22,147,174
465,0.14,"(0, 23)","(4, 14)",3,43,33,79,3,22,51,76
466,0.12,"(2, 28)","(27, 12)",9,50,119,178,4,52,234,290
467,0.08,"(1, 18)","(13, 19)",6,43,87,136,14,16,89,119
468,0.18,"(4, 10)","(23, 16)",10,85,169,264,6,22,249,277
469,0.06,"(8, 6)","(4, 9)",14,15,38,67,6,19,26,51
470,0.08,"(0, 28)","(1, 11)",8,99,244,351,11,31,85,127
471,0.14,"(20, 26)","(8, 27)",7,36,44,87,5,25,61,91
472,0.02,"(2, 28)","(28, 16)",10,169,321,500,7,46,116,169
473,0.2,"(10, 22)","(6, 21)",8,36,28,72,8,46,309,363
474,0.14,"(17, 15)","(2, 24)",6,29,49,84,5,40,156,201
475,0.18,"(1, 3)","(12, 22)",8,57,224,289,13,43,276,332
476,0.08,"(1, 29)","(16, 6)",6,43,85,134,11,46,238,295
477,0.02,"(18, 18)","(9, 8)",7,183,197,387,8,85,281,374
478,0.04,"(0, 9)","(8, 23)",9,113,296,418,7,79,116,202
479,0.04,"(16, 27)","(19, 15)",5,211,302,518,10,76,241,327
480,0.12,"(0, 17)","(17, 1)",9,71,160,240,4,61,419,484
481,0.2,"(20, 27)","(19, 28)",5,50,49,104,5,22,51,78
482,0.14,"(5, 16)","(16, 21)",5,57,120,182,7,37,223,267
483,0.12,"(27, 1)","(8, 27)",14,71,116,201,4,37,84,125
484,0.12,"(5, 2)","(19, 22)",7,113,284,404,7,31,123,161
485,0.2,"(6, 27)","(17, 13)",10,92,225,327,9,13,185,207
486,0.12,"(7, 8)","(24, 21)",16,36,99,151,4,40,91,135
487,0.12,"(17, 12)","(14, 24)",10,50,89,149,7,61,196,264
488,0.14,"(21, 11)","(21, 0)",5,43,126,174,9,31,102,142
489,0.06,"(28, 15)","(2, 29)",3,162,242,407,2,13,100,115
490,0.08,"(6, 9)","(27, 20)",3,57,85,145,6,37,193,236
491,0.02,"(5, 25)","(0, 15)",3,57,105,165,15,25,64,104
492,0.08,"(7, 1)","(11, 25)",5,71,125,201,2,67,237,306
493,0.12,"(7, 29)","(14, 2)",5,50,111,166,13,43,176,232
494,0.14,"(8, 23)","(16, 15)",9,176,237,422,12,55,207,274
495,0.14,"(1, 2)","(27, 4)",3,43,173,219,7,49,219,275
496,0.02,"(3, 2)","(3, 23)",4,141,141,286,9,64,92,165
497,0.14,"(16, 10)","(11, 25)",5,64,139,208,9,31,255,295
498,0.12,"(4, 20)","(14, 23)",5,57,122,184,9,16,78,103
499,0.02,"(24, 16)","(23, 2)",6,78,98,182,12,79,373,464
500,0.04,"(6, 25)","(14, 6)",17,113,186,316,10,22,154,186
501,0.18,"(13, 10)","(11, 18)",3,78,170,251,3,58,490,551
502,0.12,"(16, 26)","(2, 26)",11,64,183,258,7,37,67,111
503,0.08,"(3, 24)","(6, 18)",5,36,32,73,8,43,98,149
504,0.08,"(0, 6)","(26, 19)",4,85,105,194,3,46,139,188
505,0.06,"(23, 15)","(8, 14)",7,113,186,306,6,19,77,102
506,0.1,"(23, 10)","(23, 21)",4,36,82,122,5,85,229,319
507,0.08,"(10, 9)","(25, 18)",11,127,172,310,7,58,290,355
508,0.12,"(14, 22)","(2, 8)",6,43,79,128,7,25,119,151
509,0.12,"(21, 2)","(4, 23)",11,78,276,365,13,37,133,183
510,0.18,"(22, 13)","(3, 14)",4,36,78,118,6,49,322,377
511,0.16,"(11, 2)","(4, 23)",6,78,153,237,12,43,171,226
512,0.16,"(25, 17)","(23, 25)",8,92,97,197,21,97,508,626
513,0.2,"(8, 0)","(4, 24)",12,36,124,172,26,82,834,942
514,0.16,"(20, 7)","(24, 28)",5,57,163,225,9,31,195,235
515,0.1,"(13, 8)","(14, 28)",5,29,76,110,10,28,98,136
516,0.02,"(16, 0)","(23, 6)",10,190,185,385,6,106,455,567
517,0.2,"(21, 8)","(17, 22)",4,92,232,328,3,34,262,299
518,0.18,"(24, 18)","(12, 4)",5,99,218,322,6,52,380,438
519,0.06,"(20, 25)","(20, 29)",6,36,54,96,11,49,254,314
520,0.12,"(24, 22)","(14, 3)",8,85,128,221,7,58,283,348
521,0.04,"(10, 28)","(7, 14)",5,71,126,202,16,88,215,319
522,0.06,"(26, 9)","(8, 3)",9,85,211,305,4,22,40,66
523,0.16,"(17, 28)","(20, 18)",3,50,76,129,21,34,189,244
524,0.16,"(25, 29)","(8, 23)",3,71,233,307,5,46,251,302
525,0.16,"(15, 11)","(19, 8)",7,71,71,149,6,40,58,104
526,0.06,"(21, 16)","(18, 27)",19,71,193,283,6,73,342,421
527,0.02,"(0, 20)","(15, 9)",17,127,138,282,4,52,228,284
528,0.18,"(6, 1)","(16, 21)",2,71,212,285,5,67,315,387
529,0.04,"(23, 24)","(0, 19)",11,106,90,207,7,55,174,236
530,0.12,"(25, 10)","(1, 1)",32,57,165,254,16,37,188,241
531,0.02,"(24, 6)","(29, 10)",7,57,86,150,15,34,49,98
532,0.1,"(11, 14)","(7, 18)",10,64,70,144,9,43,118,170
533,0.14,"(12, 25)","(22, 26)",8,29,54,91,2,37,181,220
534,0.2,"(7, 18)","(25, 9)",5,92,311,408,8,34,254,296
535,0.12,"(7, 25)","(4, 22)",8,43,72,123,7,37,240,284
536,0.2,"(12, 14)","(3, 26)",3,43,176,222,5,16,147,168
537,0.16,"(3, 23)","(15, 21)",6,50,91,147,10,22,231,263
538,0.18,"(5, 5)","(9, 19)",6,50,239,295,9,40,359,408
539,0.04,"(10, 14)","(23, 0)",6,22,83,111,3,13,84,100
540,0.06,"(3, 22)","(0, 8)",17,22,35,74,15,40,67,122
541,0.1,"(22, 15)","(5, 18)",12,64,79,155,3,55,310,368
542,0.18,"(13, 21)","(15, 7)",11,120,316,447,12,61,472,545
543,0.06,"(22, 13)","(15, 27)",8,78,161,247,7,58,326,391
544,0.14,"(3, 14)","(25, 14)",4,78,169,251,23,52,252,327
545,0.18,"(8, 15)","(19, 0)",12,29,84,125,21,16,91,128
546,0.08,"(1, 23)","(19, 15)",6,106,245,357,4,76,401,481
547,0.14,"(17, 18)","(14, 19)",6,8,11,25,13,28,37,78
548,0.08,"(7, 17)","(10, 29)",4,29,62,95,6,16,64,86
549,0.04,"(8, 27)","(24, 16)",6,64,126,196,4,88,196,288
550,0.2,"(19, 15)","(15, 5)",7,92,225,324,10,22,246,278
551,0.06,"(9, 12)","(0, 28)",5,71,227,303,9,43,276,328
552,0.04,"(0, 0)","(26, 29)",5,29,69,103,9,49,192,250
553,0.2,"(13, 20)","(26, 12)",14,43,96,153,18,46,275,339
554,0.04,"(13, 15)","(3, 10)",6,120,84,210,15,31,87,133
555,0.14,"(19, 12)","(18, 19)",8,36,57,101,11,31,59,101
556,0.12,"(3, 21)","(7, 17)",4,57,29,90,3,19,45,67
557,0.14,"(7, 1)","(2, 1)",5,36,23,64,8,25,43,76
558,0.04,"(1, 9)","(15, 29)",4,50,59,113,9,49,291,349
559,0.2,"(17, 21)","(6, 8)",4,57,102,163,13,31,250,294
560,0.14,"(6, 16)","(12, 11)",7,85,159,251,8,70,158,236
561,0.2,"(0, 3)","(22, 16)",6,99,282,387,29,109,850,988
562,0.12,"(18, 23)","(3, 16)",5,92,270,367,8,31,184,223
563,0.06,"(9, 28)","(10, 24)",9,64,49,122,11,19,42,72
564,0.04,"(27, 19)","(22, 15)",5,78,102,185,9,82,187,278
565,0.16,"(28, 23)","(2, 5)",9,57,85,151,10,16,84,110
566,0.2,"(28, 4)","(22, 17)",4,71,273,348,8,34,244,286
567,0.08,"(2, 25)","(23, 26)",7,29,117,153,11,19,132,162
568,0.08,"(1, 14)","(29, 18)",4,36,77,117,3,43,158,204
569,0.14,"(6, 19)","(1, 24)",11,36,43,90,4,31,129,164
570,0.08,"(28, 29)","(19, 14)",26,71,126,223,11,100,439,550
571,0.16,"(0, 4)","(7, 16)",4,71,222,297,3,70,334,407
572,0.04,"(19, 8)","(5, 9)",5,204,257,466,5,52,101,158
573,0.12,"(15, 16)","(8, 4)",2,36,95,133,2,52,103,157
574,0.18,"(28, 16)","(25, 1)",16,99,270,385,3,25,239,267
575,0.02,"(20, 29)","(4, 4)",4,183,257,444,8,61,161,230
576,0.18,"(16, 12)","(2, 14)",12,78,144,234,11,46,395,452
577,0.04,"(4, 6)","(17, 7)",4,64,72,140,32,52,134,218
578,0.18,"(27, 25)","(25, 7)",7,71,180,258,7,34,186,227
579,0.08,"(14, 17)","(21, 6)",5,64,130,199,7,76,184,267
580,0.16,"(16, 1)","(28, 1)",5,36,104,145,6,37,372,415
581,0.02,"(29, 23)","(3, 18)",12,134,197,343,12,100,351,463
582,0.12,"(15, 14)","(25, 14)",5,22,78,105,6,31,56,93
583,0.04,"(10, 6)","(23, 16)",2,113,161,276,2,88,293,383
584,0.16,"(0, 15)","(19, 8)",3,57,237,297,3,37,180,220
585,0.04,"(6, 23)","(21, 5)",6,92,128,226,5,142,430,577
586,0.02,"(24, 5)","(13, 3)",9,78,129,216,10,103,586,699
587,0.1,"(13, 18)","(2, 5)",9,36,73,118,12,40,178,230
588,0.1,"(1, 18)","(18, 2)",7,43,84,134,8,76,181,265
589,0.12,"(3, 5)","(7, 28)",30,64,171,265,6,31,190,227
590,0.2,"(26, 14)","(16, 11)",10,85,238,333,5,31,59,95
591,0.1,"(10, 28)","(22, 9)",17,78,128,223,27,25,242,294
592,0.1,"(22, 22)","(1, 27)",7,71,79,157,7,19,169,195
593,0.02,"(17, 22)","(3, 7)",5,127,175,307,6,76,172,254
594,0.08,"(19, 0)","(0, 27)",9,64,79,152,8,7,59,74
595,0.02,"(15, 13)","(18, 4)",5,57,87,149,7,97,306,410
596,0.14,"(23, 12)","(20, 21)",4,78,132,214,9,49,98,156
597,0.2,"(1, 16)","(14, 0)",4,29,98,131,8,13,105,126
598,0.2,"(5, 13)","(22, 11)",6,85,267,358,6,31,87,124
599,0.12,"(16, 23)","(9, 3)",8,50,101,159,6,31,90,127
600,0.04,"(14, 16)","(22, 9)",13,134,176,323,4,25,77,106
601,0.04,"(29, 22)","(5, 13)",8,64,93,165,6,49,179,234
602,0.16,"(8, 20)","(2, 20)",5,43,35,83,5,13,21,39
603,0.08,"(6, 19)","(13, 14)",4,106,133,243,4,46,291,341
604,0.04,"(20, 27)","(10, 2)",9,176,176,361,6,91,205,302
605,0.1,"(21, 12)","(5, 12)",6,36,37,79,6,31,248,285
606,0.12,"(17, 2)","(8, 6)",5,64,51,120,5,46,267,318
607,0.02,"(20, 5)","(5, 13)",12,120,195,327,6,82,225,313
608,0.06,"(0, 28)","(7, 1)",3,43,50,96,3,22,110,135
609,0.08,"(29, 8)","(22, 22)",5,71,122,198,7,52,185,244
610,0.2,"(10, 12)","(28, 3)",6,36,84,126,10,70,217,297
611,0.12,"(22, 22)","(19, 12)",4,78,99,181,15,37,239,291
612,0.08,"(27, 4)","(18, 4)",6,141,196,343,5,31,53,89
613,0.04,"(26, 1)","(21, 7)",11,99,64,174,5,10,31,46
614,0.02,"(5, 8)","(24, 23)",6,197,173,376,14,28,97,139
615,0.16,"(12, 1)","(1, 24)",17,29,92,138,6,19,91,116
616,0.14,"(16, 6)","(3, 23)",5,57,139,201,12,40,116,168
617,0.08,"(17, 4)","(24, 0)",8,43,89,140,18,37,103,158
618,0.04,"(3, 8)","(23, 16)",5,127,178,310,7,13,71,91
619,0.02,"(13, 27)","(14, 8)",9,71,105,185,25,109,181,315
620,0.12,"(17, 13)","(8, 6)",10,64,84,158,10,43,163,216
621,0.12,"(14, 5)","(1, 12)",8,71,171,250,10,25,99,134
622,0.12,"(5, 20)","(26, 15)",11,57,159,227,11,55,280,346
623,0.04,"(4, 19)","(11, 28)",21,155,225,401,28,37,204,269
624,0.14,"(3, 27)","(9, 29)",31,92,288,411,6,19,40,65
625,0.02,"(2, 14)","(1, 13)",10,64,28,102,8,16,16,40
626,0.12,"(28, 12)","(16, 4)",5,57,72,134,3,49,225,277
627,0.02,"(25, 18)","(7, 3)",5,148,209,362,8,34,83,125
628,0.1,"(16, 15)","(6, 16)",6,43,42,91,4,16,31,51
629,0.2,"(9, 13)","(7, 11)",12,15,21,48,9,28,32,69
630,0.12,"(27, 15)","(3, 25)",10,36,100,146,7,52,359,418
631,0.06,"(4, 7)","(8, 7)",7,85,140,232,8,1,8,17
632,0.02,"(5, 28)","(2, 0)",7,57,85,149,4,61,264,329
633,0.2,"(4, 15)","(19, 7)",5,106,171,282,8,31,212,251
634,0.06,"(13, 27)","(0, 16)",10,85,73,168,10,10,144,164
635,0.1,"(27, 19)","(8, 1)",6,43,89,138,9,49,251,309
636,0.2,"(11, 29)","(24, 18)",14,92,313,419,8,46,251,305
637,0.06,"(20, 18)","(23, 26)",4,64,93,161,7,55,152,214
638,0.06,"(0, 25)","(5, 18)",8,127,278,413,5,55,125,185
639,0.1,"(0, 13)","(29, 11)",8,57,178,243,11,19,219,249
640,0.16,"(9, 5)","(23, 27)",7,29,60,96,7,28,67,102
641,0.04,"(11, 26)","(25, 19)",6,36,79,121,5,34,129,168
642,0.18,"(27, 2)","(24, 1)",7,8,16,31,10,10,20,40
643,0.1,"(24, 19)","(2, 0)",14,29,79,122,13,16,64,93
644,0.16,"(20, 7)","(27, 8)",7,71,99,177,7,46,454,507
645,0.04,"(23, 23)","(21, 22)",6,71,28,105,8,4,9,21
646,0.02,"(16, 17)","(27, 19)",5,113,189,307,8,70,223,301
647,0.14,"(12, 28)","(15, 25)",10,50,95,155,6,52,322,380
648,0.08,"(6, 11)","(18, 21)",24,71,111,206,17,109,362,488
649,0.04,"(10, 7)","(2, 18)",8,64,74,146,11,88,234,333
650,0.16,"(21, 18)","(13, 10)",15,43,165,223,6,40,108,154
651,0.02,"(11, 14)","(14, 23)",9,183,167,359,5,121,339,465
652,0.1,"(29, 2)","(8, 9)",4,64,144,212,21,31,263,315
653,0.18,"(8, 15)","(3, 6)",6,85,190,281,5,28,70,103
654,0.02,"(10, 26)","(5, 4)",40,162,183,385,8,166,421,595
655,0.16,"(12, 12)","(2, 21)",10,43,162,215,12,52,238,302
656,0.02,"(24, 17)","(10, 3)",9,92,130,231,5,31,138,174
657,0.04,"(13, 17)","(4, 0)",4,29,71,104,7,34,60,101
658,0.14,"(16, 4)","(19, 7)",6,22,36,64,4,37,150,191
659,0.04,"(29, 10)","(27, 23)",3,106,117,226,3,28,64,95
660,0.12,"(9, 17)","(15, 16)",9,85,88,182,4,43,119,166
661,0.2,"(24, 28)","(22, 11)",3,99,283,385,3,43,250,296
662,0.12,"(16, 16)","(7, 4)",3,57,68,128,10,55,156,221
663,0.12,"(28, 29)","(26, 0)",3,43,121,167,7,28,170,205
664,0.08,"(17, 1)","(10, 8)",3,57,71,131,10,46,323,379
665,0.1,"(1, 8)","(10, 0)",4,43,149,196,2,64,251,317
666,0.2,"(12, 15)","(5, 24)",5,85,165,255,4,37,212,253
667,0.14,"(18, 28)","(11, 26)",8,36,57,101,6,22,41,69
668,0.2,"(24, 17)","(29, 12)",5,71,98,174,5,28,84,117
669,0.16,"(1, 0)","(20, 21)",3,85,127,215,3,52,285,340
670,0.16,"(26, 23)","(1, 28)",5,71,159,235,9,16,111,136
671,0.04,"(19, 21)","(13, 20)",5,162,123,290,8,40,55,103
672,0.2,"(2, 20)","(22, 6)",5,71,116,192,9,79,509,597
673,0.18,"(8, 12)","(17, 28)",5,71,196,272,4,28,180,212
674,0.2,"(11, 8)","(23, 2)",13,78,130,221,20,43,394,457
675,0.08,"(23, 29)","(22, 27)",6,57,70,133,5,25,47,77
676,0.2,"(17, 28)","(7, 3)",39,50,131,220,6,28,95,129
677,0.2,"(6, 28)","(22, 28)",4,50,65,119,4,31,112,147
678,0.2,"(12, 3)","(21, 9)",9,57,82,148,4,43,263,310
679,0.1,"(11, 27)","(3, 13)",8,71,178,257,5,76,396,477
680,0.18,"(3, 6)","(10, 29)",7,50,144,201,9,31,182,222
681,0.08,"(10, 15)","(0, 25)",10,57,44,111,12,13,52,77
682,0.12,"(18, 17)","(1, 27)",5,85,192,282,11,16,215,242
683,0.04,"(1, 7)","(28, 28)",3,15,58,76,5,64,225,294
684,0.06,"(22, 15)","(27, 26)",22,64,124,210,21,52,184,257
685,0.06,"(15, 28)","(21, 11)",4,141,191,336,7,52,183,242
686,0.18,"(13, 1)","(2, 22)",4,106,345,455,7,22,104,133
687,0.08,"(18, 12)","(23, 18)",9,99,114,222,11,70,356,437
688,0.06,"(19, 12)","(13, 3)",11,85,202,298,3,25,60,88
689,0.12,"(8, 13)","(29, 28)",6,22,47,75,4,10,42,56
690,0.16,"(11, 6)","(19, 2)",7,106,259,372,7,31,88,126
691,0.08,"(7, 9)","(7, 8)",5,43,37,85,4,1,4,9
692,0.16,"(9, 8)","(9, 17)",9,29,45,83,7,37,125,169
693,0.16,"(18, 25)","(10, 28)",4,92,190,286,8,28,194,230
694,0.04,"(20, 22)","(7, 10)",6,85,99,190,5,22,84,111
695,0.2,"(3, 26)","(23, 22)",9,148,260,417,8,43,232,283
696,0.06,"(24, 12)","(6, 2)",5,92,190,287,8,61,114,183
697,0.18,"(24, 6)","(2, 17)",8,64,256,328,8,34,96,138
698,0.08,"(22, 26)","(29, 12)",9,57,82,148,23,43,187,253
699,0.1,"(29, 14)","(5, 18)",2,64,94,160,3,40,130,173
700,0.02,"(19, 15)","(27, 24)",5,218,227,450,9,73,336,418
701,0.06,"(6, 28)","(13, 3)",7,64,152,223,5,43,152,200
702,0.14,"(12, 14)","(28, 9)",16,64,141,221,9,64,454,527
703,0.2,"(19, 11)","(3, 9)",3,64,75,142,9,55,189,253
704,0.16,"(22, 5)","(13, 9)",15,71,244,330,16,79,482,577
705,0.06,"(24, 9)","(19, 27)",17,71,175,263,5,46,250,301
706,0.2,"(6, 3)","(26, 7)",8,36,161,205,14,43,386,443
707,0.04,"(25, 26)","(8, 21)",12,85,105,202,10,88,292,390
708,0.12,"(4, 27)","(4, 3)",7,57,132,196,5,31,135,171
709,0.08,"(6, 7)","(17, 29)",7,43,79,129,7,31,100,138
710,0.04,"(28, 16)","(27, 5)",10,43,59,112,5,34,114,153
711,0.1,"(22, 13)","(26, 10)",6,64,167,237,7,70,388,465
712,0.18,"(1, 8)","(9, 13)",6,57,75,138,4,28,51,83
713,0.14,"(22, 28)","(0, 9)",4,50,74,128,6,22,74,102
714,0.06,"(29, 14)","(1, 29)",37,50,161,248,23,7,71,101
715,0.08,"(29, 7)","(5, 0)",4,36,90,130,8,7,93,108
716,0.06,"(26, 20)","(8, 26)",4,99,152,255,8,61,228,297
717,0.16,"(5, 5)","(27, 23)",13,71,169,253,7,61,380,448
718,0.12,"(25, 23)","(22, 21)",4,57,43,104,10,31,30,71
719,0.1,"(24, 24)","(6, 4)",4,22,67,93,7,85,263,355
720,0.2,"(13, 13)","(26, 4)",14,64,167,245,11,19,98,128
721,0.06,"(29, 1)","(8, 14)",9,78,111,198,4,58,136,198
722,0.14,"(13, 10)","(11, 23)",13,36,97,146,8,67,361,436
723,0.2,"(4, 18)","(18, 2)",7,71,211,289,4,37,121,162
724,0.02,"(5, 17)","(18, 2)",7,106,145,258,11,64,278,353
725,0.14,"(9, 12)","(18, 5)",3,106,174,283,4,58,333,395
726,0.14,"(9, 17)","(2, 16)",7,43,31,81,6,25,41,72
727,0.14,"(10, 22)","(25, 5)",6,99,277,382,10,16,119,145
728,0.18,"(23, 0)","(29, 10)",8,57,158,223,8,25,106,139
729,0.14,"(23, 4)","(12, 10)",5,43,80,128,5,61,291,357
730,0.06,"(22, 22)","(9, 22)",9,106,89,204,5,85,259,349
731,0.04,"(5, 28)","(20, 5)",6,92,117,215,5,85,156,246
732,0.1,"(28, 3)","(18, 19)",7,71,228,306,4,55,265,324
733,0.04,"(12, 1)","(12, 8)",5,43,30,78,5,40,43,88
734,0.04,"(16, 5)","(27, 21)",8,127,211,346,11,43,126,180
735,0.16,"(5, 23)","(21, 4)",5,64,120,189,14,40,158,212
736,0.06,"(23, 22)","(4, 23)",4,85,93,182,10,40,96,146
737,0.1,"(9, 10)","(10, 4)",4,57,90,151,13,67,176,256
738,0.18,"(26, 10)","(6, 21)",8,43,98,149,6,52,335,393
739,0.02,"(27, 19)","(12, 7)",8,57,177,242,6,64,194,264
740,0.08,"(10, 16)","(22, 27)",4,71,124,199,5,40,77,122
741,0.18,"(21, 12)","(16, 25)",10,78,115,203,7,46,374,427
742,0.2,"(24, 21)","(13, 23)",9,50,143,202,10,46,361,417
743,0.16,"(13, 3)","(20, 27)",11,43,104,158,11,28,224,263
744,0.04,"(29, 26)","(29, 2)",6,22,87,115,6,58,187,251
745,0.06,"(21, 26)","(7, 23)",8,85,51,144,7,55,201,263
746,0.08,"(1, 1)","(13, 29)",5,64,193,262,4,25,111,140
747,0.18,"(10, 18)","(1, 1)",4,50,157,211,6,19,145,170
748,0.04,"(12, 24)","(1, 5)",3,85,162,250,5,43,87,135
749,0.04,"(16, 9)","(12, 24)",5,99,185,289,6,22,61,89
750,0.04,"(15, 18)","(20, 27)",8,50,74,132,11,49,151,211
751,0.02,"(23, 6)","(1, 28)",7,22,55,84,5,25,195,225
752,0.14,"(25, 3)","(27, 20)",3,50,63,116,5,61,155,221
753,0.14,"(25, 11)","(12, 20)",11,36,193,240,5,13,182,200
754,0.14,"(22, 3)","(0, 6)",17,85,277,379,12,19,168,199
755,0.12,"(2, 23)","(13, 22)",11,71,103,185,11,37,107,155
756,0.1,"(2, 20)","(22, 7)",7,85,166,258,4,49,185,238
757,0.18,"(20, 28)","(0, 17)",18,57,324,399,11,19,167,197
758,0.2,"(17, 8)","(17, 2)",10,36,62,108,4,7,45,56
759,0.12,"(10, 17)","(27, 14)",7,50,138,195,22,28,119,169
760,0.14,"(12, 14)","(5, 2)",16,64,149,229,7,34,98,139
761,0.16,"(25, 21)","(3, 20)",2,64,124,190,4,64,358,426
762,0.08,"(10, 22)","(29, 11)",8,78,205,291,8,28,91,127
763,0.02,"(27, 27)","(26, 15)",6,71,81,158,13,115,335,463
764,0.02,"(20, 5)","(20, 28)",11,134,198,343,11,151,637,799
765,0.14,"(19, 23)","(13, 20)",11,43,79,133,21,55,460,536
766,0.18,"(13, 4)","(19, 29)",9,36,65,110,8,22,72,102
767,0.12,"(27, 2)","(22, 4)",5,43,35,83,7,16,28,51
768,0.12,"(12, 24)","(12, 26)",5,57,38,100,6,10,20,36
769,0.16,"(9, 16)","(25, 2)",7,22,55,84,6,22,55,83
770,0.08,"(15, 27)","(3, 6)",5,50,70,125,11,52,165,228
771,0.18,"(13, 11)","(4, 13)",4,71,75,150,7,34,273,314
772,0.06,"(2, 26)","(1, 1)",5,85,157,247,6,52,302,360
773,0.12,"(29, 23)","(18, 17)",1,50,58,109,1,70,270,341
774,0.02,"(7, 2)","(9, 15)",10,162,135,307,11,241,623,875
775,0.2,"(13, 6)","(21, 12)",5,78,239,322,6,49,176,231
776,0.1,"(1, 1)","(19, 29)",84,36,176,296,28,34,121,183
777,0.04,"(23, 3)","(13, 25)",5,29,73,107,3,127,456,586
778,0.02,"(29, 5)","(29, 0)",3,57,195,255,2,13,82,97
779,0.14,"(13, 15)","(4, 8)",5,106,163,274,13,28,231,272
780,0.06,"(21, 13)","(13, 5)",6,85,176,267,11,91,418,520
781,0.18,"(2, 28)","(0, 3)",17,29,172,218,5,10,115,130
782,0.12,"(20, 7)","(16, 28)",3,57,140,200,5,31,301,337
783,0.06,"(5, 0)","(16, 15)",8,71,189,268,14,76,293,383
784,0.04,"(10, 4)","(13, 2)",4,134,136,274,8,25,30,63
785,0.08,"(8, 9)","(11, 5)",4,50,43,97,7,91,292,390
786,0.18,"(11, 21)","(10, 4)",4,92,160,256,17,25,295,337
787,0.06,"(29, 25)","(28, 8)",3,106,145,254,8,46,203,257
788,0.02,"(13, 2)","(3, 24)",8,162,124,294,4,70,155,229
789,0.04,"(5, 22)","(16, 27)",4,50,66,120,8,79,282,369
790,0.2,"(15, 17)","(13, 11)",4,36,27,67,2,64,303,369
791,0.14,"(17, 15)","(25, 20)",16,71,167,254,5,37,295,337
792,0.2,"(12, 5)","(9, 13)",4,71,291,366,4,46,296,346
793,0.04,"(26, 16)","(3, 5)",5,134,190,329,5,49,131,185
794,0.06,"(19, 2)","(27, 3)",10,64,79,153,19,43,80,142
795,0.04,"(10, 7)","(0, 28)",24,22,126,172,11,4,41,56
796,0.08,"(25, 6)","(25, 3)",7,57,24,88,13,34,86,133
797,0.04,"(4, 29)","(20, 26)",10,127,238,375,11,58,190,259
798,0.14,"(25, 27)","(24, 25)",10,43,51,104,10,10,16,36
799,0.04,"(9, 16)","(16, 28)",11,64,173,248,11,91,282,384
800,0.02,"(1, 5)","(9, 16)",8,148,275,431,4,115,215,334
801,0.1,"(22, 0)","(6, 1)",5,71,174,250,2,25,41,68
802,0.16,"(19, 7)","(17, 26)",8,43,117,168,11,43,207,261
803,0.1,"(8, 3)","(21, 21)",25,85,181,291,8,31,268,307
804,0.02,"(3, 13)","(7, 13)",5,134,84,223,5,70,101,176
805,0.08,"(18, 23)","(26, 26)",8,50,123,181,5,46,183,234
806,0.02,"(18, 1)","(0, 22)",15,50,138,203,7,25,120,152
807,0.04,"(15, 14)","(6, 3)",26,57,107,190,8,19,141,168
808,0.04,"(21, 14)","(12, 14)",99,57,140,296,8,121,367,496
809,0.2,"(26, 19)","(4, 6)",37,64,134,235,8,43,246,297
810,0.12,"(13, 20)","(5, 29)",25,29,73,127,15,25,217,257
811,0.12,"(20, 13)","(7, 17)",10,22,49,81,8,52,133,193
812,0.06,"(10, 14)","(14, 29)",5,64,118,187,4,25,223,252
813,0.06,"(19, 19)","(10, 9)",11,85,169,265,7,52,83,142
814,0.12,"(12, 23)","(28, 9)",6,50,162,218,4,61,284,349
815,0.08,"(25, 4)","(22, 2)",4,57,53,114,4,7,16,27
816,0.18,"(20, 25)","(21, 5)",6,64,161,231,13,61,414,488
817,0.16,"(26, 11)","(22, 21)",12,57,88,157,9,46,347,402
818,0.06,"(5, 29)","(22, 5)",13,113,123,249,6,55,205,266
819,0.14,"(29, 14)","(11, 15)",7,36,55,98,7,55,354,416
820,0.1,"(0, 9)","(17, 6)",9,113,162,284,5,40,180,225
821,0.16,"(1, 10)","(14, 6)",2,71,139,212,21,76,411,508
822,0.08,"(22, 18)","(17, 21)",5,57,39,101,8,58,148,214
823,0.14,"(8, 5)","(5, 12)",7,141,466,614,11,10,35,56
824,0.18,"(10, 16)","(2, 10)",5,64,195,264,9,55,172,236
825,0.06,"(7, 15)","(20, 24)",13,50,122,185,12,46,241,299
826,0.08,"(5, 12)","(8, 28)",15,29,69,113,4,25,114,143
827,0.1,"(12, 17)","(7, 3)",8,57,208,273,6,52,238,296
828,0.18,"(8, 16)","(0, 16)",4,50,40,94,4,28,58,90
829,0.06,"(3, 5)","(28, 23)",12,43,157,212,17,61,215,293
830,0.02,"(15, 18)","(8, 21)",11,176,151,338,12,76,255,343
831,0.06,"(23, 7)","(9, 13)",8,85,107,200,5,73,212,290
832,0.04,"(29, 3)","(1, 26)",6,29,61,96,3,55,147,205
833,0.06,"(28, 1)","(21, 17)",8,127,129,264,6,40,257,303
834,0.12,"(23, 3)","(3, 20)",10,43,112,165,8,55,306,369
835,0.1,"(23, 14)","(0, 28)",6,50,189,245,20,7,62,89
836,0.12,"(11, 25)","(27, 20)",9,78,133,220,4,43,189,236
837,0.12,"(21, 15)","(28, 12)",8,85,91,184,5,40,90,135
838,0.1,"(24, 16)","(16, 2)",13,29,141,183,8,28,112,148
839,0.14,"(24, 23)","(24, 25)",9,50,27,86,6,22,32,60
840,0.08,"(0, 23)","(3, 13)",5,92,52,149,12,34,213,259
841,0.16,"(12, 27)","(5, 27)",5,15,12,32,11,43,250,304
842,0.08,"(6, 5)","(7, 3)",5,22,21,48,7,22,21,50
843,0.12,"(23, 28)","(23, 23)",11,71,82,164,3,31,79,113
844,0.14,"(12, 21)","(28, 0)",14,15,51,80,5,7,44,56
845,0.12,"(0, 11)","(1, 16)",14,29,37,80,9,58,427,494
846,0.06,"(17, 15)","(1, 20)",12,120,149,281,8,46,104,158
847,0.2,"(9, 1)","(20, 0)",7,36,60,103,7,43,442,492
848,0.14,"(18, 5)","(17, 24)",5,92,161,258,5,43,161,209
849,0.02,"(15, 8)","(11, 24)",14,92,90,196,11,163,325,499
850,0.14,"(4, 12)","(9, 16)",4,71,55,130,10,19,40,69
851,0.2,"(8, 10)","(21, 2)",4,50,98,152,5,40,315,360
852,0.18,"(15, 27)","(18, 14)",9,99,276,384,4,85,383,472
853,0.12,"(4, 15)","(9, 18)",14,43,54,111,11,34,57,102
854,0.16,"(14, 19)","(19, 23)",3,78,93,174,7,58,123,188
855,0.12,"(2, 17)","(29, 14)",8,50,203,261,5,25,271,301
856,0.02,"(15, 15)","(27, 7)",7,57,56,120,8,94,452,554
857,0.14,"(9, 3)","(3, 1)",4,36,33,73,4,46,95,145
858,0.14,"(4, 21)","(5, 6)",5,36,78,119,6,76,300,382
859,0.08,"(8, 19)","(12, 5)",4,64,83,151,3,73,195,271
860,0.1,"(19, 4)","(10, 20)",6,78,155,239,4,43,194,241
861,0.2,"(12, 2)","(19, 17)",6,50,167,223,4,28,234,266
862,0.18,"(29, 26)","(29, 6)",6,78,281,365,7,28,206,241
863,0.06,"(19, 2)","(25, 0)",7,22,46,75,8,40,208,256
864,0.04,"(11, 9)","(7, 5)",9,71,39,119,7,55,94,156
865,0.2,"(20, 13)","(4, 4)",4,78,115,197,9,34,159,202
866,0.04,"(25, 17)","(2, 7)",6,36,44,86,5,22,66,93
867,0.02,"(2, 27)","(19, 16)",21,204,228,453,6,211,568,785
868,0.12,"(18, 5)","(14, 25)",5,71,134,210,3,43,189,235
869,0.18,"(22, 13)","(28, 15)",4,57,114,175,6,16,62,84
870,0.04,"(22, 20)","(19, 14)",8,113,226,347,7,73,429,509
871,0.1,"(2, 29)","(12, 18)",10,50,78,138,16,22,244,282
872,0.16,"(20, 12)","(11, 3)",6,57,106,169,5,25,124,154
873,0.02,"(10, 2)","(15, 11)",7,106,188,301,6,94,143,243
874,0.04,"(22, 19)","(21, 12)",10,85,234,329,8,73,110,191
875,0.08,"(7, 11)","(21, 8)",7,99,119,225,11,79,250,340
876,0.16,"(24, 19)","(9, 7)",9,85,154,248,9,40,288,337
877,0.06,"(3, 27)","(6, 26)",12,29,22,63,6,25,27,58
878,0.18,"(25, 13)","(4, 10)",6,57,140,203,9,46,260,315
879,0.08,"(5, 6)","(1, 7)",16,64,88,168,9,7,13,29
880,0.04,"(25, 8)","(17, 23)",16,64,113,193,11,22,155,188
881,0.06,"(29, 26)","(4, 1)",6,71,172,249,3,22,102,127
882,0.08,"(9, 17)","(17, 25)",4,64,154,222,9,25,81,115
883,0.06,"(13, 9)","(7, 14)",13,71,109,193,6,100,177,283
884,0.02,"(15, 10)","(3, 9)",26,43,48,117,12,70,119,201
885,0.06,"(21, 12)","(0, 17)",9,71,128,208,7,34,176,217
886,0.08,"(1, 24)","(23, 20)",13,50,105,168,5,46,137,188
887,0.1,"(8, 10)","(29, 21)",6,50,89,145,7,25,106,138
888,0.16,"(7, 10)","(17, 23)",24,64,144,232,6,43,346,395
889,0.02,"(1, 17)","(22, 10)",8,197,159,364,5,25,106,136
890,0.02,"(7, 3)","(29, 24)",6,43,74,123,10,43,87,140
891,0.1,"(14, 6)","(18, 18)",3,64,278,345,4,52,285,341
892,0.08,"(6, 17)","(4, 18)",5,22,11,38,10,37,58,105
893,0.12,"(28, 28)","(8, 28)",3,57,67,127,2,22,77,101
894,0.06,"(12, 10)","(0, 22)",6,36,58,100,9,43,210,262
895,0.2,"(1, 8)","(9, 12)",7,43,99,149,7,25,87,119
896,0.08,"(0, 0)","(3, 6)",1,22,16,39,1,13,20,34
897,0.1,"(5, 8)","(4, 6)",6,36,32,74,14,28,64,106
898,0.2,"(9, 25)","(6, 17)",10,36,63,109,9,46,284,339
899,0.2,"(21, 26)","(29, 0)",11,36,105,152,5,19,140,164
900,0.1,"(21, 7)","(15, 17)",10,85,98,193,6,58,166,230
901,0.04,"(24, 29)","(4, 26)",15,92,165,272,19,40,114,173
902,0.16,"(27, 21)","(9, 24)",8,50,116,174,28,52,184,264
903,0.04,"(10, 8)","(12, 15)",10,120,152,282,8,133,380,521
904,0.02,"(7, 12)","(0, 19)",5,113,172,290,9,91,128,228
905,0.1,"(25, 25)","(5, 22)",5,78,72,155,7,16,116,139
906,0.2,"(11, 4)","(29, 22)",8,29,77,114,10,55,430,495
907,0.08,"(1, 9)","(11, 5)",4,50,54,108,4,40,104,148
908,0.04,"(17, 12)","(29, 24)",7,57,91,155,5,16,100,121
909,0.08,"(3, 18)","(19, 2)",4,57,76,137,8,61,203,272
910,0.16,"(6, 2)","(20, 8)",16,141,336,493,10,31,287,328
911,0.02,"(25, 25)","(20, 28)",12,162,157,331,4,103,140,247
912,0.16,"(8, 18)","(27, 29)",4,15,87,106,4,7,86,97
913,0.06,"(1, 28)","(19, 25)",6,36,115,157,5,49,148,202
914,0.16,"(7, 20)","(26, 9)",8,36,122,166,11,61,372,444
915,0.14,"(28, 3)","(15, 23)",6,78,155,239,5,58,234,297
916,0.2,"(29, 16)","(11, 14)",5,92,281,378,5,25,182,212
917,0.16,"(28, 24)","(28, 14)",4,85,318,407,3,85,668,756
918,0.04,"(7, 15)","(17, 7)",8,85,197,290,20,46,166,232
919,0.14,"(24, 6)","(26, 29)",17,50,152,219,6,37,131,174
920,0.06,"(26, 12)","(18, 17)",7,127,295,429,8,31,60,99
921,0.2,"(10, 23)","(8, 10)",5,64,263,332,7,34,96,137
922,0.2,"(25, 9)","(25, 19)",6,50,65,121,5,52,354,411
923,0.04,"(5, 25)","(24, 7)",4,64,109,177,7,37,134,178
924,0.1,"(23, 4)","(20, 9)",3,57,113,173,9,55,183,247
925,0.14,"(5, 23)","(2, 25)",5,15,18,38,5,85,324,414
926,0.02,"(10, 11)","(10, 19)",38,260,279,577,37,115,380,532
927,0.18,"(23, 22)","(18, 19)",5,71,97,173,11,13,18,42
928,0.18,"(18, 11)","(18, 21)",7,85,248,340,7,25,75,107
929,0.18,"(19, 12)","(21, 13)",6,64,89,159,7,13,18,38
930,0.12,"(18, 26)","(19, 23)",5,113,156,274,15,82,494,591
931,0.06,"(13, 25)","(5, 13)",9,57,87,153,6,106,260,372
932,0.18,"(20, 23)","(14, 5)",6,64,115,185,7,37,180,224
933,0.02,"(19, 27)","(22, 0)",5,85,187,277,6,88,196,290
934,0.08,"(15, 14)","(9, 28)",6,71,150,227,7,25,110,142
935,0.06,"(11, 1)","(27, 28)",7,85,150,242,7,52,253,312
936,0.12,"(16, 2)","(14, 5)",6,43,19,68,4,22,27,53
937,0.06,"(24, 23)","(17, 23)",6,8,12,26,6,55,182,243
938,0.14,"(6, 19)","(0, 12)",6,71,112,189,8,31,42,81
939,0.08,"(24, 23)","(26, 3)",5,106,201,312,5,31,177,213
940,0.16,"(0, 7)","(2, 29)",9,36,115,160,4,31,204,239
941,0.14,"(11, 23)","(7, 20)",22,43,63,128,7,28,96,131
942,0.2,"(8, 12)","(2, 14)",14,64,73,151,5,25,47,77
943,0.16,"(7, 9)","(6, 1)",14,78,277,369,5,37,227,269
944,0.16,"(0, 9)","(26, 0)",4,22,91,117,3,19,97,119
945,0.04,"(14, 2)","(3, 17)",11,36,82,129,5,46,156,207
946,0.08,"(15, 16)","(1, 12)",8,71,64,143,5,55,87,147
947,0.02,"(14, 15)","(28, 25)",10,36,135,181,8,79,233,320
948,0.08,"(2, 11)","(29, 18)",13,22,79,114,7,13,83,103
949,0.04,"(15, 19)","(21, 18)",6,162,138,306,10,52,225,287
950,0.08,"(17, 10)","(0, 29)",7,29,133,169,4,46,182,232
951,0.12,"(5, 14)","(29, 28)",6,113,215,334,5,40,225,270
952,0.2,"(29, 18)","(15, 1)",3,43,189,235,6,40,329,375
953,0.08,"(21, 3)","(19, 29)",7,57,119,183,9,43,305,357
954,0.1,"(14, 8)","(28, 20)",5,85,137,227,11,46,125,182
955,0.18,"(21, 20)","(16, 1)",4,64,195,263,6,40,284,330
956,0.2,"(7, 3)","(1, 0)",5,15,17,37,8,34,373,415
957,0.1,"(29, 11)","(14, 28)",3,57,96,156,7,28,104,139
958,0.02,"(24, 28)","(12, 12)",3,183,278,464,11,118,276,405
959,0.16,"(9, 6)","(8, 16)",12,57,78,147,9,28,74,111
960,0.1,"(29, 8)","(11, 28)",16,29,102,147,8,25,136,169
961,0.06,"(25, 11)","(7, 14)",7,36,64,107,5,34,198,237
962,0.06,"(24, 29)","(9, 26)",13,50,99,162,6,43,135,184
963,0.04,"(1, 11)","(11, 19)",5,99,101,205,6,25,117,148
964,0.14,"(21, 7)","(18, 24)",6,43,125,174,3,19,254,276
965,0.14,"(2, 0)","(1, 2)",8,29,41,78,11,22,35,68
966,0.14,"(22, 4)","(0, 1)",8,57,108,173,5,19,147,171
967,0.12,"(20, 21)","(10, 7)",7,92,106,205,4,61,181,246
968,0.08,"(22, 21)","(27, 13)",5,92,122,219,10,43,150,203
969,0.2,"(23, 11)","(8, 12)",12,50,114,176,9,76,503,588
970,0.08,"(25, 7)","(21, 24)",11,78,162,251,7,43,239,289
971,0.14,"(2, 4)","(5, 15)",8,50,120,178,3,43,323,369
972,0.14,"(15, 3)","(25, 10)",5,78,267,350,11,46,265,322
973,0.2,"(5, 25)","(8, 14)",13,78,248,339,4,58,383,445
974,0.02,"(21, 16)","(19, 20)",13,78,120,211,7,58,44,109
975,0.06,"(12, 2)","(21, 23)",6,92,160,258,12,76,197,285
976,0.1,"(2, 21)","(10, 9)",11,50,64,125,5,28,81,114
977,0.06,"(26, 12)","(28, 21)",8,22,55,85,12,79,365,456
978,0.2,"(20, 14)","(28, 28)",10,36,180,226,4,16,175,195
979,0.08,"(9, 12)","(26, 1)",25,85,197,307,7,31,159,197
980,0.02,"(25, 22)","(12, 24)",11,218,410,639,4,79,442,525
981,0.14,"(28, 12)","(22, 20)",6,106,295,407,11,43,217,271
982,0.08,"(1, 6)","(19, 7)",40,64,142,246,25,58,212,295
983,0.08,"(16, 14)","(29, 6)",8,50,195,253,10,19,174,203
984,0.12,"(7, 10)","(2, 25)",4,57,173,234,14,37,195,246
985,0.04,"(18, 1)","(4, 9)",5,141,90,236,5,55,128,188
986,0.1,"(10, 28)","(3, 16)",5,71,128,204,10,34,72,116
987,0.16,"(24, 24)","(2, 0)",15,22,66,103,4,25,79,108
988,0.02,"(0, 14)","(12, 9)",2,127,206,335,2,142,307,451
989,0.12,"(21, 18)","(13, 11)",58,71,222,351,26,28,253,307
990,0.06,"(2, 1)","(14, 20)",4,50,72,126,4,46,127,177
991,0.04,"(16, 1)","(11, 15)",4,99,134,237,7,85,206,298
992,0.1,"(19, 24)","(7, 10)",8,43,68,119,4,79,271,354
993,0.02,"(27, 6)","(0, 21)",12,29,64,105,8,70,224,302
994,0.02,"(15, 7)","(2, 29)",7,127,114,248,11,25,70,106
995,0.14,"(5, 16)","(9, 8)",6,43,88,137,4,79,324,407
996,0.1,"(28, 6)","(16, 4)",5,36,50,91,4,40,112,156
997,0.12,"(2, 14)","(10, 7)",5,92,273,370,5,37,208,250
998,0.14,"(27, 23)","(20, 26)",11,78,88,177,6,16,26,48
999,0.18,"(13, 26)","(25, 21)",7,64,108,179,3,37,171,211
,,,,8.633,70.062,132.479,211.174,8.107,46.129,196.312,250.548
