0,0.06,"(12, 24)","(22, 11)",4,111,90,205,13,113,106,232
1,0.16,"(7, 29)","(2, 10)",25,136,135,296,5,92,77,174
2,0.04,"(12, 4)","(6, 13)",6,161,120,287,9,119,108,236
3,0.18,"(25, 15)","(17, 29)",5,111,90,206,4,189,173,366
4,0.06,"(21, 14)","(23, 22)",9,116,100,225,6,87,73,166
5,0.06,"(21, 8)","(19, 17)",9,101,85,195,4,150,134,288
6,0.14,"(6, 23)","(28, 9)",9,76,63,148,7,102,89,198
7,0.06,"(27, 27)","(25, 3)",4,151,123,278,4,194,178,376
8,0.08,"(1, 19)","(16, 10)",3,86,67,156,7,105,92,204
9,0.06,"(14, 25)","(8, 23)",12,36,26,74,3,16,13,32
10,0.16,"(3, 16)","(8, 28)",7,51,43,101,12,96,88,196
11,0.1,"(12, 16)","(26, 10)",16,51,56,123,7,89,76,172
12,0.02,"(25, 11)","(3, 29)",6,131,120,257,4,163,147,314
13,0.12,"(22, 18)","(11, 26)",13,156,149,318,10,102,92,204
14,0.04,"(15, 21)","(14, 13)",13,61,39,113,6,55,41,102
15,0.04,"(0, 26)","(20, 10)",6,116,100,222,23,122,125,270
16,0.12,"(7, 7)","(27, 9)",7,106,90,203,12,92,84,188
17,0.04,"(22, 6)","(18, 8)",5,111,81,197,5,56,41,102
18,0.14,"(6, 0)","(4, 4)",2,26,17,45,6,62,48,116
19,0.14,"(18, 16)","(4, 0)",10,81,64,155,11,86,77,174
20,0.02,"(23, 13)","(7, 23)",9,166,141,316,6,60,46,112
21,0.1,"(2, 22)","(2, 28)",7,26,20,53,11,68,55,134
22,0.2,"(14, 20)","(1, 27)",6,171,162,339,21,218,219,458
23,0.06,"(12, 10)","(11, 19)",5,121,102,228,4,91,75,170
24,0.1,"(17, 9)","(23, 11)",11,81,69,161,5,70,55,130
25,0.18,"(26, 12)","(8, 27)",4,96,84,184,8,81,69,158
26,0.04,"(27, 26)","(22, 27)",8,81,45,134,3,40,22,65
27,0.18,"(5, 15)","(20, 28)",13,141,133,287,15,116,111,242
28,0.06,"(2, 28)","(7, 10)",6,121,90,217,5,65,50,120
29,0.04,"(15, 20)","(11, 9)",6,131,111,248,14,71,65,150
30,0.02,"(8, 0)","(10, 22)",9,201,136,346,12,161,153,326
31,0.02,"(6, 7)","(18, 18)",3,161,133,297,6,235,221,462
32,0.06,"(3, 27)","(1, 7)",8,131,118,257,7,110,97,214
33,0.04,"(6, 17)","(20, 14)",10,56,42,108,5,268,253,526
34,0.12,"(10, 10)","(17, 0)",10,81,69,160,6,172,158,336
35,0.08,"(15, 22)","(15, 12)",20,81,80,181,6,91,77,174
36,0.02,"(26, 0)","(11, 1)",6,91,58,155,27,146,153,326
37,0.02,"(22, 8)","(6, 18)",4,211,177,392,4,152,136,292
38,0.2,"(14, 1)","(4, 18)",5,96,78,179,2,162,144,308
39,0.2,"(20, 23)","(21, 6)",4,171,160,335,13,196,189,398
40,0.04,"(3, 11)","(6, 11)",8,121,83,212,11,65,55,131
41,0.12,"(3, 18)","(5, 4)",12,71,63,146,7,112,99,218
42,0.04,"(25, 13)","(13, 21)",4,146,106,256,6,105,91,202
43,0.04,"(12, 11)","(8, 9)",6,16,11,33,14,54,43,111
44,0.08,"(8, 27)","(24, 28)",10,71,66,147,6,106,92,204
45,0.16,"(14, 12)","(29, 12)",17,96,102,215,29,107,116,252
46,0.2,"(15, 2)","(6, 28)",7,196,184,387,15,79,74,168
47,0.02,"(13, 27)","(25, 13)",9,116,87,212,7,81,68,156
48,0.18,"(23, 9)","(16, 2)",8,106,102,216,7,34,21,62
49,0.02,"(12, 10)","(28, 9)",4,161,132,297,4,151,135,290
50,0.12,"(2, 3)","(8, 17)",24,86,86,196,5,83,68,156
51,0.06,"(16, 24)","(14, 13)",12,121,106,239,10,104,94,208
52,0.06,"(1, 25)","(28, 6)",4,101,78,183,4,128,112,244
53,0.2,"(7, 26)","(6, 18)",7,56,38,101,5,32,17,54
54,0.08,"(17, 2)","(24, 3)",7,101,76,184,13,181,174,368
55,0.16,"(16, 27)","(1, 2)",9,81,73,163,17,98,95,210
56,0.02,"(21, 25)","(1, 27)",10,121,90,221,8,228,216,452
57,0.18,"(13, 27)","(29, 10)",5,101,92,198,4,224,208,436
58,0.04,"(6, 3)","(3, 26)",11,151,123,285,20,197,197,414
59,0.02,"(25, 14)","(22, 8)",8,186,143,337,16,80,76,172
60,0.08,"(12, 27)","(3, 10)",10,46,44,100,4,90,74,168
61,0.02,"(28, 23)","(0, 8)",6,101,77,184,10,64,54,128
62,0.06,"(4, 19)","(12, 13)",12,126,101,239,16,133,129,278
63,0.1,"(17, 22)","(25, 8)",7,106,80,193,9,131,120,260
64,0.16,"(18, 20)","(10, 6)",4,131,118,253,10,61,51,122
65,0.16,"(16, 21)","(4, 22)",4,76,59,139,5,51,36,92
66,0.14,"(20, 23)","(4, 14)",7,91,76,174,4,87,71,162
67,0.2,"(1, 8)","(10, 25)",5,86,62,153,6,220,206,432
68,0.1,"(22, 9)","(24, 11)",5,106,67,178,7,48,33,88
69,0.1,"(27, 23)","(10, 6)",6,161,142,309,11,94,85,190
70,0.1,"(17, 3)","(21, 23)",16,96,99,211,8,91,79,178
71,0.08,"(7, 10)","(16, 7)",8,111,97,216,9,105,94,208
72,0.2,"(29, 19)","(25, 0)",5,256,247,508,5,143,128,276
73,0.2,"(15, 28)","(11, 8)",17,61,56,134,6,109,95,210
74,0.1,"(6, 2)","(18, 10)",21,86,88,195,4,109,93,206
75,0.16,"(17, 12)","(1, 20)",11,76,71,158,5,80,65,150
76,0.16,"(4, 23)","(5, 13)",14,46,36,96,11,61,52,124
77,0.2,"(20, 0)","(17, 21)",6,111,94,211,6,120,106,232
78,0.08,"(2, 0)","(29, 9)",15,96,89,200,5,151,136,292
79,0.02,"(26, 14)","(26, 5)",9,51,41,101,7,96,83,186
80,0.1,"(12, 3)","(17, 13)",6,141,127,274,9,95,84,188
81,0.12,"(4, 16)","(25, 6)",9,91,78,178,10,81,71,162
82,0.12,"(14, 17)","(23, 29)",4,56,41,101,12,280,272,564
83,0.08,"(17, 3)","(26, 6)",8,91,72,171,10,59,49,118
84,0.1,"(21, 17)","(12, 17)",5,21,15,41,10,35,25,70
85,0.06,"(16, 3)","(1, 9)",6,66,59,131,10,193,183,386
86,0.1,"(0, 7)","(26, 29)",6,166,149,321,5,79,64,148
87,0.12,"(13, 7)","(9, 17)",9,81,74,164,6,42,28,76
88,0.18,"(29, 15)","(1, 7)",7,91,77,175,9,86,75,170
89,0.18,"(28, 29)","(14, 4)",3,111,89,203,5,109,94,208
90,0.08,"(2, 9)","(27, 21)",6,106,101,213,11,102,93,206
91,0.02,"(2, 28)","(21, 28)",5,86,54,145,3,137,120,260
92,0.08,"(6, 2)","(24, 3)",5,171,145,321,7,78,65,150
93,0.1,"(21, 2)","(25, 29)",9,86,76,171,18,92,90,200
94,0.2,"(2, 8)","(1, 15)",3,41,27,71,5,34,19,58
95,0.06,"(25, 7)","(12, 25)",8,176,143,327,6,108,94,208
96,0.06,"(13, 4)","(21, 22)",8,91,67,166,5,128,113,246
97,0.08,"(24, 11)","(27, 25)",8,46,35,89,4,77,61,142
98,0.02,"(2, 13)","(5, 28)",9,111,84,204,5,106,89,200
99,0.06,"(10, 20)","(1, 26)",6,146,121,273,4,51,35,90
100,0.08,"(11, 19)","(12, 4)",5,101,80,186,4,119,103,226
101,0.08,"(15, 5)","(6, 0)",5,51,37,93,8,62,50,120
102,0.14,"(20, 2)","(1, 25)",13,131,123,267,5,77,62,144
103,0.1,"(22, 25)","(17, 19)",21,41,43,105,7,65,50,122
104,0.1,"(19, 22)","(14, 29)",8,71,66,145,3,96,79,178
105,0.06,"(0, 9)","(27, 9)",5,91,76,172,5,104,89,198
106,0.18,"(19, 28)","(25, 0)",5,146,137,288,4,89,73,166
107,0.2,"(18, 21)","(12, 6)",5,66,53,124,6,108,94,208
108,0.06,"(13, 18)","(0, 8)",7,76,70,153,5,45,30,80
109,0.06,"(23, 1)","(8, 16)",5,101,74,180,9,59,48,116
110,0.08,"(0, 2)","(22, 7)",8,76,61,145,10,150,140,300
111,0.06,"(28, 25)","(25, 24)",5,86,54,145,9,42,28,79
112,0.08,"(9, 20)","(0, 15)",16,91,96,203,7,129,116,252
113,0.1,"(24, 28)","(17, 3)",7,86,78,171,4,135,119,258
114,0.08,"(11, 11)","(24, 6)",5,116,102,223,6,100,86,192
115,0.2,"(19, 24)","(4, 21)",14,116,103,233,3,347,330,680
116,0.18,"(24, 2)","(0, 25)",2,141,132,275,5,137,122,264
117,0.04,"(16, 18)","(19, 4)",5,91,81,177,6,116,102,224
118,0.1,"(29, 29)","(6, 4)",6,71,62,139,4,72,56,132
119,0.18,"(27, 29)","(18, 18)",8,106,94,208,12,86,78,176
120,0.1,"(0, 26)","(29, 28)",7,166,152,325,8,90,78,176
121,0.12,"(8, 5)","(13, 13)",4,91,74,169,12,62,54,128
122,0.04,"(9, 14)","(5, 3)",9,31,25,65,11,44,35,90
123,0.14,"(22, 1)","(29, 15)",7,106,84,197,8,91,79,178
124,0.1,"(22, 19)","(13, 2)",5,66,49,120,4,72,56,132
125,0.18,"(17, 7)","(1, 15)",12,141,127,280,5,87,72,164
126,0.18,"(24, 15)","(26, 15)",7,46,39,92,9,50,31,90
127,0.1,"(29, 28)","(10, 26)",6,86,60,152,3,51,34,88
128,0.06,"(1, 17)","(26, 20)",17,126,111,254,3,118,101,222
129,0.02,"(0, 15)","(10, 28)",6,106,89,201,3,124,107,234
130,0.02,"(10, 21)","(22, 2)",5,156,129,290,5,180,165,350
131,0.04,"(18, 19)","(19, 12)",6,61,38,105,18,49,47,114
132,0.04,"(1, 0)","(7, 20)",2,156,112,270,7,65,52,124
133,0.02,"(25, 16)","(8, 28)",5,146,97,248,5,118,103,226
134,0.2,"(15, 13)","(0, 9)",8,426,412,846,22,126,128,276
135,0.04,"(15, 2)","(7, 13)",4,76,59,139,3,38,21,62
136,0.1,"(9, 21)","(18, 22)",7,66,53,126,7,89,76,172
137,0.12,"(10, 17)","(13, 10)",7,31,23,61,4,51,34,89
138,0.18,"(18, 9)","(29, 19)",10,71,62,143,7,205,192,404
139,0.18,"(23, 23)","(10, 26)",9,51,45,105,7,94,81,182
140,0.14,"(5, 3)","(25, 29)",8,76,63,147,7,80,67,154
141,0.04,"(6, 28)","(1, 2)",7,106,89,202,7,248,235,490
142,0.08,"(10, 4)","(5, 18)",7,81,57,145,9,142,131,282
143,0.16,"(25, 22)","(23, 9)",4,91,75,170,9,118,107,234
144,0.02,"(24, 15)","(29, 8)",9,141,113,263,3,245,228,476
145,0.04,"(3, 0)","(4, 26)",13,191,183,387,15,81,76,172
146,0.14,"(22, 16)","(15, 13)",11,101,87,199,11,82,73,166
147,0.04,"(12, 2)","(27, 1)",7,111,97,215,11,207,198,416
148,0.12,"(0, 9)","(4, 27)",5,106,86,197,3,70,53,126
149,0.02,"(2, 16)","(16, 11)",7,171,110,288,7,114,99,220
150,0.08,"(23, 27)","(28, 25)",7,81,60,148,6,78,57,141
151,0.04,"(22, 27)","(21, 5)",12,241,212,465,13,103,96,212
152,0.1,"(19, 19)","(26, 27)",6,191,172,369,5,156,141,302
153,0.04,"(4, 20)","(2, 12)",7,91,76,174,6,45,31,82
154,0.2,"(15, 3)","(8, 27)",8,76,68,152,7,116,103,226
155,0.1,"(29, 26)","(23, 12)",11,61,53,125,6,86,72,164
156,0.14,"(18, 6)","(2, 8)",10,146,133,289,11,173,164,348
157,0.06,"(7, 2)","(13, 14)",27,211,202,440,41,62,83,186
158,0.2,"(4, 13)","(16, 12)",8,116,107,231,4,151,135,290
159,0.08,"(1, 28)","(21, 4)",10,86,68,164,13,90,83,186
160,0.12,"(15, 28)","(15, 6)",5,61,42,108,21,89,90,200
161,0.1,"(27, 8)","(10, 10)",12,51,50,113,5,99,84,188
162,0.04,"(12, 29)","(13, 1)",4,111,94,209,6,145,131,282
163,0.1,"(8, 19)","(18, 1)",5,116,99,220,5,121,106,232
164,0.18,"(14, 17)","(4, 28)",13,96,86,195,9,53,42,104
165,0.18,"(25, 22)","(26, 14)",4,61,46,111,9,51,40,100
166,0.16,"(17, 18)","(26, 24)",12,106,107,225,9,131,120,260
167,0.06,"(22, 17)","(11, 19)",3,121,99,223,10,39,29,78
168,0.1,"(16, 23)","(29, 12)",8,76,69,153,7,130,117,254
169,0.04,"(13, 9)","(21, 9)",4,96,61,161,3,111,94,208
170,0.06,"(5, 7)","(23, 9)",6,146,137,289,11,61,52,124
171,0.1,"(15, 21)","(12, 26)",10,36,27,73,8,85,72,165
172,0.12,"(26, 2)","(6, 21)",7,116,99,222,6,100,86,192
173,0.12,"(5, 5)","(5, 13)",9,61,46,116,4,58,39,101
174,0.2,"(29, 6)","(26, 9)",4,31,19,54,8,34,18,60
175,0.12,"(9, 3)","(0, 3)",9,71,57,137,5,33,17,55
176,0.1,"(27, 20)","(6, 9)",5,86,59,150,6,85,71,162
177,0.16,"(8, 19)","(3, 26)",6,41,24,71,4,91,75,170
178,0.18,"(25, 25)","(2, 2)",3,101,82,186,3,76,59,138
179,0.04,"(28, 20)","(0, 14)",15,71,75,161,8,103,91,202
180,0.06,"(21, 19)","(28, 13)",10,76,58,144,17,126,123,266
181,0.12,"(18, 12)","(18, 1)",5,106,93,204,5,110,95,210
182,0.12,"(6, 11)","(17, 10)",7,66,54,127,6,79,65,150
183,0.06,"(18, 26)","(8, 26)",4,106,76,186,12,60,52,124
184,0.02,"(26, 5)","(9, 3)",7,46,34,87,5,66,51,122
185,0.04,"(14, 2)","(26, 10)",8,236,207,451,7,135,122,264
186,0.2,"(5, 0)","(1, 13)",4,41,23,68,5,166,151,322
187,0.18,"(11, 10)","(6, 10)",6,41,28,75,9,57,45,111
188,0.12,"(10, 11)","(1, 28)",9,111,101,221,6,126,112,244
189,0.2,"(14, 8)","(11, 3)",8,61,49,118,7,96,83,186
190,0.12,"(18, 15)","(25, 6)",8,116,94,218,7,92,79,178
191,0.08,"(8, 28)","(10, 21)",4,51,41,96,5,42,27,74
192,0.04,"(4, 24)","(7, 20)",11,91,60,162,5,100,80,185
193,0.08,"(12, 3)","(3, 18)",4,116,86,206,6,51,37,94
194,0.1,"(16, 5)","(22, 28)",4,56,48,108,7,105,92,204
195,0.2,"(12, 20)","(4, 6)",4,76,66,146,7,139,126,272
196,0.08,"(8, 0)","(16, 20)",6,196,168,370,4,136,120,260
197,0.2,"(7, 22)","(13, 25)",7,76,59,142,3,87,70,160
198,0.16,"(26, 24)","(15, 10)",10,66,57,133,8,105,93,206
199,0.04,"(19, 26)","(25, 21)",10,81,77,168,11,89,80,180
200,0.14,"(19, 0)","(9, 2)",3,46,25,74,14,53,45,112
201,0.1,"(13, 11)","(2, 18)",5,56,35,96,7,118,105,230
202,0.1,"(6, 4)","(26, 27)",3,191,171,365,7,131,118,256
203,0.06,"(22, 10)","(25, 12)",9,96,76,181,9,99,88,196
204,0.18,"(7, 7)","(24, 9)",5,81,75,161,7,69,56,132
205,0.2,"(24, 24)","(3, 7)",11,66,57,134,21,77,78,176
206,0.12,"(24, 20)","(29, 8)",6,131,116,253,8,105,93,206
207,0.18,"(3, 16)","(22, 25)",4,81,72,157,11,151,142,304
208,0.1,"(27, 15)","(22, 4)",7,81,68,156,8,90,78,176
209,0.1,"(19, 14)","(27, 27)",7,91,70,168,8,207,195,410
210,0.06,"(16, 9)","(26, 14)",4,196,173,373,14,59,53,126
211,0.14,"(12, 8)","(25, 9)",5,56,47,108,7,93,80,180
212,0.18,"(14, 9)","(17, 10)",7,41,29,77,7,69,56,132
213,0.06,"(25, 10)","(4, 25)",3,181,136,320,8,75,63,146
214,0.14,"(15, 6)","(14, 9)",26,41,43,110,6,41,24,71
215,0.14,"(1, 7)","(6, 14)",8,86,69,163,8,66,54,128
216,0.2,"(7, 5)","(24, 11)",7,246,237,490,3,103,86,192
217,0.06,"(28, 0)","(5, 1)",5,156,133,294,6,120,106,232
218,0.12,"(4, 20)","(0, 27)",5,116,101,222,10,53,43,106
219,0.1,"(25, 15)","(4, 23)",13,96,94,203,4,65,49,118
220,0.08,"(2, 13)","(14, 12)",4,41,33,78,5,126,111,242
221,0.1,"(13, 9)","(9, 25)",11,71,70,152,5,167,152,324
222,0.16,"(16, 28)","(3, 4)",5,76,66,147,5,77,62,144
223,0.2,"(11, 13)","(13, 8)",12,36,35,83,6,108,94,208
224,0.02,"(19, 14)","(4, 3)",11,106,71,188,16,117,113,246
225,0.1,"(16, 9)","(17, 25)",18,41,46,105,2,63,45,110
226,0.06,"(22, 21)","(1, 20)",5,161,147,313,5,148,133,286
227,0.08,"(21, 15)","(10, 19)",8,166,153,327,6,52,38,96
228,0.16,"(29, 16)","(1, 16)",6,111,100,217,6,141,127,274
229,0.02,"(25, 16)","(10, 27)",4,246,162,412,6,126,112,244
230,0.1,"(15, 23)","(6, 22)",7,86,62,155,8,52,40,100
231,0.04,"(20, 22)","(21, 13)",5,106,80,191,8,139,127,274
232,0.04,"(14, 11)","(2, 0)",17,101,91,209,21,168,169,358
233,0.04,"(0, 4)","(21, 28)",3,136,118,257,3,100,83,186
234,0.18,"(2, 19)","(8, 5)",6,126,110,242,8,76,64,148
235,0.2,"(11, 23)","(29, 12)",5,86,76,167,12,138,130,280
236,0.02,"(26, 5)","(9, 13)",5,86,59,150,8,52,40,100
237,0.02,"(18, 21)","(14, 28)",3,61,49,113,7,68,53,128
238,0.12,"(20, 1)","(16, 29)",4,136,123,263,10,145,135,290
239,0.14,"(10, 2)","(12, 25)",6,111,106,223,5,86,71,162
240,0.02,"(10, 13)","(29, 25)",3,91,68,162,6,281,267,554
241,0.04,"(10, 24)","(20, 27)",5,76,57,138,4,72,56,132
242,0.04,"(25, 27)","(0, 10)",2,76,63,141,2,109,91,202
243,0.18,"(22, 25)","(18, 17)",4,86,73,163,6,78,64,148
244,0.18,"(26, 9)","(27, 9)",8,16,10,34,4,52,31,87
245,0.06,"(0, 13)","(2, 4)",4,81,43,128,8,100,88,196
246,0.04,"(1, 12)","(17, 14)",4,101,81,186,4,118,102,224
247,0.06,"(23, 22)","(24, 19)",4,56,35,95,7,95,82,184
248,0.08,"(10, 0)","(26, 0)",4,61,52,117,5,161,146,312
249,0.12,"(20, 4)","(11, 15)",8,96,91,195,14,67,61,142
250,0.14,"(9, 7)","(11, 0)",4,26,15,45,4,71,55,130
251,0.18,"(19, 9)","(18, 2)",12,66,59,137,7,65,52,124
252,0.14,"(24, 22)","(18, 3)",5,96,86,187,4,155,139,298
253,0.16,"(5, 26)","(20, 11)",11,86,78,175,4,114,98,216
254,0.04,"(27, 17)","(10, 0)",6,101,88,195,7,123,110,240
255,0.12,"(19, 4)","(18, 7)",11,36,23,70,6,42,23,71
256,0.04,"(3, 4)","(5, 16)",8,76,48,132,11,175,166,352
257,0.2,"(12, 6)","(12, 25)",6,96,91,193,7,88,75,170
258,0.16,"(4, 22)","(1, 2)",9,141,123,273,4,54,38,96
259,0.16,"(14, 14)","(20, 25)",5,131,113,249,16,157,153,326
260,0.14,"(16, 19)","(12, 17)",5,76,60,141,4,41,22,67
261,0.08,"(17, 11)","(12, 2)",8,56,53,117,16,119,115,250
262,0.08,"(28, 19)","(14, 4)",12,111,85,208,8,114,102,224
263,0.14,"(24, 12)","(9, 26)",5,76,62,143,11,102,93,206
264,0.14,"(2, 13)","(25, 22)",8,111,108,227,8,102,90,200
265,0.08,"(24, 7)","(22, 22)",4,71,49,124,3,121,104,228
266,0.1,"(7, 7)","(29, 8)",15,91,87,193,3,94,77,174
267,0.16,"(21, 21)","(22, 9)",8,91,74,173,8,157,145,310
268,0.08,"(18, 20)","(22, 10)",7,96,74,177,13,127,120,260
269,0.1,"(2, 2)","(2, 19)",9,86,77,172,3,72,55,130
270,0.18,"(7, 26)","(14, 11)",4,51,37,92,11,66,57,134
271,0.14,"(27, 12)","(25, 28)",7,161,143,311,7,149,136,292
272,0.1,"(6, 29)","(7, 11)",8,121,100,229,5,79,64,148
273,0.02,"(24, 29)","(26, 28)",3,116,65,184,7,37,15,59
274,0.1,"(15, 12)","(7, 17)",6,31,19,56,13,33,26,72
275,0.2,"(23, 4)","(9, 18)",5,66,45,116,6,82,68,156
276,0.2,"(26, 23)","(19, 7)",5,96,76,177,7,141,128,276
277,0.18,"(19, 2)","(27, 8)",9,156,142,307,52,157,189,398
278,0.08,"(21, 5)","(29, 11)",10,41,36,87,4,113,97,214
279,0.2,"(28, 9)","(0, 21)",2,86,64,152,9,87,76,172
280,0.2,"(8, 26)","(12, 17)",5,111,102,218,8,57,45,110
281,0.02,"(0, 5)","(2, 19)",17,161,150,328,7,115,102,224
282,0.2,"(28, 13)","(0, 20)",6,76,65,147,16,162,158,336
283,0.12,"(24, 29)","(21, 28)",5,81,67,153,5,55,32,92
284,0.12,"(8, 19)","(21, 1)",7,171,153,331,9,84,73,166
285,0.18,"(19, 11)","(7, 24)",5,41,34,80,6,71,57,134
286,0.08,"(14, 1)","(18, 4)",5,71,47,123,5,51,34,90
287,0.12,"(7, 28)","(2, 10)",5,166,146,317,6,109,95,210
288,0.04,"(14, 8)","(8, 5)",5,121,90,216,13,161,154,328
289,0.04,"(21, 25)","(1, 24)",4,81,61,146,6,76,62,144
290,0.2,"(12, 6)","(18, 3)",5,121,109,235,6,120,106,232
291,0.02,"(11, 10)","(15, 19)",9,116,78,203,6,209,195,410
292,0.12,"(25, 25)","(13, 22)",10,46,41,97,12,42,34,88
293,0.04,"(27, 15)","(9, 23)",8,126,107,241,36,153,169,358
294,0.02,"(16, 0)","(20, 29)",5,191,178,374,6,147,133,286
295,0.04,"(13, 10)","(2, 4)",5,151,119,275,6,110,96,212
296,0.04,"(2, 9)","(28, 20)",7,151,112,270,4,295,279,578
297,0.02,"(23, 12)","(28, 27)",3,141,96,240,5,135,120,260
298,0.08,"(16, 17)","(23, 16)",9,91,74,174,8,63,51,122
299,0.02,"(0, 22)","(20, 20)",9,166,140,315,5,170,155,330
300,0.14,"(20, 13)","(12, 18)",7,36,28,71,13,63,56,132
301,0.06,"(26, 16)","(22, 9)",8,121,96,225,8,63,51,122
302,0.08,"(8, 3)","(11, 9)",6,146,132,284,5,87,72,164
303,0.2,"(6, 2)","(26, 10)",3,76,65,144,8,113,101,222
304,0.04,"(17, 10)","(18, 29)",6,96,83,185,11,221,212,444
305,0.08,"(19, 20)","(10, 8)",5,86,55,146,16,198,194,408
306,0.08,"(21, 23)","(0, 17)",15,71,71,157,4,99,83,186
307,0.14,"(6, 15)","(1, 19)",13,86,75,174,15,80,75,170
308,0.04,"(1, 11)","(18, 28)",4,131,102,237,36,132,148,316
309,0.12,"(25, 14)","(28, 10)",14,101,82,197,6,43,22,71
310,0.14,"(1, 20)","(22, 23)",6,221,207,434,7,145,132,284
311,0.12,"(7, 24)","(27, 26)",4,106,84,194,11,149,140,300
312,0.14,"(0, 22)","(16, 10)",11,101,89,201,5,140,125,270
313,0.1,"(27, 9)","(22, 22)",7,41,33,81,7,85,72,164
314,0.02,"(7, 11)","(28, 13)",8,146,125,279,11,105,96,212
315,0.16,"(15, 14)","(17, 3)",7,71,53,131,5,135,120,260
316,0.1,"(25, 17)","(5, 9)",12,151,136,299,5,82,67,154
317,0.2,"(3, 19)","(26, 17)",29,346,354,729,10,89,79,178
318,0.16,"(6, 19)","(21, 23)",11,86,74,171,9,126,115,250
319,0.06,"(4, 15)","(28, 28)",15,86,74,175,4,122,106,232
320,0.08,"(25, 12)","(24, 6)",22,31,38,91,26,81,87,194
321,0.14,"(10, 9)","(13, 19)",12,96,89,197,8,115,103,226
322,0.2,"(7, 4)","(21, 24)",13,96,86,195,4,55,39,98
323,0.08,"(20, 24)","(2, 12)",5,126,90,221,7,107,94,208
324,0.18,"(9, 27)","(29, 1)",10,86,68,164,6,119,105,230
325,0.1,"(0, 20)","(26, 12)",11,111,96,218,7,71,58,136
326,0.06,"(14, 0)","(14, 29)",8,56,52,116,24,105,109,238
327,0.12,"(1, 22)","(8, 7)",5,81,67,153,7,55,42,104
328,0.14,"(4, 26)","(14, 25)",4,56,34,94,12,38,30,80
329,0.06,"(2, 19)","(8, 12)",12,81,74,167,8,41,29,78
330,0.2,"(12, 25)","(23, 17)",4,36,24,64,18,40,38,96
331,0.02,"(6, 16)","(8, 2)",3,131,105,239,9,65,54,128
332,0.06,"(29, 8)","(13, 7)",8,66,55,129,4,126,110,240
333,0.12,"(16, 16)","(6, 17)",4,101,82,187,15,88,80,183
334,0.14,"(22, 15)","(6, 13)",6,111,105,222,5,57,42,104
335,0.14,"(11, 29)","(27, 19)",3,101,78,182,3,121,104,228
336,0.12,"(29, 9)","(15, 14)",15,111,103,229,6,62,48,116
337,0.06,"(28, 4)","(12, 22)",8,76,59,143,3,103,86,192
338,0.14,"(17, 2)","(1, 10)",15,71,71,157,27,197,204,428
339,0.18,"(22, 9)","(5, 10)",11,101,94,206,6,102,88,196
340,0.06,"(23, 2)","(10, 27)",4,166,139,309,7,116,103,226
341,0.14,"(2, 17)","(6, 7)",3,91,66,160,5,89,74,168
342,0.18,"(13, 13)","(4, 24)",7,96,88,191,4,118,102,224
343,0.02,"(14, 11)","(3, 15)",9,86,75,170,10,57,47,114
344,0.1,"(16, 27)","(8, 21)",47,86,101,234,8,68,56,132
345,0.06,"(20, 29)","(26, 15)",1,81,66,148,1,92,73,166
346,0.1,"(7, 19)","(16, 15)",6,96,80,182,6,61,47,114
347,0.02,"(14, 18)","(6, 0)",9,231,220,460,20,242,242,504
348,0.08,"(8, 4)","(25, 18)",4,136,113,253,6,107,93,206
349,0.06,"(21, 26)","(6, 19)",8,61,56,125,8,77,65,150
350,0.1,"(5, 8)","(18, 29)",3,116,92,211,8,107,95,210
351,0.04,"(28, 1)","(7, 15)",4,121,85,210,6,172,158,336
352,0.16,"(9, 26)","(22, 6)",4,166,139,309,4,89,73,166
353,0.08,"(1, 12)","(8, 16)",14,106,103,223,7,56,43,106
354,0.04,"(29, 25)","(4, 26)",7,136,101,244,3,123,106,232
355,0.04,"(24, 10)","(1, 0)",5,86,76,167,7,127,114,248
356,0.06,"(14, 12)","(27, 10)",5,76,57,138,7,94,81,182
357,0.06,"(10, 15)","(8, 25)",18,61,53,132,26,61,67,154
358,0.04,"(15, 17)","(19, 24)",14,141,114,269,3,105,88,196
359,0.16,"(14, 17)","(21, 14)",10,96,82,188,7,75,62,144
360,0.08,"(29, 13)","(26, 6)",7,31,22,60,4,55,35,94
361,0.02,"(29, 8)","(20, 11)",2,151,111,264,4,106,81,191
362,0.08,"(7, 21)","(20, 26)",5,106,77,188,12,106,98,216
363,0.1,"(11, 25)","(12, 6)",7,141,117,265,5,65,50,120
364,0.1,"(15, 7)","(15, 13)",16,91,87,194,5,57,39,101
365,0.06,"(17, 23)","(10, 2)",3,81,57,141,3,126,109,238
366,0.12,"(3, 19)","(7, 26)",4,41,32,77,8,76,63,147
367,0.16,"(20, 15)","(19, 19)",7,56,44,107,5,35,12,52
368,0.14,"(2, 16)","(7, 26)",7,76,54,137,14,109,103,226
369,0.2,"(29, 29)","(14, 27)",5,46,26,77,10,47,37,94
370,0.16,"(18, 22)","(16, 28)",4,36,24,64,4,54,38,96
371,0.04,"(23, 11)","(17, 6)",22,116,112,250,8,107,95,210
372,0.1,"(25, 26)","(24, 12)",5,106,78,189,10,134,124,268
373,0.1,"(4, 28)","(15, 0)",5,66,51,122,13,135,128,276
374,0.16,"(10, 2)","(10, 21)",5,76,56,137,26,109,115,250
375,0.18,"(24, 3)","(25, 21)",10,111,94,215,3,61,44,108
376,0.12,"(1, 20)","(6, 19)",23,36,42,101,6,38,17,61
377,0.06,"(0, 28)","(10, 0)",5,156,135,296,3,93,76,172
378,0.18,"(3, 6)","(10, 10)",6,61,44,111,4,82,65,151
379,0.04,"(27, 13)","(17, 0)",16,51,54,121,12,64,56,132
380,0.2,"(24, 10)","(29, 27)",6,431,414,851,4,253,237,494
381,0.08,"(16, 19)","(5, 0)",3,131,111,245,3,123,106,232
382,0.2,"(21, 23)","(9, 15)",8,71,60,139,15,48,43,106
383,0.04,"(6, 8)","(3, 5)",6,61,29,96,10,111,94,215
384,0.16,"(29, 9)","(7, 14)",4,106,82,192,3,142,125,270
385,0.1,"(25, 28)","(5, 24)",12,61,60,133,14,85,79,178
386,0.16,"(0, 15)","(13, 11)",30,51,69,150,11,71,62,144
387,0.1,"(11, 3)","(29, 28)",11,131,115,257,13,130,123,266
388,0.08,"(19, 29)","(21, 21)",8,111,89,208,4,45,26,75
389,0.04,"(13, 21)","(18, 16)",7,156,103,266,4,113,94,211
390,0.04,"(20, 19)","(7, 21)",5,186,165,356,5,222,207,434
391,0.18,"(1, 13)","(4, 2)",4,86,64,154,9,120,109,238
392,0.02,"(24, 8)","(13, 22)",4,151,104,259,4,142,126,272
393,0.1,"(23, 27)","(0, 8)",5,66,52,123,12,72,64,148
394,0.1,"(6, 22)","(18, 26)",16,96,98,210,16,194,190,400
395,0.12,"(20, 2)","(9, 14)",10,131,117,258,8,44,32,84
396,0.06,"(11, 20)","(20, 15)",10,121,102,233,5,96,81,182
397,0.04,"(14, 11)","(7, 13)",10,131,120,261,6,44,30,80
398,0.1,"(2, 18)","(27, 0)",17,91,86,194,5,97,82,184
399,0.06,"(16, 9)","(25, 23)",6,101,78,185,10,118,108,236
400,0.06,"(7, 6)","(5, 0)",6,96,82,184,6,57,41,104
401,0.2,"(23, 1)","(11, 15)",9,81,79,169,17,140,137,294
402,0.06,"(27, 24)","(20, 29)",5,61,55,121,7,129,116,252
403,0.14,"(15, 6)","(3, 13)",5,56,38,99,6,117,103,226
404,0.04,"(8, 26)","(25, 13)",10,101,69,180,10,161,151,322
405,0.02,"(17, 19)","(21, 26)",4,111,85,200,6,146,132,284
406,0.2,"(3, 26)","(3, 24)",7,31,19,57,17,35,29,81
407,0.16,"(7, 21)","(29, 20)",19,61,69,149,5,158,143,306
408,0.02,"(20, 13)","(2, 14)",5,171,146,322,6,192,178,376
409,0.02,"(1, 8)","(26, 25)",3,96,74,173,8,68,56,132
410,0.16,"(16, 6)","(13, 3)",9,26,17,52,10,39,23,72
411,0.08,"(23, 20)","(11, 1)",14,111,94,219,24,108,112,244
412,0.02,"(0, 15)","(15, 24)",12,81,64,157,6,148,134,288
413,0.06,"(12, 25)","(7, 21)",6,26,14,46,8,33,21,62
414,0.16,"(23, 19)","(2, 10)",13,76,73,162,6,59,45,110
415,0.14,"(16, 22)","(27, 26)",7,61,47,115,5,120,105,230
416,0.18,"(26, 5)","(28, 20)",3,151,137,291,8,113,101,222
417,0.14,"(27, 20)","(28, 23)",4,51,36,91,9,69,55,133
418,0.02,"(25, 18)","(26, 20)",9,151,86,246,14,54,39,107
419,0.08,"(28, 16)","(20, 29)",7,131,119,257,7,116,103,226
420,0.14,"(24, 10)","(7, 1)",5,126,109,240,3,172,155,330
421,0.08,"(21, 24)","(21, 1)",10,151,132,293,9,128,117,254
422,0.04,"(0, 7)","(16, 2)",4,161,132,297,6,60,46,112
423,0.2,"(3, 16)","(10, 13)",7,96,78,181,8,114,100,222
424,0.18,"(28, 16)","(15, 29)",16,96,83,195,3,114,97,214
425,0.02,"(29, 2)","(16, 4)",3,91,69,163,12,64,56,132
426,0.04,"(14, 10)","(25, 10)",12,231,205,448,9,145,134,288
427,0.02,"(8, 13)","(1, 0)",8,51,40,99,11,128,119,258
428,0.08,"(8, 0)","(11, 13)",15,96,79,190,7,87,74,168
429,0.16,"(17, 1)","(0, 22)",4,111,100,215,11,165,156,332
430,0.12,"(24, 14)","(20, 15)",16,46,40,102,10,55,45,110
431,0.06,"(3, 8)","(8, 13)",13,131,113,257,5,77,62,144
432,0.2,"(17, 13)","(13, 1)",7,71,60,138,7,216,203,426
433,0.14,"(21, 22)","(22, 4)",10,96,81,187,7,99,86,192
434,0.12,"(9, 15)","(2, 16)",8,26,17,51,5,36,18,59
435,0.12,"(19, 17)","(21, 23)",7,51,34,92,3,65,42,110
436,0.02,"(3, 19)","(28, 3)",5,106,83,194,4,96,80,180
437,0.18,"(21, 2)","(2, 20)",6,106,95,207,8,121,109,238
438,0.08,"(13, 29)","(7, 17)",7,91,59,157,9,115,104,228
439,0.2,"(3, 1)","(10, 0)",3,41,23,67,13,61,54,128
440,0.14,"(7, 7)","(10, 7)",11,61,48,120,7,62,47,116
441,0.06,"(25, 1)","(23, 19)",7,136,116,259,5,58,43,106
442,0.2,"(5, 11)","(26, 13)",10,96,90,196,4,296,280,580
443,0.04,"(23, 1)","(9, 0)",9,61,51,121,3,52,35,90
444,0.18,"(12, 1)","(23, 3)",10,116,106,232,13,84,77,174
445,0.08,"(24, 27)","(22, 5)",3,101,76,180,7,167,154,328
446,0.16,"(7, 25)","(28, 7)",9,61,50,120,5,70,55,130
447,0.02,"(2, 9)","(26, 4)",5,126,95,226,12,135,127,274
448,0.08,"(20, 28)","(7, 2)",8,121,108,237,5,112,97,214
449,0.1,"(4, 11)","(5, 16)",4,26,11,41,4,35,19,58
450,0.14,"(16, 2)","(29, 22)",7,126,116,249,6,187,173,366
451,0.02,"(11, 17)","(24, 4)",6,151,107,264,8,104,92,204
452,0.04,"(21, 3)","(11, 8)",5,116,76,197,9,136,125,270
453,0.18,"(15, 19)","(16, 13)",5,131,108,244,10,121,108,239
454,0.14,"(24, 9)","(24, 13)",15,66,51,132,12,107,95,214
455,0.04,"(20, 17)","(21, 15)",3,41,20,64,4,66,43,113
456,0.12,"(29, 13)","(9, 20)",16,86,84,186,4,98,82,184
457,0.1,"(29, 11)","(8, 20)",6,131,114,251,5,103,88,196
458,0.12,"(22, 8)","(4, 4)",4,96,77,177,7,139,126,272
459,0.1,"(14, 24)","(5, 28)",7,61,49,117,4,47,31,82
460,0.12,"(23, 11)","(6, 26)",5,111,86,202,18,81,79,178
461,0.06,"(25, 26)","(16, 7)",9,101,87,197,13,98,91,202
462,0.2,"(21, 12)","(20, 25)",7,121,108,236,7,140,127,274
463,0.12,"(26, 6)","(0, 21)",10,126,119,255,4,103,87,194
464,0.04,"(20, 5)","(16, 14)",9,66,63,138,10,201,191,402
465,0.1,"(8, 0)","(19, 10)",4,136,115,255,11,76,67,154
466,0.06,"(4, 27)","(29, 15)",13,86,84,183,4,93,77,174
467,0.1,"(14, 13)","(0, 16)",13,71,65,149,4,81,65,150
468,0.02,"(28, 1)","(3, 27)",6,176,144,326,8,89,77,174
469,0.14,"(14, 13)","(17, 6)",10,56,40,106,6,76,58,140
470,0.08,"(17, 18)","(15, 1)",7,106,71,184,6,120,106,232
471,0.12,"(1, 10)","(9, 3)",7,46,34,87,54,71,105,230
472,0.12,"(29, 18)","(13, 11)",10,81,75,166,13,70,63,146
473,0.06,"(10, 26)","(28, 11)",2,136,102,240,2,72,54,128
474,0.04,"(8, 5)","(6, 26)",24,141,132,297,9,155,143,307
475,0.12,"(23, 16)","(16, 15)",6,51,23,80,7,34,21,62
476,0.18,"(1, 11)","(4, 28)",7,81,70,158,9,119,108,236
477,0.14,"(10, 5)","(0, 23)",7,116,98,221,17,99,96,212
478,0.2,"(21, 14)","(0, 12)",15,96,100,211,11,60,51,122
479,0.14,"(24, 28)","(10, 5)",5,106,92,203,5,112,97,214
480,0.14,"(29, 26)","(5, 18)",6,141,129,276,11,97,88,196
481,0.18,"(4, 0)","(3, 29)",5,106,93,204,7,346,333,686
482,0.14,"(20, 29)","(16, 1)",5,91,68,164,5,91,76,172
483,0.18,"(1, 21)","(23, 1)",7,136,122,265,3,70,53,126
484,0.08,"(19, 21)","(13, 10)",5,106,98,209,7,74,61,142
485,0.18,"(13, 27)","(27, 24)",5,96,79,180,11,96,87,194
486,0.18,"(5, 16)","(10, 1)",6,91,78,175,5,115,100,220
487,0.1,"(7, 23)","(23, 23)",5,101,80,186,15,65,60,140
488,0.02,"(10, 25)","(14, 29)",15,191,190,396,10,205,195,410
489,0.08,"(29, 13)","(16, 0)",6,111,67,184,6,129,115,250
490,0.16,"(22, 29)","(24, 14)",4,76,69,149,11,133,124,268
491,0.1,"(16, 3)","(6, 29)",5,101,87,193,6,83,69,158
492,0.12,"(14, 26)","(1, 0)",3,156,135,294,15,91,86,192
493,0.14,"(4, 27)","(20, 14)",11,126,109,246,7,65,52,124
494,0.08,"(10, 27)","(24, 12)",13,111,104,228,9,118,107,234
495,0.06,"(18, 13)","(22, 20)",8,76,63,147,10,90,80,180
496,0.06,"(4, 6)","(7, 25)",5,146,120,271,5,90,75,170
497,0.16,"(28, 1)","(21, 22)",6,91,81,178,5,92,77,174
498,0.04,"(27, 20)","(1, 10)",5,106,90,201,11,112,103,226
499,0.16,"(5, 20)","(25, 24)",13,146,137,296,28,94,102,224
500,0.08,"(24, 15)","(6, 20)",9,76,61,146,7,209,196,412
501,0.1,"(6, 4)","(12, 11)",4,66,48,118,15,62,57,134
502,0.08,"(18, 0)","(14, 25)",9,126,105,240,7,114,101,222
503,0.08,"(25, 8)","(7, 16)",6,66,55,127,8,58,46,112
504,0.16,"(28, 26)","(17, 12)",6,66,49,121,5,60,45,110
505,0.2,"(17, 24)","(16, 16)",3,81,72,156,6,52,38,96
506,0.08,"(22, 11)","(5, 18)",14,111,86,211,5,75,60,140
507,0.2,"(16, 5)","(28, 26)",4,101,85,190,14,160,154,328
508,0.12,"(0, 5)","(14, 13)",6,136,102,244,3,139,122,264
509,0.12,"(9, 23)","(1, 3)",15,91,85,191,7,137,124,268
510,0.1,"(1, 21)","(24, 13)",7,106,83,196,21,72,73,166
511,0.12,"(25, 27)","(15, 24)",7,101,89,197,4,66,50,120
512,0.06,"(7, 1)","(4, 26)",8,126,104,238,20,218,218,456
513,0.06,"(11, 0)","(17, 2)",3,71,48,122,4,72,51,127
514,0.18,"(3, 1)","(28, 15)",3,86,74,163,8,157,145,310
515,0.06,"(26, 17)","(26, 21)",5,66,36,107,14,83,77,174
516,0.02,"(8, 0)","(28, 3)",5,266,206,477,11,108,99,218
517,0.1,"(21, 15)","(7, 29)",8,81,76,165,3,115,98,216
518,0.12,"(10, 23)","(13, 18)",4,46,35,85,5,47,31,83
519,0.14,"(3, 10)","(0, 14)",7,31,23,61,4,16,14,34
520,0.12,"(7, 24)","(7, 15)",8,81,73,162,6,58,43,107
521,0.1,"(20, 8)","(24, 10)",5,71,41,117,10,49,33,92
522,0.02,"(10, 17)","(18, 8)",10,96,79,185,6,103,89,198
523,0.08,"(29, 25)","(28, 14)",9,101,85,195,10,80,70,160
524,0.04,"(6, 1)","(21, 18)",5,136,113,254,10,238,228,476
525,0.06,"(16, 5)","(2, 10)",5,166,136,307,13,52,45,110
526,0.18,"(11, 23)","(28, 13)",14,146,143,303,4,148,132,284
527,0.02,"(26, 25)","(24, 2)",13,51,51,115,9,142,131,282
528,0.16,"(17, 12)","(29, 17)",5,151,136,292,10,83,73,166
529,0.18,"(19, 15)","(7, 21)",8,126,118,252,5,81,66,152
530,0.16,"(8, 13)","(11, 29)",4,61,43,108,36,198,214,448
531,0.16,"(14, 17)","(3, 22)",6,86,76,168,4,97,81,182
532,0.04,"(16, 13)","(19, 22)",7,71,54,132,7,157,144,308
533,0.2,"(8, 9)","(10, 6)",7,36,23,66,6,42,20,68
534,0.1,"(19, 12)","(19, 18)",7,51,43,101,7,64,45,116
535,0.1,"(15, 18)","(13, 16)",8,76,58,142,10,65,55,130
536,0.04,"(11, 27)","(2, 26)",7,41,24,72,12,51,42,105
537,0.2,"(16, 16)","(6, 6)",10,111,108,229,12,194,186,392
538,0.2,"(8, 26)","(29, 9)",11,146,132,289,4,73,57,134
539,0.06,"(10, 29)","(20, 6)",5,131,111,247,2,137,119,258
540,0.02,"(3, 3)","(7, 0)",6,36,21,63,12,170,162,344
541,0.06,"(6, 25)","(13, 26)",6,91,56,153,9,86,75,170
542,0.16,"(22, 7)","(28, 25)",7,121,107,235,7,145,132,284
543,0.16,"(24, 12)","(26, 15)",113,61,145,319,42,71,87,200
544,0.16,"(28, 17)","(28, 2)",9,151,132,292,11,97,88,196
545,0.14,"(26, 15)","(15, 9)",29,126,137,292,5,60,45,110
546,0.12,"(17, 15)","(28, 21)",5,96,83,184,4,125,109,238
547,0.06,"(14, 11)","(22, 24)",5,146,103,254,5,84,69,158
548,0.06,"(19, 7)","(28, 29)",4,111,91,206,7,70,57,134
549,0.18,"(27, 12)","(9, 5)",3,66,51,120,8,94,82,184
550,0.18,"(27, 5)","(17, 2)",7,36,27,70,10,74,64,148
551,0.16,"(29, 7)","(29, 20)",3,51,41,95,2,117,99,218
552,0.16,"(14, 27)","(8, 1)",8,111,101,220,5,196,181,382
553,0.06,"(5, 0)","(11, 26)",4,151,141,296,4,133,117,254
554,0.14,"(25, 25)","(0, 0)",5,66,59,130,4,79,63,146
555,0.04,"(9, 20)","(6, 7)",8,56,44,108,6,124,110,240
556,0.06,"(10, 6)","(0, 13)",6,56,43,105,6,36,22,64
557,0.2,"(8, 5)","(3, 23)",3,101,87,191,12,95,87,194
558,0.2,"(5, 19)","(26, 17)",6,111,99,216,11,113,104,228
559,0.1,"(10, 13)","(3, 8)",26,46,46,118,17,33,30,80
560,0.04,"(29, 8)","(10, 28)",5,161,125,291,6,97,83,186
561,0.08,"(8, 5)","(26, 7)",14,111,102,227,5,64,49,118
562,0.08,"(9, 19)","(10, 6)",5,126,116,247,6,43,29,78
563,0.16,"(29, 15)","(20, 16)",8,81,65,154,7,46,33,86
564,0.06,"(7, 7)","(17, 0)",5,111,83,199,4,127,111,242
565,0.02,"(23, 4)","(0, 27)",6,126,116,248,12,76,68,156
566,0.2,"(4, 15)","(6, 6)",3,41,29,73,3,80,61,144
567,0.14,"(0, 14)","(16, 8)",10,81,73,164,5,66,51,122
568,0.18,"(21, 29)","(14, 13)",6,111,96,213,11,80,71,162
569,0.08,"(28, 12)","(0, 2)",4,76,63,143,6,101,87,194
570,0.02,"(11, 6)","(17, 11)",7,91,67,165,7,165,152,324
571,0.18,"(8, 13)","(11, 24)",6,171,163,340,4,104,88,196
572,0.2,"(3, 11)","(0, 19)",6,56,51,113,4,63,47,114
573,0.02,"(4, 18)","(28, 4)",4,111,84,199,10,74,64,148
574,0.2,"(0, 24)","(11, 2)",23,71,83,177,11,252,243,506
575,0.16,"(12, 7)","(2, 9)",9,36,27,72,8,55,43,106
576,0.18,"(1, 28)","(1, 24)",9,26,16,51,5,39,17,61
577,0.1,"(11, 6)","(26, 6)",10,51,46,107,4,57,41,102
578,0.14,"(21, 16)","(24, 29)",9,151,144,304,4,169,153,326
579,0.12,"(22, 2)","(13, 14)",9,76,61,146,14,60,54,128
580,0.16,"(12, 14)","(29, 9)",8,91,83,182,9,69,58,136
581,0.1,"(9, 3)","(28, 17)",11,111,103,225,43,180,203,426
582,0.02,"(24, 18)","(3, 15)",15,71,62,148,21,62,63,146
583,0.16,"(21, 14)","(8, 19)",2,61,46,109,7,76,63,146
584,0.06,"(21, 7)","(15, 25)",12,101,94,207,5,180,165,350
585,0.1,"(2, 7)","(26, 23)",7,151,132,290,5,203,188,396
586,0.08,"(18, 27)","(27, 11)",3,111,96,210,8,101,89,198
587,0.1,"(10, 28)","(17, 27)",3,36,20,59,3,59,42,104
588,0.1,"(14, 14)","(21, 21)",4,91,76,171,4,89,72,165
589,0.16,"(27, 27)","(5, 20)",5,51,37,93,4,91,75,170
590,0.16,"(10, 3)","(6, 26)",15,71,75,161,6,106,92,204
591,0.04,"(9, 27)","(0, 29)",5,56,42,103,4,78,57,139
592,0.12,"(18, 4)","(22, 4)",4,31,24,59,11,105,95,211
593,0.02,"(11, 1)","(18, 29)",4,171,132,307,9,131,120,260
594,0.2,"(15, 14)","(28, 21)",7,151,137,295,9,125,114,248
595,0.16,"(17, 0)","(17, 21)",12,126,123,261,25,96,101,222
596,0.06,"(0, 4)","(19, 7)",11,216,192,419,15,112,107,234
597,0.08,"(11, 8)","(17, 4)",4,86,66,156,15,98,89,202
598,0.04,"(25, 14)","(25, 22)",4,106,58,168,6,118,104,228
599,0.18,"(25, 28)","(0, 10)",7,176,168,351,9,96,85,190
600,0.16,"(20, 15)","(17, 26)",8,101,87,196,9,144,133,286
601,0.08,"(0, 7)","(7, 22)",4,101,75,180,5,88,73,166
602,0.1,"(20, 14)","(2, 0)",7,136,132,275,4,82,66,152
603,0.14,"(16, 26)","(28, 13)",11,106,99,216,7,77,64,148
604,0.14,"(13, 1)","(12, 15)",9,136,118,263,6,78,64,148
605,0.16,"(6, 29)","(16, 25)",3,56,40,99,8,55,43,106
606,0.12,"(28, 19)","(29, 14)",17,46,37,100,5,77,57,139
607,0.02,"(26, 8)","(19, 0)",4,121,70,195,10,154,144,308
608,0.14,"(18, 6)","(17, 20)",3,71,61,135,17,107,104,228
609,0.18,"(4, 3)","(24, 25)",7,91,77,175,14,180,174,368
610,0.02,"(13, 27)","(1, 13)",5,191,168,364,9,192,181,382
611,0.02,"(19, 29)","(0, 7)",11,271,232,514,14,101,95,210
612,0.04,"(7, 19)","(18, 18)",10,86,71,167,10,129,119,258
613,0.1,"(22, 24)","(1, 23)",4,66,52,122,5,89,74,168
614,0.2,"(3, 3)","(25, 17)",9,131,127,267,21,82,83,186
615,0.04,"(13, 2)","(23, 27)",4,106,91,201,8,96,84,188
616,0.14,"(4, 16)","(5, 26)",20,61,70,151,5,73,58,136
617,0.2,"(19, 21)","(25, 4)",5,116,97,218,7,110,97,214
618,0.2,"(4, 25)","(11, 23)",6,46,29,81,8,116,104,228
619,0.02,"(15, 24)","(26, 16)",3,56,48,107,6,117,103,226
620,0.16,"(22, 2)","(9, 12)",6,76,55,137,7,61,48,116
621,0.2,"(13, 25)","(26, 23)",6,51,43,100,7,136,123,266
622,0.06,"(15, 21)","(24, 2)",7,76,68,151,7,80,67,154
623,0.18,"(20, 7)","(16, 20)",8,206,189,403,7,139,126,272
624,0.16,"(9, 17)","(27, 2)",4,181,165,350,6,96,82,184
625,0.04,"(22, 28)","(21, 10)",9,126,117,252,11,155,146,312
626,0.16,"(19, 15)","(6, 29)",6,76,66,148,11,89,80,180
627,0.12,"(21, 14)","(6, 6)",5,56,49,110,3,49,32,84
628,0.06,"(12, 16)","(23, 3)",16,141,134,291,11,97,88,196
629,0.2,"(25, 28)","(22, 13)",4,136,119,259,10,74,64,148
630,0.2,"(28, 26)","(6, 28)",5,131,122,258,4,398,382,784
631,0.02,"(25, 22)","(23, 11)",10,226,192,428,14,161,155,330
632,0.18,"(2, 18)","(22, 9)",5,71,54,130,5,124,109,238
633,0.08,"(6, 29)","(22, 18)",11,101,90,202,5,113,98,216
634,0.04,"(6, 22)","(24, 29)",12,56,51,119,12,123,115,250
635,0.12,"(27, 13)","(12, 16)",12,91,81,184,7,86,73,166
636,0.2,"(2, 14)","(21, 29)",5,76,69,150,5,133,118,256
637,0.2,"(3, 19)","(9, 27)",4,116,102,222,7,99,85,191
638,0.16,"(24, 26)","(12, 9)",7,106,98,211,12,69,61,142
639,0.1,"(14, 15)","(25, 20)",23,131,112,266,15,86,81,182
640,0.04,"(11, 20)","(24, 12)",6,106,79,191,5,96,81,182
641,0.08,"(18, 21)","(0, 24)",3,106,96,205,3,106,89,198
642,0.2,"(1, 9)","(6, 2)",5,61,38,104,8,107,95,210
643,0.16,"(26, 3)","(0, 9)",6,91,77,174,12,92,84,188
644,0.16,"(9, 16)","(21, 22)",8,86,74,168,5,116,101,222
645,0.02,"(28, 26)","(12, 15)",5,171,103,279,5,170,155,330
646,0.2,"(5, 15)","(22, 12)",3,81,60,144,6,163,149,318
647,0.12,"(7, 11)","(29, 24)",8,86,69,163,4,137,121,262
648,0.08,"(15, 20)","(11, 12)",6,71,55,132,11,87,78,176
649,0.08,"(14, 23)","(2, 1)",28,96,95,219,11,132,123,266
650,0.1,"(27, 27)","(15, 18)",8,126,109,243,6,51,37,94
651,0.2,"(26, 28)","(17, 6)",4,81,68,153,5,203,188,396
652,0.04,"(27, 0)","(4, 19)",2,151,123,276,2,108,90,200
653,0.2,"(0, 4)","(27, 27)",5,91,72,168,8,127,115,250
654,0.2,"(27, 25)","(6, 29)",15,181,185,381,6,130,116,252
655,0.14,"(27, 15)","(14, 23)",10,46,45,101,12,59,51,122
656,0.06,"(11, 6)","(10, 1)",8,56,31,95,5,61,43,109
657,0.18,"(8, 3)","(27, 5)",4,66,53,123,10,87,77,174
658,0.1,"(16, 16)","(16, 20)",7,31,24,62,16,53,46,115
659,0.1,"(4, 11)","(11, 7)",11,96,77,184,16,125,121,262
660,0.08,"(22, 7)","(23, 14)",3,76,57,136,7,69,56,132
661,0.02,"(0, 4)","(23, 26)",9,96,90,195,15,134,129,278
662,0.02,"(20, 6)","(2, 25)",3,141,133,277,15,100,95,210
663,0.06,"(22, 6)","(23, 15)",5,71,64,140,6,142,128,276
664,0.02,"(5, 23)","(8, 23)",2,56,19,77,4,56,34,94
665,0.02,"(8, 6)","(14, 0)",3,131,96,230,6,170,156,332
666,0.16,"(1, 13)","(9, 8)",6,56,51,113,13,93,86,192
667,0.06,"(4, 6)","(26, 24)",4,156,138,298,4,125,109,238
668,0.2,"(21, 21)","(15, 22)",7,61,50,118,9,42,26,77
669,0.08,"(21, 17)","(3, 10)",4,76,69,149,5,155,140,300
670,0.2,"(5, 9)","(1, 27)",13,116,106,235,9,177,166,352
671,0.16,"(23, 4)","(0, 11)",4,81,72,157,5,154,139,298
672,0.2,"(13, 3)","(1, 19)",5,216,200,421,15,199,194,408
673,0.16,"(26, 12)","(20, 20)",6,46,29,81,6,49,35,90
674,0.14,"(25, 17)","(0, 0)",7,81,77,165,7,91,78,176
675,0.14,"(14, 4)","(26, 0)",12,111,101,224,8,80,68,156
676,0.16,"(3, 1)","(9, 10)",6,81,61,148,3,69,52,124
677,0.06,"(17, 15)","(4, 12)",5,151,117,273,7,85,72,164
678,0.08,"(3, 16)","(21, 0)",27,106,113,246,14,67,61,142
679,0.12,"(0, 20)","(17, 20)",11,151,144,306,11,129,120,260
680,0.16,"(13, 28)","(16, 3)",3,111,98,212,4,95,79,178
681,0.16,"(3, 4)","(17, 9)",6,116,107,229,11,91,82,184
682,0.06,"(9, 23)","(16, 19)",8,111,79,198,3,69,52,124
683,0.08,"(20, 16)","(19, 8)",5,51,45,101,17,85,82,184
684,0.12,"(15, 18)","(19, 29)",3,61,47,111,10,146,136,292
685,0.18,"(20, 24)","(1, 29)",5,126,107,238,5,173,158,336
686,0.18,"(28, 17)","(14, 26)",8,161,150,319,5,77,62,144
687,0.2,"(14, 25)","(20, 18)",5,46,40,91,5,81,66,152
688,0.18,"(10, 26)","(21, 18)",13,96,91,200,23,101,104,228
689,0.18,"(8, 27)","(14, 11)",5,76,56,137,6,134,120,260
690,0.12,"(29, 22)","(22, 17)",14,131,120,265,4,83,67,154
691,0.12,"(24, 23)","(24, 6)",7,131,115,253,5,91,76,172
692,0.14,"(19, 28)","(20, 11)",15,96,96,207,8,75,63,146
693,0.02,"(11, 15)","(8, 19)",16,106,78,200,5,99,75,179
694,0.2,"(29, 14)","(25, 10)",6,66,42,114,10,48,35,93
695,0.14,"(13, 7)","(15, 27)",19,136,138,293,10,60,50,120
696,0.1,"(10, 17)","(24, 20)",11,201,195,407,12,104,96,212
697,0.2,"(29, 8)","(28, 19)",4,86,75,165,8,148,135,291
698,0.12,"(7, 29)","(7, 14)",5,51,41,97,9,74,63,146
699,0.12,"(29, 21)","(14, 10)",5,96,86,187,11,82,73,166
700,0.14,"(2, 13)","(25, 18)",6,106,99,211,18,87,85,190
701,0.06,"(16, 0)","(21, 28)",5,121,104,230,6,94,80,180
702,0.04,"(12, 12)","(2, 5)",8,131,106,245,23,60,63,146
703,0.06,"(20, 9)","(12, 14)",7,61,43,111,13,31,24,68
704,0.02,"(12, 7)","(12, 2)",8,186,153,347,5,147,126,278
705,0.16,"(14, 9)","(16, 27)",9,41,39,89,4,84,68,156
706,0.08,"(20, 16)","(25, 26)",4,76,48,128,11,86,77,174
707,0.18,"(12, 0)","(6, 29)",4,96,83,183,9,115,104,228
708,0.06,"(4, 0)","(3, 16)",20,46,46,112,13,105,98,216
709,0.04,"(8, 2)","(12, 2)",7,66,40,113,7,76,63,146
710,0.14,"(3, 1)","(10, 27)",5,131,109,245,16,112,108,236
711,0.12,"(6, 1)","(19, 5)",3,66,46,115,4,88,72,164
712,0.02,"(9, 13)","(11, 1)",4,126,89,219,10,92,82,184
713,0.14,"(17, 21)","(24, 23)",9,141,121,271,12,131,119,262
714,0.16,"(8, 10)","(18, 17)",8,76,70,154,7,96,83,186
715,0.08,"(16, 16)","(14, 0)",9,91,67,167,4,47,31,82
716,0.14,"(19, 9)","(9, 11)",15,136,136,287,12,92,84,188
717,0.08,"(27, 4)","(17, 21)",8,166,148,322,4,134,118,256
718,0.14,"(19, 17)","(29, 25)",10,71,60,141,6,116,102,224
719,0.14,"(10, 18)","(18, 27)",26,101,112,239,7,113,100,220
720,0.16,"(17, 27)","(9, 26)",6,26,16,48,4,16,14,34
721,0.08,"(0, 20)","(20, 0)",5,116,91,212,24,126,130,280
722,0.06,"(0, 19)","(18, 12)",5,81,63,149,11,123,114,248
723,0.04,"(4, 13)","(8, 22)",4,56,37,97,8,59,47,114
724,0.2,"(14, 6)","(5, 28)",6,111,100,217,10,164,154,328
725,0.04,"(0, 7)","(4, 28)",11,56,51,118,9,75,64,148
726,0.08,"(10, 24)","(4, 12)",7,61,56,124,10,41,31,82
727,0.18,"(24, 22)","(3, 17)",13,86,81,180,8,132,120,260
728,0.12,"(15, 28)","(20, 3)",10,126,102,238,2,103,85,190
729,0.16,"(21, 3)","(7, 16)",5,61,49,115,7,93,80,180
730,0.04,"(22, 3)","(23, 29)",7,86,65,158,5,157,142,304
731,0.14,"(4, 16)","(29, 6)",19,86,88,193,7,107,94,208
732,0.2,"(14, 22)","(15, 15)",4,36,21,61,6,77,63,146
733,0.2,"(24, 8)","(11, 25)",13,71,63,147,8,77,65,150
734,0.1,"(13, 3)","(1, 5)",8,66,56,130,16,63,59,138
735,0.16,"(29, 3)","(19, 22)",5,156,135,296,4,59,43,106
736,0.12,"(24, 23)","(15, 10)",14,61,60,135,6,50,36,92
737,0.16,"(0, 29)","(7, 0)",5,96,86,187,4,131,115,250
738,0.16,"(13, 24)","(20, 6)",4,111,86,201,5,78,63,146
739,0.02,"(27, 5)","(12, 24)",8,201,146,355,7,305,292,604
740,0.14,"(15, 6)","(5, 25)",4,81,65,150,2,86,68,156
741,0.16,"(20, 11)","(4, 6)",8,106,86,200,4,142,126,272
742,0.06,"(20, 22)","(25, 25)",5,91,60,156,4,46,27,77
743,0.1,"(11, 17)","(5, 1)",4,176,164,344,6,136,122,264
744,0.02,"(27, 4)","(23, 24)",8,106,64,178,16,82,78,176
745,0.02,"(5, 3)","(14, 26)",11,166,133,310,10,150,140,300
746,0.02,"(5, 13)","(21, 20)",18,136,103,257,12,144,136,292
747,0.2,"(1, 28)","(5, 1)",12,106,107,225,5,95,80,180
748,0.02,"(26, 14)","(24, 10)",11,111,56,178,9,133,122,264
749,0.12,"(27, 0)","(16, 5)",5,61,41,107,11,55,46,112
750,0.02,"(4, 29)","(14, 5)",4,66,59,129,5,219,204,428
751,0.18,"(5, 3)","(5, 14)",7,71,60,138,3,44,27,74
752,0.02,"(19, 6)","(8, 29)",12,86,84,182,4,160,144,308
753,0.12,"(22, 21)","(23, 9)",9,106,95,210,6,67,53,126
754,0.06,"(25, 0)","(4, 18)",13,96,74,183,3,98,81,182
755,0.14,"(25, 26)","(14, 21)",2,71,49,122,8,73,61,142
756,0.1,"(21, 12)","(26, 8)",5,86,70,161,5,89,74,168
757,0.12,"(15, 29)","(10, 26)",5,16,10,31,11,16,21,48
758,0.04,"(29, 7)","(13, 23)",3,106,94,203,12,177,169,358
759,0.08,"(27, 13)","(1, 17)",10,81,65,156,6,113,99,218
760,0.14,"(28, 24)","(19, 28)",5,96,80,181,6,52,38,96
761,0.18,"(13, 0)","(9, 28)",5,91,85,181,11,136,127,274
762,0.14,"(26, 23)","(13, 6)",19,96,79,194,13,112,105,230
763,0.18,"(24, 15)","(26, 11)",16,101,92,209,8,35,20,63
764,0.18,"(2, 29)","(11, 0)",7,96,88,191,13,138,131,282
765,0.08,"(16, 3)","(6, 29)",12,96,90,198,5,130,115,250
766,0.04,"(5, 6)","(2, 13)",5,56,43,104,7,130,117,254
767,0.18,"(16, 15)","(1, 10)",14,96,89,199,9,140,129,278
768,0.04,"(22, 21)","(4, 10)",13,76,70,159,7,138,125,270
769,0.04,"(3, 26)","(11, 18)",8,106,71,185,7,82,69,158
770,0.12,"(2, 5)","(18, 22)",5,76,65,146,4,78,62,144
771,0.14,"(24, 6)","(9, 1)",13,106,102,221,12,88,80,180
772,0.08,"(1, 15)","(3, 16)",7,56,45,108,7,64,51,122
773,0.18,"(16, 19)","(25, 24)",8,121,100,229,12,168,160,340
774,0.18,"(10, 25)","(29, 20)",7,106,93,206,12,196,188,396
775,0.1,"(22, 28)","(8, 9)",6,121,95,222,7,95,82,184
776,0.16,"(6, 6)","(17, 22)",7,96,81,184,12,113,105,230
777,0.02,"(19, 8)","(11, 5)",4,156,95,255,5,169,154,328
778,0.1,"(5, 25)","(26, 17)",4,106,86,196,5,99,84,188
779,0.06,"(29, 28)","(20, 28)",3,41,23,67,12,38,30,80
780,0.14,"(7, 13)","(23, 25)",5,106,89,200,11,58,49,118
781,0.16,"(27, 5)","(22, 22)",8,61,56,125,11,140,131,282
782,0.02,"(13, 22)","(27, 19)",6,221,176,403,4,77,61,142
783,0.14,"(13, 26)","(26, 28)",10,46,43,99,8,59,47,114
784,0.08,"(27, 8)","(9, 27)",14,196,166,376,9,90,79,178
785,0.2,"(15, 27)","(4, 6)",12,71,61,144,15,84,79,178
786,0.02,"(25, 5)","(27, 25)",10,201,162,373,8,186,174,368
787,0.06,"(24, 1)","(5, 2)",12,171,165,348,10,73,63,146
788,0.14,"(24, 11)","(29, 29)",7,251,243,501,7,64,51,122
789,0.18,"(19, 24)","(18, 11)",4,66,55,125,5,91,76,172
790,0.18,"(15, 1)","(20, 10)",9,56,45,110,6,70,56,132
791,0.18,"(19, 3)","(4, 8)",8,76,68,152,12,100,92,204
792,0.16,"(18, 2)","(13, 17)",5,86,62,153,9,99,88,196
793,0.1,"(15, 6)","(21, 25)",12,66,67,145,10,110,100,220
794,0.06,"(17, 14)","(20, 28)",8,121,110,239,14,94,88,196
795,0.06,"(16, 0)","(6, 26)",4,106,82,192,5,66,51,122
796,0.02,"(0, 14)","(10, 1)",4,76,60,140,6,123,109,238
797,0.16,"(27, 8)","(26, 25)",15,136,137,288,11,80,71,162
798,0.16,"(11, 10)","(15, 13)",14,116,112,242,13,56,49,118
799,0.2,"(3, 29)","(18, 24)",28,106,116,250,5,100,85,190
800,0.02,"(0, 15)","(0, 20)",6,111,87,204,7,71,52,130
801,0.14,"(17, 6)","(27, 2)",7,86,70,163,6,171,157,334
802,0.08,"(3, 8)","(4, 0)",7,56,43,106,8,74,57,139
803,0.02,"(7, 25)","(16, 21)",8,146,99,253,15,67,60,142
804,0.04,"(7, 6)","(17, 10)",10,151,135,296,13,191,184,388
805,0.14,"(0, 2)","(23, 11)",6,61,48,115,11,147,138,296
806,0.08,"(4, 2)","(21, 26)",7,91,78,176,8,141,129,278
807,0.16,"(23, 11)","(29, 10)",3,76,68,147,11,52,42,105
808,0.18,"(17, 7)","(5, 25)",6,46,37,89,9,102,91,202
809,0.2,"(22, 23)","(9, 9)",12,106,106,224,10,63,53,126
810,0.2,"(23, 1)","(9, 20)",4,131,118,253,9,85,74,168
811,0.2,"(0, 1)","(18, 12)",2,111,98,211,3,134,117,254
812,0.08,"(5, 6)","(29, 21)",23,96,97,216,15,148,143,306
813,0.12,"(20, 22)","(20, 3)",11,66,47,124,10,117,107,234
814,0.16,"(15, 26)","(16, 16)",9,141,120,270,5,142,127,274
815,0.06,"(29, 20)","(9, 1)",5,91,83,179,8,184,172,364
816,0.08,"(14, 0)","(4, 25)",13,121,105,239,4,123,107,234
817,0.14,"(16, 12)","(5, 11)",16,186,187,389,4,45,27,76
818,0.04,"(26, 27)","(6, 23)",8,86,70,164,4,62,46,112
819,0.12,"(25, 23)","(16, 27)",11,76,69,156,6,121,106,233
820,0.1,"(4, 5)","(9, 19)",14,71,64,149,7,76,63,146
821,0.08,"(13, 24)","(21, 24)",7,111,102,220,4,97,81,182
822,0.2,"(0, 11)","(8, 7)",3,61,46,110,7,54,41,102
823,0.04,"(5, 21)","(20, 28)",3,76,57,136,7,62,49,118
824,0.06,"(0, 12)","(0, 20)",3,71,53,127,8,64,52,124
825,0.18,"(0, 10)","(21, 19)",3,66,51,120,5,270,255,530
826,0.12,"(28, 28)","(2, 11)",5,131,117,253,3,149,132,284
827,0.04,"(18, 10)","(21, 14)",11,96,80,187,5,106,91,202
828,0.1,"(13, 20)","(22, 8)",6,66,49,121,8,116,104,228
829,0.08,"(7, 17)","(28, 8)",16,96,94,206,4,75,59,138
830,0.12,"(11, 22)","(3, 26)",7,46,34,87,7,76,63,146
831,0.06,"(27, 24)","(22, 20)",7,111,89,207,7,44,26,77
832,0.06,"(23, 28)","(2, 28)",6,101,86,193,6,114,100,220
833,0.02,"(3, 1)","(6, 12)",4,71,38,113,8,264,252,524
834,0.2,"(1, 19)","(28, 21)",6,91,84,181,15,198,193,406
835,0.1,"(14, 27)","(3, 4)",7,101,87,195,10,94,84,188
836,0.18,"(27, 23)","(20, 27)",10,46,33,89,21,79,80,180
837,0.06,"(18, 4)","(10, 19)",3,91,52,146,3,64,47,114
838,0.1,"(23, 9)","(17, 22)",6,51,42,99,5,114,99,218
839,0.18,"(13, 16)","(16, 1)",4,126,117,247,8,60,48,116
840,0.12,"(9, 28)","(10, 15)",8,66,63,137,4,83,67,154
841,0.2,"(0, 16)","(21, 25)",4,121,106,231,2,76,58,136
842,0.1,"(6, 15)","(12, 1)",5,86,77,168,6,67,53,126
843,0.04,"(2, 11)","(10, 23)",4,31,23,58,4,126,110,240
844,0.1,"(20, 23)","(22, 7)",6,116,85,207,11,58,49,118
845,0.04,"(24, 28)","(13, 7)",16,81,83,180,11,171,162,344
846,0.06,"(16, 17)","(28, 0)",8,86,70,164,5,101,86,192
847,0.14,"(17, 6)","(25, 6)",7,46,39,92,4,116,100,220
848,0.18,"(6, 14)","(13, 12)",7,66,48,121,7,81,68,156
849,0.2,"(10, 15)","(26, 8)",44,56,85,185,10,77,67,154
850,0.06,"(21, 12)","(4, 0)",11,96,88,195,5,107,92,204
851,0.1,"(3, 7)","(15, 29)",21,91,90,202,9,125,114,248
852,0.02,"(29, 11)","(26, 26)",4,176,154,334,13,111,104,228
853,0.14,"(9, 12)","(20, 17)",4,121,99,224,8,130,118,256
854,0.14,"(24, 7)","(27, 4)",4,66,51,121,4,40,19,63
855,0.2,"(14, 9)","(21, 25)",7,61,57,125,6,91,77,174
856,0.2,"(24, 4)","(24, 20)",3,121,100,224,3,163,146,312
857,0.06,"(20, 29)","(25, 5)",2,176,155,333,4,102,86,192
858,0.04,"(1, 17)","(17, 25)",5,121,86,212,5,157,142,304
859,0.14,"(17, 28)","(1, 14)",12,76,60,148,9,215,204,428
860,0.16,"(18, 25)","(29, 14)",6,126,121,253,8,107,95,210
861,0.02,"(2, 24)","(2, 15)",8,191,112,311,5,223,204,432
862,0.12,"(0, 0)","(11, 26)",3,71,55,129,3,75,58,136
863,0.1,"(5, 9)","(16, 1)",6,81,64,151,9,124,113,246
864,0.12,"(22, 15)","(15, 13)",6,71,53,130,7,16,16,39
865,0.18,"(21, 6)","(2, 27)",11,81,78,170,18,138,136,292
866,0.08,"(16, 3)","(10, 22)",12,46,39,97,5,62,47,114
867,0.06,"(6, 14)","(17, 11)",13,86,85,184,5,122,105,232
868,0.2,"(13, 13)","(26, 9)",7,141,125,273,5,119,104,228
869,0.06,"(7, 28)","(0, 29)",10,36,25,71,6,32,13,51
870,0.06,"(25, 8)","(2, 19)",5,121,99,225,7,73,60,140
871,0.1,"(11, 8)","(3, 10)",5,131,102,238,4,34,14,52
872,0.12,"(10, 6)","(8, 6)",21,51,43,115,7,59,40,106
873,0.06,"(5, 0)","(21, 29)",29,86,88,203,5,121,106,232
874,0.02,"(11, 16)","(29, 7)",10,121,110,241,6,273,259,538
875,0.02,"(7, 18)","(4, 5)",12,151,119,282,7,185,172,364
876,0.08,"(11, 14)","(5, 2)",4,66,42,112,5,128,113,246
877,0.08,"(4, 18)","(20, 0)",8,81,64,153,6,167,153,326
878,0.14,"(4, 17)","(16, 25)",4,71,44,119,15,84,79,178
879,0.02,"(8, 28)","(17, 22)",3,201,153,357,5,218,203,426
880,0.02,"(24, 0)","(28, 9)",6,96,65,167,7,158,145,310
881,0.2,"(21, 24)","(29, 3)",12,331,329,672,5,140,125,270
882,0.16,"(9, 12)","(3, 5)",7,111,80,198,12,77,69,158
883,0.08,"(21, 15)","(24, 9)",9,41,38,88,5,63,44,112
884,0.02,"(19, 10)","(6, 10)",9,211,166,386,10,87,77,174
885,0.12,"(17, 13)","(24, 0)",8,91,84,183,8,235,223,466
886,0.16,"(22, 26)","(27, 29)",5,176,153,334,14,219,213,446
887,0.04,"(4, 13)","(15, 13)",5,91,77,173,5,114,99,218
888,0.02,"(28, 25)","(13, 3)",10,111,77,198,4,220,204,428
889,0.06,"(10, 26)","(0, 23)",7,101,97,205,8,55,43,106
890,0.18,"(24, 2)","(5, 3)",11,96,89,196,12,73,65,150
891,0.08,"(7, 29)","(0, 2)",4,111,94,209,14,169,163,346
892,0.1,"(25, 27)","(21, 19)",3,51,42,96,4,125,109,238
893,0.04,"(26, 18)","(28, 4)",42,131,137,310,7,105,92,204
894,0.08,"(26, 0)","(13, 24)",17,186,163,366,7,102,89,198
895,0.02,"(20, 15)","(24, 4)",7,236,190,433,11,140,131,282
896,0.2,"(24, 18)","(3, 26)",5,251,230,486,7,93,80,180
897,0.1,"(27, 8)","(24, 9)",6,66,40,112,3,35,9,47
898,0.04,"(0, 21)","(1, 16)",2,66,30,98,3,36,18,57
899,0.1,"(18, 11)","(27, 28)",11,96,83,190,6,206,192,404
900,0.16,"(0, 21)","(19, 18)",5,91,76,172,13,67,60,140
901,0.04,"(7, 24)","(11, 8)",7,136,121,264,12,80,72,164
902,0.12,"(2, 12)","(10, 2)",4,66,49,119,6,97,83,186
903,0.02,"(1, 26)","(21, 16)",6,126,96,228,9,95,84,188
904,0.02,"(20, 19)","(15, 3)",4,141,87,232,81,143,204,428
905,0.14,"(7, 29)","(9, 11)",3,61,43,107,4,129,113,246
906,0.06,"(9, 17)","(16, 20)",10,81,70,161,4,78,62,144
907,0.16,"(15, 1)","(28, 29)",6,106,86,198,11,118,109,238
908,0.04,"(22, 28)","(23, 6)",5,71,58,134,4,72,56,132
909,0.2,"(27, 29)","(28, 8)",12,156,142,310,6,98,84,188
910,0.14,"(22, 20)","(28, 26)",8,76,73,157,5,103,88,196
911,0.08,"(20, 9)","(3, 16)",4,116,91,211,6,104,90,200
912,0.16,"(12, 23)","(2, 9)",6,86,74,166,8,136,124,268
913,0.12,"(29, 18)","(20, 25)",5,76,59,140,21,69,70,160
914,0.2,"(26, 20)","(25, 15)",6,66,59,131,16,43,37,96
915,0.12,"(15, 18)","(24, 21)",8,36,31,75,15,68,63,146
916,0.2,"(28, 7)","(3, 26)",3,86,74,163,5,119,104,228
917,0.12,"(9, 4)","(3, 16)",24,81,88,193,8,73,61,142
918,0.18,"(8, 2)","(2, 19)",4,136,122,262,4,99,83,186
919,0.06,"(16, 19)","(21, 0)",4,76,67,147,5,129,114,248
920,0.1,"(13, 17)","(19, 2)",9,121,109,239,9,123,112,244
921,0.14,"(8, 12)","(20, 28)",13,66,67,146,7,276,263,546
922,0.16,"(15, 10)","(20, 12)",5,51,44,100,7,57,42,106
923,0.08,"(5, 12)","(11, 17)",3,66,45,114,6,66,52,124
924,0.06,"(29, 23)","(13, 21)",10,101,80,191,12,67,57,136
925,0.12,"(20, 2)","(17, 8)",7,46,28,81,4,52,35,91
926,0.12,"(12, 14)","(2, 14)",7,106,102,215,18,47,45,110
927,0.2,"(27, 7)","(7, 1)",6,101,92,199,13,441,434,888
928,0.18,"(17, 11)","(6, 21)",6,121,109,236,3,54,37,94
929,0.12,"(13, 12)","(29, 7)",9,66,52,127,7,130,117,254
930,0.18,"(27, 4)","(18, 28)",7,161,150,318,9,92,81,182
931,0.12,"(21, 5)","(2, 0)",9,86,73,168,3,103,86,192
932,0.16,"(14, 23)","(9, 3)",5,111,101,217,9,101,90,200
933,0.02,"(21, 11)","(20, 17)",6,141,84,231,6,62,46,114
934,0.04,"(5, 2)","(5, 4)",6,41,25,72,4,16,5,25
935,0.08,"(4, 2)","(10, 12)",5,166,135,306,16,87,83,186
936,0.06,"(8, 21)","(21, 4)",18,91,95,204,14,103,97,214
937,0.12,"(2, 20)","(0, 12)",5,66,55,126,2,121,103,226
938,0.06,"(13, 11)","(11, 12)",5,36,17,58,13,33,19,65
939,0.06,"(2, 0)","(25, 9)",18,91,92,201,10,138,128,276
940,0.18,"(16, 11)","(26, 11)",3,131,118,252,3,67,50,120
941,0.08,"(10, 9)","(19, 8)",5,76,52,133,30,114,124,268
942,0.2,"(0, 23)","(1, 10)",9,76,68,153,5,107,92,204
943,0.04,"(2, 27)","(0, 2)",17,81,79,177,6,81,67,154
944,0.12,"(2, 17)","(16, 23)",24,91,91,206,13,100,93,206
945,0.18,"(6, 13)","(12, 12)",5,96,72,173,10,83,73,166
946,0.1,"(6, 13)","(0, 20)",5,86,73,164,5,78,62,145
947,0.18,"(28, 5)","(25, 28)",5,106,93,204,4,104,88,196
948,0.2,"(15, 4)","(22, 6)",6,71,53,130,3,69,52,124
949,0.18,"(12, 26)","(2, 17)",7,61,50,118,4,53,37,94
950,0.06,"(23, 19)","(5, 6)",7,136,110,253,8,72,60,140
951,0.18,"(3, 1)","(14, 10)",9,66,61,136,4,82,66,152
952,0.2,"(14, 21)","(0, 25)",10,71,70,151,9,252,241,502
953,0.06,"(27, 20)","(12, 6)",11,121,107,239,6,81,67,154
954,0.02,"(1, 23)","(6, 16)",5,91,75,171,7,52,39,98
955,0.1,"(25, 13)","(22, 17)",9,46,40,95,11,50,41,102
956,0.08,"(0, 27)","(29, 7)",4,91,80,175,9,190,179,378
957,0.18,"(13, 0)","(28, 13)",7,96,86,189,7,176,163,346
958,0.18,"(0, 2)","(9, 16)",7,61,53,121,3,46,29,78
959,0.1,"(16, 11)","(3, 23)",13,101,97,211,7,143,130,280
960,0.06,"(19, 0)","(26, 16)",10,151,135,296,6,104,90,200
961,0.14,"(4, 0)","(5, 22)",12,51,51,114,6,78,64,148
962,0.1,"(16, 22)","(18, 11)",9,106,99,214,5,142,127,274
963,0.2,"(21, 4)","(24, 3)",4,36,21,61,7,55,38,100
964,0.1,"(4, 28)","(26, 27)",3,91,75,169,4,65,49,118
965,0.06,"(19, 0)","(8, 22)",5,96,89,190,4,89,73,166
966,0.04,"(6, 9)","(28, 17)",4,91,74,169,9,161,150,320
967,0.02,"(5, 13)","(3, 0)",5,86,73,164,4,119,103,226
968,0.14,"(10, 21)","(15, 6)",8,121,114,243,11,130,121,262
969,0.12,"(28, 19)","(7, 0)",5,91,74,170,10,76,66,152
970,0.16,"(0, 6)","(21, 23)",16,96,94,206,6,71,57,134
971,0.04,"(25, 13)","(16, 27)",3,96,63,162,5,63,48,116
972,0.02,"(23, 0)","(23, 27)",6,166,122,294,9,82,71,162
973,0.08,"(22, 8)","(18, 2)",5,71,48,124,8,79,67,154
974,0.04,"(4, 8)","(20, 5)",3,81,65,149,4,117,101,222
975,0.18,"(12, 22)","(11, 21)",25,51,55,131,8,16,11,35
976,0.2,"(5, 29)","(2, 25)",7,41,23,71,9,33,20,62
977,0.14,"(28, 21)","(20, 28)",11,106,98,215,6,78,64,148
978,0.06,"(24, 18)","(28, 1)",8,131,123,262,7,92,79,178
979,0.18,"(17, 29)","(27, 22)",10,61,50,121,4,146,130,280
980,0.18,"(11, 12)","(24, 25)",4,151,136,291,11,71,62,144
981,0.06,"(21, 18)","(21, 7)",10,91,90,191,3,166,149,318
982,0.2,"(2, 26)","(20, 0)",9,66,54,129,7,106,93,206
983,0.08,"(12, 21)","(7, 1)",12,86,87,185,4,63,47,114
984,0.06,"(28, 16)","(3, 7)",6,111,90,207,6,90,76,172
985,0.18,"(26, 28)","(16, 29)",5,61,50,116,10,34,24,68
986,0.12,"(24, 25)","(22, 23)",4,46,27,77,11,16,13,40
987,0.08,"(11, 20)","(23, 26)",5,111,95,211,7,56,43,106
988,0.08,"(10, 27)","(1, 17)",15,71,56,142,6,53,39,98
989,0.1,"(20, 15)","(28, 12)",8,56,46,110,3,69,52,124
990,0.12,"(26, 6)","(25, 13)",6,26,14,46,4,53,37,94
991,0.1,"(19, 19)","(18, 10)",5,91,71,167,14,69,63,146
992,0.2,"(13, 7)","(16, 11)",3,86,77,166,2,62,44,108
993,0.1,"(3, 6)","(1, 21)",5,71,55,131,6,73,59,138
994,0.1,"(11, 29)","(29, 27)",10,126,111,247,8,217,205,430
995,0.16,"(17, 7)","(1, 3)",9,96,89,194,3,295,278,576
996,0.2,"(29, 24)","(4, 29)",5,126,117,248,4,122,106,232
997,0.2,"(18, 16)","(0, 7)",7,56,48,111,6,64,50,120
998,0.18,"(23, 24)","(8, 19)",9,86,80,175,3,92,75,170
999,0.2,"(21, 18)","(12, 27)",8,156,145,309,3,123,106,232
,,,,8.054,99.985,84.521,192.56,8.318,104.328,92.339,204.985
