0,0.08,"(10, 16)","(24, 13)",5,126,62,193,6,142,115,263
1,0.2,"(5, 12)","(25, 7)",3,116,51,170,6,106,79,191
2,0.08,"(27, 7)","(16, 21)",7,86,43,136,13,152,132,297
3,0.14,"(9, 5)","(8, 12)",3,116,45,164,16,78,61,155
4,0.04,"(29, 24)","(14, 20)",2,116,57,175,2,77,46,125
5,0.06,"(12, 4)","(20, 27)",10,126,66,202,4,110,81,195
6,0.06,"(26, 24)","(22, 13)",4,86,41,131,3,58,28,89
7,0.2,"(12, 14)","(11, 26)",6,156,70,232,6,72,45,123
8,0.18,"(19, 15)","(24, 16)",6,66,31,103,3,70,40,113
9,0.2,"(12, 15)","(9, 7)",6,86,41,133,7,57,31,95
10,0.06,"(6, 21)","(22, 14)",5,236,111,352,4,99,70,173
11,0.12,"(22, 22)","(26, 1)",6,186,84,276,4,75,46,125
12,0.2,"(2, 3)","(17, 27)",7,376,188,571,6,97,70,173
13,0.1,"(8, 6)","(5, 23)",7,106,50,163,10,142,119,271
14,0.18,"(3, 9)","(8, 24)",13,96,51,160,4,69,40,113
15,0.18,"(21, 1)","(14, 27)",6,136,63,205,6,141,114,261
16,0.14,"(10, 28)","(28, 19)",18,136,74,228,8,128,103,239
17,0.14,"(26, 7)","(24, 6)",5,46,18,69,5,49,17,71
18,0.1,"(27, 4)","(8, 14)",6,186,86,278,11,86,64,161
19,0.1,"(6, 29)","(10, 4)",6,206,101,313,3,143,113,259
20,0.06,"(9, 8)","(23, 10)",5,206,83,294,10,118,95,223
21,0.02,"(23, 0)","(9, 7)",10,276,101,387,5,85,57,147
22,0.02,"(15, 10)","(14, 12)",11,56,31,98,4,81,51,136
23,0.02,"(23, 1)","(11, 24)",4,156,70,230,12,187,166,365
24,0.06,"(24, 6)","(11, 26)",6,146,63,215,7,94,68,169
25,0.04,"(26, 5)","(1, 3)",9,166,77,252,5,141,113,259
26,0.06,"(17, 16)","(21, 26)",14,166,69,249,8,96,71,175
27,0.18,"(20, 11)","(23, 15)",19,86,56,161,7,81,55,143
28,0.16,"(15, 10)","(4, 24)",12,296,151,459,4,92,63,159
29,0.14,"(27, 12)","(27, 26)",7,86,39,132,6,165,138,309
30,0.16,"(2, 19)","(27, 10)",9,136,61,206,9,113,89,211
31,0.06,"(1, 27)","(10, 25)",5,166,77,248,11,134,112,257
32,0.12,"(23, 17)","(6, 16)",6,136,60,202,6,130,103,239
33,0.08,"(23, 13)","(11, 24)",7,156,74,237,6,135,108,249
34,0.14,"(22, 2)","(23, 26)",5,196,100,301,10,122,99,231
35,0.18,"(3, 6)","(18, 6)",4,126,61,191,22,91,80,193
36,0.16,"(17, 20)","(22, 5)",20,166,85,271,12,91,70,173
37,0.14,"(25, 4)","(2, 26)",14,306,154,474,8,98,73,179
38,0.08,"(15, 20)","(27, 23)",6,186,81,273,12,69,48,129
39,0.14,"(18, 22)","(25, 0)",6,236,116,358,14,124,105,243
40,0.08,"(8, 23)","(25, 8)",3,216,94,313,8,120,95,223
41,0.14,"(10, 3)","(27, 3)",15,96,51,162,9,82,58,149
42,0.08,"(28, 23)","(16, 22)",5,96,43,144,9,71,47,127
43,0.06,"(15, 10)","(14, 7)",9,36,16,61,6,43,16,65
44,0.02,"(6, 6)","(18, 6)",5,306,146,457,8,89,64,161
45,0.1,"(6, 5)","(21, 22)",8,186,86,280,8,96,71,175
46,0.06,"(17, 9)","(8, 8)",3,116,33,152,13,44,24,81
47,0.12,"(27, 28)","(23, 12)",7,106,54,167,10,138,115,263
48,0.08,"(14, 17)","(6, 14)",10,206,94,310,6,75,48,129
49,0.02,"(13, 18)","(21, 22)",6,146,58,210,5,92,64,161
50,0.14,"(14, 15)","(29, 24)",6,156,77,239,4,72,43,119
51,0.06,"(8, 3)","(21, 5)",7,106,55,168,4,144,115,263
52,0.2,"(27, 17)","(29, 14)",5,96,47,148,6,76,49,131
53,0.08,"(17, 5)","(4, 11)",8,156,71,235,15,66,48,129
54,0.08,"(22, 26)","(26, 18)",8,136,55,199,44,113,124,281
55,0.1,"(12, 17)","(15, 5)",15,126,75,216,5,60,32,97
56,0.02,"(7, 2)","(17, 13)",2,216,81,299,3,87,57,147
57,0.08,"(23, 6)","(16, 2)",22,76,51,149,15,77,59,151
58,0.18,"(24, 16)","(18, 25)",7,66,33,106,10,104,81,195
59,0.16,"(29, 10)","(7, 27)",7,156,80,243,5,119,91,215
60,0.18,"(27, 3)","(0, 0)",6,126,58,190,9,125,101,235
61,0.04,"(29, 27)","(14, 21)",5,106,47,158,6,80,53,139
62,0.18,"(0, 1)","(27, 5)",8,186,94,288,4,97,68,169
63,0.02,"(17, 0)","(16, 0)",7,46,15,68,7,42,10,59
64,0.04,"(29, 16)","(15, 27)",11,146,79,236,5,124,96,225
65,0.02,"(7, 10)","(1, 29)",20,186,88,294,11,127,105,243
66,0.18,"(23, 2)","(24, 3)",6,46,13,65,6,66,38,110
67,0.16,"(27, 7)","(5, 14)",6,186,88,280,5,118,90,213
68,0.04,"(20, 2)","(2, 18)",6,166,64,236,12,167,146,325
69,0.06,"(29, 20)","(1, 19)",5,126,57,188,7,112,86,205
70,0.1,"(3, 3)","(9, 25)",6,126,62,194,8,94,69,171
71,0.06,"(29, 3)","(5, 20)",5,156,68,229,4,92,63,159
72,0.12,"(20, 16)","(14, 27)",9,136,74,219,4,109,80,193
73,0.06,"(26, 18)","(14, 11)",4,136,57,197,4,183,154,341
74,0.06,"(20, 13)","(0, 28)",31,96,72,199,11,107,85,203
75,0.08,"(9, 15)","(11, 3)",13,76,41,130,7,105,79,191
76,0.2,"(24, 27)","(4, 24)",4,116,58,178,6,186,159,351
77,0.08,"(22, 28)","(0, 6)",7,176,86,269,6,146,119,271
78,0.04,"(0, 7)","(26, 2)",4,86,42,132,18,102,87,207
79,0.06,"(5, 1)","(21, 14)",28,266,140,434,19,126,112,257
80,0.14,"(0, 17)","(4, 5)",5,276,126,407,13,52,32,97
81,0.08,"(1, 29)","(6, 20)",4,96,34,134,14,73,54,141
82,0.02,"(15, 28)","(6, 5)",6,146,64,216,9,156,132,297
83,0.06,"(9, 22)","(14, 29)",9,86,47,142,5,96,68,169
84,0.04,"(13, 13)","(9, 27)",10,106,52,168,5,169,141,315
85,0.1,"(4, 9)","(13, 9)",5,126,55,186,4,83,54,141
86,0.2,"(13, 21)","(9, 23)",5,96,40,141,11,67,45,123
87,0.04,"(25, 10)","(9, 7)",8,76,41,125,12,127,106,245
88,0.04,"(20, 9)","(22, 12)",6,96,30,132,7,79,47,133
89,0.14,"(4, 23)","(12, 28)",9,116,58,183,6,60,33,99
90,0.12,"(12, 21)","(29, 3)",7,156,68,231,12,112,91,215
91,0.16,"(3, 15)","(22, 6)",6,196,91,293,15,98,80,193
92,0.2,"(12, 13)","(15, 3)",7,96,40,143,5,93,65,163
93,0.16,"(25, 21)","(11, 5)",22,136,81,239,6,107,80,193
94,0.16,"(4, 17)","(5, 13)",7,86,38,131,4,47,14,65
95,0.02,"(8, 0)","(7, 3)",3,26,6,35,3,52,22,77
96,0.02,"(3, 11)","(22, 12)",11,276,125,412,9,95,71,175
97,0.2,"(6, 4)","(4, 11)",5,56,26,87,4,42,13,59
98,0.16,"(28, 4)","(17, 2)",7,156,78,241,11,84,62,157
99,0.12,"(15, 5)","(18, 24)",3,156,75,234,5,73,45,123
100,0.12,"(23, 8)","(23, 17)",5,236,109,350,5,123,95,223
101,0.18,"(11, 3)","(22, 23)",4,136,60,200,6,132,105,243
102,0.14,"(0, 16)","(28, 26)",2,146,68,216,3,88,58,149
103,0.14,"(14, 29)","(18, 8)",5,226,101,332,5,88,60,153
104,0.02,"(7, 17)","(17, 18)",5,166,72,243,9,165,141,315
105,0.2,"(3, 27)","(0, 16)",5,146,73,224,10,56,33,99
106,0.2,"(0, 12)","(24, 16)",17,166,92,275,8,88,63,159
107,0.2,"(3, 4)","(15, 3)",5,236,110,351,8,99,74,181
108,0.2,"(0, 6)","(24, 28)",5,226,115,346,4,79,50,133
109,0.12,"(0, 23)","(9, 26)",7,106,49,162,2,92,61,155
110,0.1,"(29, 3)","(16, 13)",2,136,59,197,3,84,54,141
111,0.1,"(11, 17)","(4, 1)",9,176,71,256,5,140,112,257
112,0.06,"(22, 7)","(18, 10)",5,76,33,114,5,72,44,121
113,0.1,"(7, 2)","(13, 25)",10,176,89,275,10,159,136,305
114,0.04,"(26, 19)","(7, 20)",5,256,125,386,29,77,73,179
115,0.06,"(9, 16)","(11, 24)",7,96,48,151,7,63,37,107
116,0.1,"(5, 2)","(6, 13)",5,106,45,156,3,72,42,117
117,0.04,"(4, 29)","(0, 13)",4,136,63,203,7,57,31,95
118,0.16,"(20, 24)","(21, 16)",6,76,30,112,7,79,53,139
119,0.2,"(13, 0)","(26, 24)",8,266,130,404,8,132,107,247
120,0.02,"(27, 6)","(5, 6)",8,286,117,411,9,220,196,425
121,0.04,"(7, 0)","(12, 10)",5,126,55,186,4,128,99,231
122,0.06,"(8, 12)","(5, 16)",8,66,23,97,8,92,67,167
123,0.1,"(12, 23)","(4, 12)",9,196,97,302,6,70,43,119
124,0.18,"(24, 14)","(13, 0)",4,136,67,207,18,190,175,383
125,0.12,"(16, 28)","(25, 3)",9,186,95,290,4,92,63,159
126,0.14,"(25, 16)","(24, 22)",12,66,32,110,5,80,52,137
127,0.12,"(25, 10)","(5, 7)",20,146,79,245,14,79,60,153
128,0.04,"(11, 27)","(18, 18)",4,166,72,242,14,126,107,247
129,0.18,"(20, 3)","(29, 2)",3,96,41,140,6,86,59,151
130,0.02,"(25, 16)","(24, 29)",4,166,69,239,5,144,116,265
131,0.08,"(7, 12)","(29, 13)",5,136,64,205,15,102,84,201
132,0.18,"(17, 22)","(25, 26)",8,156,75,239,13,63,43,119
133,0.18,"(25, 25)","(23, 26)",12,26,18,56,9,59,35,103
134,0.14,"(9, 2)","(3, 29)",5,156,72,233,8,134,109,251
135,0.12,"(28, 12)","(8, 14)",7,166,77,250,7,99,73,179
136,0.08,"(13, 27)","(20, 12)",11,156,73,240,5,105,77,187
137,0.02,"(12, 15)","(28, 14)",6,296,132,434,5,103,75,183
138,0.02,"(0, 22)","(19, 18)",5,276,104,385,6,99,72,177
139,0.1,"(1, 25)","(20, 23)",4,116,55,175,13,94,74,181
140,0.04,"(8, 22)","(9, 7)",8,176,74,258,9,70,46,125
141,0.1,"(16, 23)","(21, 3)",5,196,89,290,14,147,128,289
142,0.04,"(14, 11)","(28, 20)",6,166,71,243,4,134,105,243
143,0.14,"(17, 27)","(12, 1)",17,106,60,183,9,96,72,177
144,0.18,"(17, 18)","(16, 5)",4,156,64,224,5,68,40,113
145,0.2,"(18, 3)","(29, 27)",7,116,61,184,5,132,104,241
146,0.16,"(11, 9)","(5, 23)",6,106,48,160,5,73,45,123
147,0.02,"(11, 28)","(5, 27)",3,146,50,199,4,42,13,59
148,0.14,"(14, 8)","(13, 25)",6,86,45,137,4,82,53,139
149,0.02,"(8, 24)","(13, 17)",6,276,102,384,14,77,58,149
150,0.08,"(27, 27)","(7, 18)",5,206,83,294,15,126,108,249
151,0.08,"(6, 27)","(5, 6)",3,106,48,157,14,137,118,269
152,0.14,"(8, 4)","(5, 5)",4,1,4,9,13,67,47,127
153,0.16,"(9, 0)","(26, 5)",7,86,47,140,9,91,67,167
154,0.2,"(26, 26)","(20, 11)",13,76,44,133,6,90,63,159
155,0.02,"(19, 25)","(20, 7)",7,256,123,386,10,71,48,129
156,0.14,"(8, 24)","(6, 3)",6,96,51,153,10,83,60,153
157,0.12,"(16, 27)","(8, 7)",4,116,49,169,8,140,115,263
158,0.08,"(20, 2)","(12, 4)",4,36,19,59,4,66,37,107
159,0.14,"(17, 9)","(29, 1)",8,96,46,150,7,76,50,133
160,0.18,"(3, 25)","(22, 28)",16,376,184,576,7,126,100,233
161,0.1,"(19, 1)","(6, 28)",3,206,98,307,18,129,114,261
162,0.14,"(10, 28)","(6, 8)",8,166,81,255,4,98,69,171
163,0.14,"(14, 21)","(3, 7)",4,156,68,228,6,61,34,101
164,0.06,"(1, 24)","(13, 25)",5,226,92,323,8,68,43,119
165,0.2,"(5, 8)","(24, 12)",14,196,104,314,6,125,98,229
166,0.2,"(24, 12)","(6, 2)",9,136,70,215,5,132,104,241
167,0.08,"(6, 9)","(16, 12)",9,76,38,123,16,106,89,211
168,0.2,"(19, 12)","(24, 13)",15,86,50,151,4,71,42,117
169,0.1,"(5, 9)","(21, 6)",26,126,76,228,4,156,127,287
170,0.02,"(28, 8)","(1, 28)",3,136,57,196,5,80,52,137
171,0.2,"(12, 13)","(19, 18)",15,96,59,170,5,89,61,155
172,0.16,"(1, 29)","(24, 11)",4,206,97,307,9,126,102,237
173,0.2,"(14, 7)","(23, 13)",7,126,63,196,7,128,102,237
174,0.06,"(10, 27)","(4, 2)",10,176,85,271,5,145,117,267
175,0.08,"(2, 12)","(23, 17)",7,106,53,166,3,156,126,285
176,0.1,"(13, 1)","(3, 13)",5,76,33,114,10,80,57,147
177,0.12,"(29, 28)","(8, 15)",4,96,49,149,4,82,53,139
178,0.18,"(0, 5)","(4, 19)",5,206,89,300,5,90,62,157
179,0.14,"(25, 28)","(29, 15)",3,86,41,130,4,93,64,161
180,0.08,"(8, 28)","(13, 28)",3,106,50,159,7,66,38,111
181,0.04,"(22, 29)","(25, 5)",1,286,120,407,1,132,100,233
182,0.2,"(25, 1)","(15, 25)",10,146,75,231,5,143,115,263
183,0.1,"(0, 4)","(20, 12)",3,136,64,203,4,111,82,197
184,0.2,"(19, 6)","(18, 25)",7,176,88,271,4,115,86,205
185,0.06,"(20, 2)","(0, 1)",6,96,47,149,7,130,104,241
186,0.16,"(4, 22)","(19, 23)",7,116,50,173,9,108,84,201
187,0.04,"(11, 28)","(0, 10)",5,116,55,176,7,61,35,103
188,0.06,"(24, 18)","(26, 14)",5,76,38,119,8,60,35,103
189,0.2,"(20, 2)","(1, 14)",16,86,49,151,7,114,88,209
190,0.18,"(8, 22)","(20, 11)",24,106,63,193,10,116,93,219
191,0.12,"(13, 6)","(8, 17)",7,66,35,108,10,84,61,155
192,0.04,"(20, 15)","(9, 29)",7,156,70,233,16,193,176,385
193,0.14,"(10, 0)","(13, 9)",3,146,66,215,9,95,71,175
194,0.12,"(7, 7)","(15, 1)",4,176,77,257,13,151,131,295
195,0.2,"(21, 6)","(9, 26)",4,146,60,210,10,104,81,195
196,0.16,"(1, 11)","(26, 8)",4,156,78,238,3,109,79,191
197,0.08,"(14, 18)","(15, 29)",17,306,157,480,4,61,32,97
198,0.1,"(29, 20)","(29, 5)",2,156,60,218,2,69,38,109
199,0.08,"(15, 13)","(17, 8)",6,86,46,138,12,50,27,89
200,0.04,"(28, 6)","(15, 0)",3,126,60,189,5,75,47,127
201,0.1,"(21, 8)","(4, 10)",8,126,63,197,4,142,113,259
202,0.08,"(3, 21)","(11, 26)",10,156,81,247,5,97,69,171
203,0.16,"(21, 1)","(8, 21)",12,126,66,204,5,104,76,185
204,0.18,"(27, 16)","(16, 15)",5,66,31,102,9,63,39,111
205,0.04,"(15, 8)","(22, 7)",13,66,39,118,10,138,112,260
206,0.06,"(9, 6)","(2, 2)",15,86,45,146,23,211,201,435
207,0.1,"(26, 2)","(26, 27)",7,146,71,224,8,114,89,211
208,0.1,"(0, 25)","(27, 28)",4,266,122,392,6,108,81,195
209,0.04,"(29, 7)","(28, 2)",5,156,56,217,6,58,30,94
210,0.18,"(27, 1)","(12, 0)",10,96,51,157,2,86,55,143
211,0.08,"(13, 1)","(16, 5)",4,116,34,154,4,100,71,175
212,0.2,"(11, 17)","(20, 20)",14,146,81,241,10,88,65,163
213,0.12,"(10, 3)","(27, 5)",4,116,47,167,4,74,45,123
214,0.1,"(9, 29)","(17, 12)",3,136,51,190,17,97,81,195
215,0.06,"(17, 0)","(22, 5)",3,106,46,155,9,88,64,161
216,0.18,"(0, 7)","(3, 8)",5,66,26,97,11,21,12,44
217,0.02,"(14, 18)","(29, 21)",4,326,117,447,8,143,118,269
218,0.04,"(1, 22)","(21, 25)",10,236,103,349,6,90,63,159
219,0.04,"(11, 19)","(21, 16)",7,156,64,227,6,91,64,161
220,0.06,"(2, 6)","(15, 2)",10,116,58,184,4,125,96,225
221,0.02,"(15, 2)","(9, 28)",5,136,66,207,7,126,100,233
222,0.2,"(6, 2)","(4, 0)",4,26,12,42,17,60,43,120
223,0.1,"(21, 27)","(8, 21)",6,86,41,133,7,92,66,165
224,0.14,"(24, 5)","(1, 27)",21,146,78,245,6,75,48,129
225,0.16,"(27, 4)","(16, 11)",5,106,52,163,6,88,61,155
226,0.02,"(5, 21)","(18, 12)",10,76,45,131,7,151,125,283
227,0.18,"(25, 21)","(22, 0)",11,316,162,489,7,104,78,189
228,0.04,"(13, 4)","(19, 13)",5,156,71,232,6,101,74,181
229,0.08,"(9, 25)","(28, 22)",3,66,33,102,11,127,105,243
230,0.04,"(20, 1)","(13, 17)",6,96,47,149,6,96,69,171
231,0.16,"(11, 11)","(4, 28)",12,146,79,237,9,163,139,311
232,0.1,"(7, 18)","(0, 29)",8,266,126,400,8,134,109,251
233,0.08,"(28, 9)","(7, 16)",12,76,43,131,3,102,72,177
234,0.02,"(22, 18)","(8, 26)",10,136,49,195,11,84,62,157
235,0.1,"(8, 21)","(10, 10)",8,176,91,275,6,134,107,247
236,0.08,"(19, 9)","(13, 29)",6,136,63,205,18,129,114,261
237,0.2,"(0, 27)","(6, 16)",5,76,33,114,3,56,26,85
238,0.1,"(15, 25)","(23, 9)",7,156,72,235,5,84,56,145
239,0.1,"(3, 14)","(11, 28)",6,136,63,205,13,137,117,267
240,0.12,"(11, 4)","(12, 2)",13,86,49,148,7,62,36,105
241,0.02,"(25, 6)","(26, 17)",4,216,88,308,8,110,85,203
242,0.04,"(8, 3)","(14, 2)",8,66,34,108,7,59,33,99
243,0.16,"(10, 14)","(11, 23)",5,176,80,261,8,77,52,137
244,0.2,"(4, 16)","(28, 6)",4,176,77,257,14,94,75,183
245,0.18,"(29, 10)","(14, 4)",6,86,40,132,5,134,106,245
246,0.08,"(7, 11)","(3, 5)",4,66,28,98,4,96,67,167
247,0.12,"(12, 21)","(14, 21)",21,76,49,146,7,21,8,36
248,0.14,"(25, 8)","(10, 13)",5,86,45,136,5,55,27,87
249,0.08,"(19, 27)","(29, 14)",8,106,54,168,4,98,69,171
250,0.14,"(5, 29)","(26, 19)",4,116,45,165,6,101,74,181
251,0.08,"(14, 8)","(8, 23)",25,286,156,467,8,74,49,131
252,0.12,"(22, 11)","(1, 26)",9,166,89,264,8,85,60,153
253,0.12,"(29, 9)","(22, 4)",4,106,46,156,4,99,70,173
254,0.08,"(10, 22)","(2, 17)",11,66,34,111,20,130,117,267
255,0.12,"(5, 22)","(24, 18)",8,186,96,290,4,130,101,235
256,0.04,"(17, 6)","(6, 24)",4,96,49,149,12,70,49,131
257,0.1,"(16, 14)","(2, 27)",9,116,49,174,20,66,53,139
258,0.1,"(7, 29)","(0, 13)",28,156,87,271,5,122,94,221
259,0.1,"(29, 4)","(10, 14)",6,136,65,207,5,105,77,187
260,0.14,"(21, 19)","(6, 16)",10,46,27,83,29,82,78,189
261,0.14,"(13, 20)","(15, 11)",4,126,52,182,3,65,35,103
262,0.16,"(15, 11)","(28, 15)",4,166,81,251,9,172,148,329
263,0.16,"(1, 29)","(17, 6)",3,126,55,184,5,127,99,231
264,0.06,"(23, 9)","(19, 12)",12,46,30,88,5,102,74,181
265,0.14,"(7, 15)","(17, 28)",6,66,32,104,5,58,30,93
266,0.02,"(7, 12)","(16, 21)",4,166,63,233,5,69,41,115
267,0.02,"(7, 4)","(15, 21)",26,206,106,338,9,122,98,229
268,0.06,"(21, 11)","(0, 26)",21,116,64,201,15,74,56,145
269,0.12,"(27, 11)","(24, 25)",10,136,69,215,12,77,56,145
270,0.04,"(3, 0)","(12, 9)",5,96,32,133,13,135,115,263
271,0.16,"(23, 16)","(11, 19)",5,106,49,160,33,64,64,161
272,0.12,"(5, 16)","(26, 22)",10,166,85,261,7,83,57,147
273,0.16,"(2, 13)","(14, 3)",8,206,108,322,14,122,103,239
274,0.18,"(15, 15)","(19, 21)",7,86,45,138,5,91,63,159
275,0.18,"(0, 12)","(21, 27)",5,116,56,177,17,122,106,245
276,0.12,"(8, 24)","(25, 14)",12,106,60,178,3,101,71,175
277,0.06,"(3, 22)","(15, 7)",6,86,42,134,10,77,54,141
278,0.18,"(12, 19)","(11, 26)",9,56,30,95,13,53,33,99
279,0.12,"(23, 15)","(22, 19)",6,66,29,101,4,86,57,147
280,0.04,"(9, 0)","(12, 12)",13,186,80,279,4,176,147,327
281,0.04,"(22, 0)","(5, 0)",5,86,37,128,3,73,43,119
282,0.1,"(14, 9)","(28, 2)",12,116,66,194,7,106,80,193
283,0.12,"(27, 3)","(10, 10)",7,106,45,158,6,85,58,149
284,0.16,"(17, 7)","(5, 14)",4,186,85,275,7,149,123,279
285,0.16,"(17, 13)","(24, 5)",8,166,84,258,12,120,99,231
286,0.18,"(0, 10)","(4, 9)",9,26,19,54,5,56,28,89
287,0.04,"(22, 5)","(10, 14)",5,156,70,231,10,105,82,197
288,0.14,"(0, 13)","(11, 19)",18,166,94,278,17,174,158,349
289,0.18,"(25, 12)","(18, 15)",4,66,32,102,11,70,48,129
290,0.04,"(25, 7)","(2, 0)",7,166,83,256,7,108,82,197
291,0.1,"(23, 25)","(19, 5)",6,126,58,190,10,85,62,157
292,0.02,"(25, 18)","(15, 19)",5,256,95,356,5,117,89,211
293,0.18,"(6, 29)","(14, 13)",13,116,63,192,3,77,47,127
294,0.18,"(13, 16)","(4, 0)",6,166,78,250,5,165,137,307
295,0.04,"(10, 18)","(0, 28)",6,196,75,277,8,111,86,205
296,0.12,"(13, 14)","(26, 17)",11,96,52,159,29,154,150,333
297,0.14,"(3, 11)","(12, 1)",4,66,33,103,5,116,88,209
298,0.12,"(28, 24)","(28, 29)",8,86,44,138,6,67,39,112
299,0.02,"(27, 11)","(28, 29)",14,296,145,455,5,148,120,273
300,0.02,"(19, 4)","(26, 14)",4,216,94,314,7,115,89,211
301,0.14,"(5, 15)","(2, 19)",5,76,29,110,10,71,48,129
302,0.2,"(10, 22)","(16, 28)",5,226,112,343,8,60,35,103
303,0.16,"(16, 25)","(22, 19)",7,76,40,123,22,64,53,139
304,0.04,"(3, 2)","(6, 1)",5,46,11,62,6,55,28,89
305,0.02,"(13, 11)","(9, 2)",6,196,80,282,14,95,76,185
306,0.08,"(0, 3)","(19, 14)",7,96,45,148,3,98,68,169
307,0.08,"(0, 14)","(6, 17)",5,166,65,236,4,74,44,122
308,0.1,"(28, 9)","(6, 3)",6,186,87,279,11,147,125,283
309,0.18,"(19, 3)","(0, 21)",15,176,96,287,18,142,127,287
310,0.06,"(24, 20)","(15, 21)",8,36,21,65,5,47,19,71
311,0.14,"(8, 4)","(1, 1)",12,106,52,170,5,110,82,197
312,0.04,"(25, 21)","(3, 11)",25,136,75,236,16,115,98,229
313,0.04,"(2, 21)","(1, 28)",6,36,15,57,21,81,69,171
314,0.06,"(18, 11)","(19, 17)",5,76,30,111,6,82,55,143
315,0.2,"(23, 4)","(13, 1)",5,76,36,117,6,103,76,185
316,0.06,"(13, 17)","(10, 1)",4,176,79,259,9,86,62,157
317,0.04,"(4, 16)","(4, 3)",4,186,75,265,5,74,46,125
318,0.08,"(22, 20)","(13, 29)",14,246,126,386,5,215,187,407
319,0.2,"(17, 17)","(2, 10)",10,166,80,256,3,93,63,159
320,0.2,"(25, 21)","(5, 14)",10,156,76,242,4,106,77,187
321,0.14,"(13, 18)","(14, 17)",6,46,16,68,9,58,32,99
322,0.18,"(9, 2)","(7, 22)",17,146,83,246,15,153,135,303
323,0.12,"(25, 23)","(14, 3)",6,266,129,401,7,116,90,213
324,0.2,"(2, 1)","(18, 6)",4,96,49,149,4,110,81,195
325,0.2,"(13, 29)","(0, 4)",5,146,68,219,12,124,103,239
326,0.04,"(7, 25)","(4, 28)",7,156,70,233,4,53,24,81
327,0.18,"(16, 5)","(25, 18)",5,196,95,296,7,132,106,245
328,0.02,"(19, 23)","(26, 3)",10,366,145,521,8,188,163,359
329,0.18,"(14, 24)","(9, 12)",8,116,58,182,9,64,40,113
330,0.02,"(27, 29)","(7, 4)",15,236,129,380,5,107,79,191
331,0.2,"(29, 7)","(14, 12)",8,106,56,170,7,163,137,307
332,0.04,"(20, 28)","(29, 28)",5,86,42,133,13,86,66,165
333,0.16,"(7, 22)","(27, 11)",6,126,63,195,10,119,96,225
334,0.12,"(4, 0)","(1, 4)",5,36,11,52,6,45,18,69
335,0.08,"(22, 20)","(9, 1)",5,216,103,324,17,220,204,441
336,0.08,"(8, 5)","(4, 28)",12,246,129,387,8,101,76,185
337,0.04,"(5, 8)","(10, 25)",4,146,65,215,3,148,118,269
338,0.18,"(23, 12)","(10, 7)",3,86,37,126,3,68,38,109
339,0.16,"(13, 16)","(8, 11)",4,46,24,74,4,47,18,69
340,0.2,"(15, 5)","(0, 8)",6,116,54,176,10,158,135,303
341,0.16,"(9, 23)","(4, 23)",7,26,17,50,13,43,23,79
342,0.2,"(5, 10)","(3, 28)",13,56,38,107,3,124,94,221
343,0.06,"(15, 26)","(27, 24)",9,126,62,197,14,107,88,209
344,0.12,"(26, 19)","(9, 15)",12,136,67,215,8,149,124,281
345,0.1,"(18, 24)","(2, 17)",6,156,66,228,8,82,57,147
346,0.1,"(22, 5)","(0, 22)",17,86,53,156,5,85,57,147
347,0.08,"(27, 19)","(7, 25)",7,166,79,252,6,130,103,239
348,0.04,"(21, 29)","(29, 22)",15,166,79,260,10,78,55,143
349,0.08,"(1, 4)","(21, 7)",13,116,61,190,11,134,112,257
350,0.04,"(15, 7)","(3, 21)",10,126,53,189,5,132,104,241
351,0.06,"(14, 17)","(26, 8)",4,106,52,162,12,84,63,159
352,0.16,"(26, 27)","(27, 8)",4,96,45,145,7,72,46,125
353,0.18,"(0, 24)","(21, 25)",14,196,105,315,11,141,119,271
354,0.08,"(26, 13)","(28, 24)",6,116,58,180,7,62,36,105
355,0.02,"(19, 11)","(13, 10)",10,176,69,255,4,21,10,35
356,0.02,"(0, 0)","(23, 22)",3,136,62,201,4,111,82,197
357,0.06,"(5, 22)","(7, 8)",6,116,50,172,11,102,80,193
358,0.02,"(8, 11)","(9, 14)",7,116,56,179,8,127,102,237
359,0.1,"(26, 15)","(6, 26)",7,156,74,237,11,129,107,247
360,0.12,"(24, 23)","(5, 11)",7,126,67,200,5,85,57,147
361,0.08,"(0, 11)","(6, 6)",6,126,62,194,39,60,66,165
362,0.18,"(21, 19)","(6, 13)",5,206,102,313,8,106,81,195
363,0.12,"(23, 10)","(3, 13)",8,166,79,253,11,77,55,143
364,0.12,"(24, 22)","(0, 28)",5,86,45,136,7,88,62,157
365,0.1,"(6, 2)","(14, 25)",5,296,136,437,4,216,187,407
366,0.16,"(16, 7)","(11, 21)",4,246,117,367,4,110,81,195
367,0.02,"(9, 13)","(13, 28)",6,206,87,299,9,73,49,131
368,0.08,"(8, 0)","(1, 16)",13,76,42,131,8,72,47,127
369,0.08,"(26, 24)","(20, 2)",6,126,58,190,11,121,99,231
370,0.18,"(23, 20)","(29, 20)",10,126,66,202,9,86,62,157
371,0.16,"(19, 21)","(25, 17)",14,156,85,255,5,110,82,197
372,0.12,"(8, 1)","(24, 0)",9,76,40,125,3,74,44,121
373,0.2,"(2, 2)","(10, 3)",8,46,28,82,6,49,22,77
374,0.12,"(2, 15)","(21, 6)",4,186,86,276,6,97,70,173
375,0.08,"(20, 25)","(6, 12)",7,126,54,187,8,80,55,143
376,0.16,"(6, 16)","(27, 14)",4,106,43,153,11,99,77,187
377,0.18,"(15, 18)","(15, 21)",16,26,24,66,7,69,39,115
378,0.16,"(12, 27)","(23, 0)",4,156,75,235,4,74,45,123
379,0.12,"(2, 24)","(21, 29)",3,156,73,232,5,139,111,255
380,0.08,"(7, 25)","(4, 27)",4,66,27,97,11,57,34,102
381,0.02,"(25, 2)","(26, 28)",10,186,78,274,6,124,97,227
382,0.06,"(11, 7)","(26, 1)",15,156,82,253,3,114,84,201
383,0.02,"(8, 12)","(17, 10)",8,326,143,477,3,114,84,201
384,0.2,"(18, 7)","(2, 11)",5,106,47,158,7,98,72,177
385,0.18,"(2, 10)","(5, 19)",9,176,85,270,8,63,38,109
386,0.1,"(21, 11)","(28, 3)",4,106,43,153,4,122,93,219
387,0.18,"(20, 24)","(5, 5)",19,186,105,310,11,123,101,235
388,0.1,"(16, 20)","(1, 29)",17,146,75,238,6,131,104,241
389,0.16,"(5, 3)","(8, 26)",4,176,86,266,4,179,150,333
390,0.12,"(6, 28)","(25, 7)",5,116,58,179,7,101,75,183
391,0.12,"(24, 8)","(28, 2)",7,126,63,196,6,78,51,135
392,0.04,"(2, 24)","(26, 17)",6,226,104,336,12,155,134,301
393,0.08,"(12, 26)","(16, 28)",9,66,34,109,3,102,72,177
394,0.16,"(19, 28)","(15, 25)",9,76,28,113,3,48,18,69
395,0.2,"(17, 8)","(20, 3)",5,86,37,128,5,95,67,167
396,0.1,"(3, 16)","(27, 18)",5,166,80,251,7,133,107,247
397,0.14,"(6, 28)","(2, 3)",6,136,62,204,9,108,84,201
398,0.14,"(20, 3)","(11, 14)",5,86,41,132,9,125,101,235
399,0.1,"(13, 4)","(26, 9)",4,116,52,172,13,117,97,227
400,0.12,"(24, 14)","(18, 21)",5,66,32,103,17,103,87,207
401,0.18,"(10, 20)","(3, 20)",10,46,23,79,9,71,43,123
402,0.02,"(29, 2)","(8, 4)",5,196,73,274,9,77,53,139
403,0.16,"(0, 3)","(15, 8)",4,86,34,124,16,127,110,253
404,0.18,"(19, 9)","(29, 20)",10,136,71,217,13,146,126,285
405,0.16,"(4, 28)","(8, 19)",6,56,31,93,10,98,75,183
406,0.02,"(17, 19)","(18, 10)",5,176,83,264,9,109,85,203
407,0.14,"(9, 28)","(28, 13)",14,166,88,268,6,115,88,209
408,0.1,"(1, 8)","(20, 11)",14,166,87,267,6,128,101,235
409,0.2,"(12, 0)","(28, 6)",6,116,58,180,3,90,60,153
410,0.14,"(17, 17)","(9, 11)",10,56,27,93,5,89,61,155
411,0.14,"(1, 18)","(5, 25)",6,206,98,310,7,106,80,193
412,0.16,"(7, 4)","(26, 9)",8,136,65,209,4,121,92,217
413,0.06,"(8, 26)","(5, 20)",6,56,22,84,11,62,40,113
414,0.06,"(20, 20)","(9, 26)",3,186,84,273,23,66,56,145
415,0.14,"(24, 24)","(19, 19)",9,96,43,148,3,93,63,159
416,0.14,"(13, 7)","(27, 16)",9,156,81,246,12,97,76,185
417,0.18,"(14, 19)","(29, 26)",9,236,117,362,6,138,111,255
418,0.16,"(25, 19)","(24, 24)",5,56,16,77,6,44,17,67
419,0.08,"(5, 15)","(10, 20)",12,96,42,150,7,100,74,181
420,0.18,"(1, 6)","(15, 14)",11,176,84,271,4,97,68,169
421,0.1,"(20, 11)","(20, 4)",5,96,43,144,8,68,43,119
422,0.2,"(20, 14)","(5, 16)",11,96,51,158,8,82,57,147
423,0.1,"(2, 7)","(13, 20)",12,156,83,251,13,97,77,187
424,0.12,"(5, 22)","(15, 19)",23,76,52,151,6,81,54,141
425,0.2,"(0, 23)","(0, 24)",8,1,8,17,6,21,8,35
426,0.14,"(6, 4)","(10, 0)",22,86,52,160,7,98,72,177
427,0.1,"(16, 9)","(2, 1)",7,146,71,224,5,70,42,117
428,0.18,"(5, 22)","(16, 12)",7,86,43,136,8,136,111,255
429,0.12,"(0, 5)","(26, 15)",4,156,66,226,4,135,106,245
430,0.2,"(16, 3)","(5, 28)",5,106,55,166,9,143,119,271
431,0.02,"(5, 3)","(5, 28)",8,216,95,319,4,158,129,291
432,0.06,"(29, 3)","(13, 13)",7,196,88,291,9,130,106,245
433,0.04,"(13, 15)","(5, 5)",9,156,72,237,4,170,141,315
434,0.12,"(7, 12)","(7, 19)",7,36,22,65,5,49,20,74
435,0.1,"(16, 22)","(20, 9)",9,166,75,250,17,129,113,259
436,0.08,"(11, 22)","(24, 5)",9,156,68,233,25,135,127,287
437,0.12,"(3, 2)","(10, 23)",10,106,53,169,13,122,102,237
438,0.1,"(8, 6)","(12, 5)",10,76,39,125,7,72,43,122
439,0.14,"(23, 28)","(10, 22)",5,86,44,135,8,82,57,147
440,0.08,"(20, 27)","(12, 21)",8,76,38,122,18,59,44,121
441,0.08,"(14, 2)","(19, 1)",10,86,46,142,8,158,133,299
442,0.12,"(28, 14)","(17, 2)",7,106,50,163,7,86,60,153
443,0.2,"(29, 25)","(26, 8)",6,226,112,344,6,92,65,163
444,0.16,"(9, 5)","(4, 11)",5,46,23,74,6,73,46,125
445,0.04,"(26, 7)","(2, 6)",11,346,168,525,5,133,105,243
446,0.06,"(10, 1)","(16, 2)",4,86,36,126,4,67,38,109
447,0.14,"(3, 7)","(23, 0)",6,226,112,344,6,166,139,311
448,0.06,"(9, 14)","(14, 4)",14,116,64,194,13,164,144,321
449,0.06,"(19, 19)","(15, 28)",12,156,81,249,5,69,41,115
450,0.04,"(2, 12)","(10, 18)",3,166,73,242,5,114,86,205
451,0.2,"(17, 23)","(16, 23)",7,26,12,45,6,45,15,66
452,0.14,"(1, 10)","(22, 5)",5,146,65,216,5,114,86,205
453,0.16,"(21, 4)","(26, 14)",21,146,89,256,13,80,60,153
454,0.04,"(14, 29)","(23, 11)",15,226,100,341,16,181,164,361
455,0.02,"(3, 0)","(9, 29)",8,156,77,241,7,147,121,275
456,0.2,"(17, 18)","(15, 24)",5,186,86,277,6,63,36,105
457,0.16,"(17, 9)","(26, 21)",12,206,107,325,3,107,77,187
458,0.18,"(15, 19)","(12, 24)",5,56,27,88,6,67,38,111
459,0.2,"(28, 2)","(13, 14)",15,106,58,179,4,163,134,301
460,0.04,"(5, 6)","(24, 17)",7,156,67,230,7,153,127,287
461,0.1,"(29, 1)","(6, 6)",7,126,57,190,4,69,40,113
462,0.06,"(23, 29)","(20, 16)",8,176,82,266,5,62,34,101
463,0.2,"(7, 13)","(15, 5)",9,96,48,153,16,117,100,233
464,0.16,"(29, 16)","(27, 20)",12,46,28,86,5,145,117,267
465,0.18,"(3, 24)","(29, 12)",11,166,87,264,8,127,102,237
466,0.14,"(0, 7)","(17, 26)",8,196,95,299,4,100,71,175
467,0.1,"(4, 26)","(22, 16)",4,106,47,157,7,98,72,177
468,0.12,"(29, 8)","(14, 26)",30,196,108,334,20,133,120,273
469,0.2,"(29, 28)","(23, 25)",4,56,17,77,24,41,32,97
470,0.16,"(17, 1)","(22, 13)",11,116,59,186,9,76,52,137
471,0.04,"(29, 19)","(1, 21)",2,126,58,186,10,97,74,181
472,0.2,"(27, 7)","(6, 5)",4,126,63,193,8,140,115,263
473,0.16,"(22, 12)","(1, 17)",5,206,92,303,10,74,51,135
474,0.14,"(29, 17)","(5, 10)",11,76,46,133,21,130,118,269
475,0.04,"(3, 28)","(22, 29)",8,106,52,166,24,139,130,293
476,0.02,"(8, 24)","(12, 3)",4,246,104,354,12,171,150,333
477,0.12,"(18, 2)","(17, 5)",6,56,30,92,6,52,25,83
478,0.18,"(10, 27)","(4, 25)",5,86,45,136,3,55,25,83
479,0.02,"(29, 28)","(21, 11)",5,106,41,152,7,197,171,375
480,0.18,"(19, 19)","(1, 0)",7,156,72,235,12,77,56,145
481,0.18,"(2, 15)","(8, 3)",5,46,25,76,6,79,52,137
482,0.2,"(28, 29)","(2, 15)",5,126,60,191,10,101,78,189
483,0.18,"(15, 8)","(22, 29)",5,166,75,246,7,110,84,201
484,0.06,"(16, 16)","(15, 13)",8,26,18,52,11,74,52,137
485,0.1,"(22, 6)","(2, 7)",9,146,67,222,5,59,31,95
486,0.02,"(12, 27)","(6, 3)",16,176,96,288,12,146,125,283
487,0.06,"(23, 28)","(20, 25)",15,26,18,59,23,48,34,105
488,0.08,"(9, 26)","(8, 6)",4,136,59,199,5,83,55,143
489,0.18,"(29, 4)","(8, 18)",7,126,61,194,8,163,138,309
490,0.2,"(16, 15)","(17, 12)",11,86,47,144,24,66,57,147
491,0.1,"(8, 7)","(16, 3)",12,136,74,222,4,78,49,131
492,0.02,"(20, 23)","(2, 26)",9,256,99,364,7,167,141,315
493,0.02,"(20, 7)","(11, 0)",5,256,106,367,6,216,189,411
494,0.2,"(13, 14)","(24, 13)",4,196,97,297,5,109,81,195
495,0.1,"(23, 14)","(29, 28)",4,166,78,248,5,68,40,113
496,0.18,"(27, 21)","(21, 28)",6,106,51,163,3,53,23,79
497,0.04,"(26, 9)","(0, 20)",7,136,64,207,5,75,47,127
498,0.1,"(13, 6)","(18, 1)",8,56,33,97,9,107,83,199
499,0.12,"(15, 21)","(18, 3)",7,126,64,197,9,73,49,131
500,0.06,"(28, 7)","(27, 6)",6,176,69,251,4,41,6,51
501,0.1,"(8, 21)","(28, 20)",5,146,75,226,4,150,121,275
502,0.06,"(4, 27)","(22, 13)",9,186,84,279,11,115,93,219
503,0.16,"(1, 12)","(24, 28)",6,176,84,266,15,76,58,149
504,0.1,"(18, 24)","(11, 28)",12,76,44,132,6,55,28,89
505,0.06,"(8, 24)","(9, 0)",7,136,66,209,42,140,149,331
506,0.18,"(4, 12)","(15, 8)",5,96,45,146,6,137,110,253
507,0.1,"(6, 20)","(24, 23)",5,106,47,158,6,109,82,197
508,0.06,"(2, 18)","(15, 16)",2,116,47,165,3,88,58,149
509,0.16,"(6, 5)","(28, 26)",10,186,88,284,7,159,133,299
510,0.12,"(23, 26)","(9, 5)",9,166,86,261,5,100,72,177
511,0.06,"(1, 16)","(21, 23)",7,146,61,214,5,123,95,223
512,0.14,"(1, 1)","(29, 12)",4,186,94,284,4,126,97,227
513,0.2,"(6, 17)","(8, 8)",20,86,51,157,9,106,82,197
514,0.08,"(19, 23)","(3, 18)",6,106,52,164,7,109,83,199
515,0.14,"(9, 24)","(10, 5)",6,116,58,180,7,91,65,163
516,0.02,"(15, 17)","(27, 2)",6,106,55,167,4,72,43,119
517,0.16,"(1, 13)","(6, 0)",3,56,28,87,11,136,114,261
518,0.2,"(2, 16)","(13, 1)",6,186,89,281,5,64,36,105
519,0.04,"(1, 22)","(9, 2)",34,136,90,260,21,97,85,203
520,0.18,"(23, 20)","(18, 2)",10,146,73,229,6,153,126,285
521,0.08,"(2, 4)","(7, 10)",3,36,18,57,3,58,28,89
522,0.02,"(21, 20)","(4, 8)",7,516,215,738,6,113,86,205
523,0.06,"(21, 18)","(7, 7)",8,216,111,335,4,94,65,163
524,0.1,"(19, 3)","(28, 25)",9,166,86,261,7,83,57,147
525,0.2,"(18, 19)","(22, 26)",4,96,41,141,7,127,101,235
526,0.08,"(25, 28)","(11, 1)",10,116,61,187,10,116,93,219
527,0.2,"(12, 20)","(4, 2)",11,546,273,830,8,104,79,191
528,0.1,"(9, 19)","(21, 13)",10,116,49,175,7,93,67,167
529,0.06,"(18, 24)","(11, 13)",13,76,42,131,11,56,34,101
530,0.1,"(1, 17)","(17, 1)",6,176,86,268,10,67,44,121
531,0.08,"(26, 2)","(2, 23)",7,96,52,155,16,103,86,205
532,0.08,"(1, 23)","(10, 27)",3,126,54,183,7,65,39,111
533,0.08,"(12, 10)","(10, 25)",7,166,71,244,5,73,45,123
534,0.16,"(13, 21)","(2, 4)",7,136,68,211,14,132,113,259
535,0.1,"(28, 12)","(17, 15)",7,96,49,152,7,83,57,147
536,0.06,"(29, 27)","(16, 18)",8,126,51,185,5,91,63,159
537,0.12,"(14, 22)","(21, 28)",6,106,49,161,6,85,58,149
538,0.04,"(2, 21)","(20, 15)",3,166,73,242,4,91,62,157
539,0.2,"(10, 14)","(17, 29)",5,216,108,329,3,75,45,123
540,0.12,"(11, 23)","(2, 25)",4,126,56,186,7,59,33,99
541,0.14,"(18, 9)","(7, 3)",5,116,56,177,12,136,115,263
542,0.02,"(16, 4)","(22, 23)",10,296,145,451,11,99,77,187
543,0.04,"(12, 28)","(16, 3)",10,256,135,401,6,169,142,317
544,0.18,"(24, 5)","(6, 7)",4,166,77,247,5,112,84,201
545,0.2,"(9, 24)","(8, 27)",22,46,36,104,5,70,42,117
546,0.12,"(14, 3)","(18, 4)",5,66,28,99,9,86,62,157
547,0.12,"(9, 22)","(10, 29)",16,126,67,209,23,58,48,129
548,0.1,"(13, 11)","(29, 19)",6,126,60,192,17,137,121,275
549,0.12,"(27, 23)","(13, 19)",6,206,102,314,8,98,73,179
550,0.06,"(5, 22)","(3, 17)",5,76,31,112,14,82,61,157
551,0.18,"(15, 25)","(29, 11)",14,196,101,311,8,121,96,225
552,0.04,"(25, 13)","(16, 5)",7,136,57,200,16,136,119,271
553,0.1,"(22, 6)","(10, 23)",8,176,84,268,7,129,103,239
554,0.06,"(28, 26)","(25, 8)",7,126,53,186,7,102,76,185
555,0.2,"(6, 11)","(29, 15)",13,136,76,225,5,94,66,165
556,0.16,"(6, 13)","(2, 23)",27,136,91,254,9,103,79,191
557,0.12,"(28, 19)","(18, 20)",19,86,59,164,15,50,32,97
558,0.14,"(5, 20)","(12, 13)",17,76,50,143,4,79,50,133
559,0.2,"(7, 11)","(15, 6)",10,86,46,142,5,50,22,77
560,0.14,"(15, 18)","(11, 24)",20,106,63,189,9,141,117,267
561,0.2,"(17, 5)","(15, 16)",4,116,53,173,5,100,72,177
562,0.06,"(17, 13)","(10, 21)",11,136,60,207,23,53,43,119
563,0.2,"(0, 18)","(9, 5)",10,106,51,167,3,114,84,201
564,0.16,"(23, 24)","(28, 5)",5,216,104,325,14,128,109,251
565,0.16,"(0, 27)","(14, 4)",9,116,61,186,7,143,117,267
566,0.2,"(27, 22)","(27, 9)",7,276,131,414,15,59,41,115
567,0.12,"(6, 1)","(8, 5)",13,186,99,298,5,107,77,189
568,0.16,"(21, 19)","(5, 5)",19,96,54,169,13,65,45,123
569,0.12,"(10, 13)","(3, 0)",12,136,68,216,8,145,120,273
570,0.12,"(1, 29)","(25, 24)",2,116,52,170,7,103,77,187
571,0.04,"(24, 24)","(0, 25)",7,126,66,199,4,211,182,397
572,0.18,"(11, 0)","(6, 23)",17,156,86,259,7,104,78,189
573,0.2,"(25, 1)","(9, 3)",9,76,38,123,6,102,75,183
574,0.12,"(14, 27)","(4, 29)",4,116,53,173,7,102,76,185
575,0.18,"(23, 17)","(6, 1)",2,206,84,292,8,123,98,229
576,0.1,"(29, 22)","(18, 22)",5,66,25,96,9,103,79,191
577,0.1,"(16, 6)","(5, 1)",8,176,78,262,5,58,30,93
578,0.14,"(9, 15)","(15, 17)",4,106,54,164,8,68,43,119
579,0.12,"(29, 9)","(18, 16)",4,56,23,83,8,50,25,83
580,0.18,"(23, 26)","(17, 24)",6,36,18,60,6,61,34,101
581,0.02,"(11, 22)","(14, 20)",12,166,69,247,7,86,60,153
582,0.02,"(11, 10)","(9, 22)",3,206,91,300,7,121,95,223
583,0.2,"(11, 3)","(5, 7)",15,66,43,124,4,79,50,133
584,0.08,"(15, 11)","(13, 10)",14,26,17,57,10,21,11,42
585,0.1,"(7, 19)","(1, 3)",7,136,61,204,10,101,78,189
586,0.06,"(21, 0)","(4, 20)",9,166,70,245,2,126,95,223
587,0.1,"(8, 7)","(22, 19)",4,126,61,191,7,109,83,199
588,0.12,"(29, 19)","(22, 17)",10,86,35,131,21,66,54,141
589,0.12,"(5, 29)","(14, 29)",4,76,31,111,13,63,43,119
590,0.04,"(16, 4)","(18, 13)",6,316,146,468,9,108,84,201
591,0.02,"(3, 16)","(13, 26)",17,186,88,291,3,234,204,441
592,0.1,"(24, 6)","(21, 18)",11,66,37,114,9,87,63,159
593,0.14,"(28, 9)","(25, 1)",4,136,65,205,4,120,91,215
594,0.16,"(6, 15)","(11, 8)",4,96,41,141,35,89,91,215
595,0.18,"(29, 19)","(6, 14)",10,116,51,177,14,98,79,191
596,0.1,"(6, 23)","(18, 29)",3,206,98,307,5,93,65,163
597,0.06,"(2, 4)","(0, 17)",8,106,57,171,6,135,108,249
598,0.08,"(11, 17)","(24, 10)",12,166,90,268,5,120,92,217
599,0.12,"(8, 9)","(12, 29)",6,176,90,272,17,97,81,195
600,0.04,"(11, 18)","(20, 12)",7,216,77,300,6,118,91,215
601,0.18,"(5, 27)","(3, 5)",7,226,106,339,16,111,94,221
602,0.02,"(23, 26)","(9, 18)",13,196,83,292,20,238,225,483
603,0.02,"(11, 28)","(19, 12)",14,186,92,292,14,179,160,353
604,0.2,"(26, 4)","(9, 23)",5,116,56,177,3,129,99,231
605,0.12,"(29, 26)","(7, 16)",3,196,97,296,8,117,92,217
606,0.1,"(0, 28)","(7, 1)",8,226,107,341,11,129,107,247
607,0.06,"(16, 4)","(14, 20)",14,136,75,225,5,110,82,197
608,0.04,"(26, 21)","(12, 12)",4,276,120,400,12,113,92,217
609,0.02,"(9, 29)","(2, 2)",5,216,92,313,9,111,87,207
610,0.18,"(24, 28)","(8, 5)",5,116,56,177,4,109,80,193
611,0.18,"(19, 15)","(9, 0)",13,236,119,368,5,113,85,203
612,0.06,"(4, 18)","(16, 20)",7,106,50,163,16,80,63,159
613,0.04,"(18, 8)","(27, 11)",6,216,102,324,5,93,65,163
614,0.02,"(12, 5)","(5, 20)",5,266,100,371,4,199,170,373
615,0.08,"(6, 17)","(22, 28)",15,226,121,362,9,72,48,129
616,0.14,"(11, 29)","(11, 6)",16,116,68,200,8,153,128,289
617,0.06,"(7, 3)","(23, 14)",24,186,95,305,13,126,106,245
618,0.14,"(7, 24)","(1, 17)",7,66,31,104,6,51,24,81
619,0.2,"(7, 14)","(23, 10)",5,116,59,180,8,173,148,329
620,0.06,"(3, 2)","(7, 20)",9,106,46,161,5,99,71,175
621,0.02,"(25, 22)","(21, 1)",5,196,82,283,3,327,297,627
622,0.2,"(5, 17)","(11, 27)",27,76,55,158,11,145,123,279
623,0.02,"(2, 8)","(20, 21)",4,186,85,275,15,264,246,525
624,0.14,"(23, 20)","(26, 17)",6,76,36,118,9,54,28,91
625,0.14,"(18, 3)","(21, 14)",5,116,57,178,5,79,51,135
626,0.16,"(19, 26)","(8, 28)",8,56,26,90,12,116,95,223
627,0.12,"(4, 10)","(6, 13)",4,86,33,123,11,81,59,151
628,0.06,"(24, 6)","(0, 3)",7,226,93,326,9,130,106,245
629,0.16,"(20, 25)","(4, 10)",6,96,44,146,13,67,47,127
630,0.12,"(12, 4)","(21, 24)",11,106,57,174,3,90,60,153
631,0.2,"(29, 2)","(3, 28)",6,196,91,293,18,89,74,181
632,0.04,"(20, 9)","(6, 25)",17,276,119,412,12,76,55,143
633,0.06,"(7, 15)","(2, 2)",14,126,58,198,8,98,73,179
634,0.2,"(7, 20)","(0, 18)",13,56,28,97,5,59,31,95
635,0.04,"(18, 21)","(20, 19)",4,76,30,110,8,101,76,185
636,0.08,"(8, 4)","(23, 21)",7,186,82,275,8,88,63,159
637,0.04,"(14, 21)","(19, 3)",8,136,67,211,7,77,51,135
638,0.2,"(3, 19)","(22, 2)",9,106,55,170,10,71,48,129
639,0.04,"(2, 8)","(28, 16)",5,196,89,290,6,152,125,283
640,0.02,"(3, 15)","(10, 16)",4,136,37,177,5,70,41,116
641,0.02,"(25, 20)","(16, 14)",10,256,100,366,7,47,21,75
642,0.04,"(8, 4)","(7, 23)",4,126,52,182,11,63,41,115
643,0.06,"(9, 1)","(8, 8)",8,136,57,201,8,56,29,93
644,0.18,"(27, 26)","(13, 19)",9,76,37,122,7,71,45,123
645,0.14,"(20, 3)","(18, 27)",8,146,68,222,6,134,107,247
646,0.02,"(21, 1)","(19, 25)",9,356,171,536,5,123,95,223
647,0.12,"(15, 24)","(7, 23)",6,46,26,78,15,51,33,99
648,0.16,"(8, 15)","(2, 19)",10,66,33,109,6,88,61,155
649,0.2,"(15, 4)","(2, 5)",9,156,78,243,6,95,68,169
650,0.12,"(29, 15)","(13, 18)",12,116,61,189,8,70,45,123
651,0.1,"(10, 13)","(9, 0)",5,86,38,129,10,80,57,147
652,0.2,"(10, 26)","(0, 3)",14,206,113,333,10,148,125,283
653,0.06,"(4, 2)","(24, 8)",6,176,82,264,3,146,116,265
654,0.08,"(29, 5)","(15, 8)",8,86,37,131,26,69,62,157
655,0.1,"(19, 15)","(6, 0)",6,146,72,224,6,141,114,261
656,0.14,"(6, 4)","(22, 12)",11,126,63,200,5,115,87,207
657,0.04,"(4, 19)","(6, 1)",5,126,50,181,9,133,109,251
658,0.12,"(2, 29)","(23, 4)",14,196,103,313,7,82,56,145
659,0.04,"(17, 16)","(4, 2)",8,286,136,430,14,122,103,239
660,0.16,"(29, 17)","(3, 22)",13,166,87,266,5,78,50,133
661,0.1,"(29, 29)","(16, 6)",4,166,79,249,5,136,108,249
662,0.06,"(29, 26)","(7, 7)",36,146,99,281,5,124,96,225
663,0.04,"(18, 27)","(19, 2)",8,236,108,352,4,120,91,215
664,0.12,"(4, 28)","(24, 18)",5,126,62,193,4,184,155,343
665,0.16,"(27, 24)","(4, 19)",3,126,56,185,4,64,35,103
666,0.18,"(4, 24)","(13, 6)",5,176,82,263,6,136,109,251
667,0.2,"(6, 25)","(11, 6)",5,136,66,207,7,110,84,201
668,0.06,"(2, 20)","(16, 6)",5,96,45,146,12,114,93,219
669,0.18,"(15, 6)","(26, 28)",14,176,90,280,10,85,62,157
670,0.16,"(23, 17)","(20, 28)",5,66,33,104,7,60,34,101
671,0.02,"(27, 24)","(23, 5)",7,236,110,353,9,90,66,165
672,0.18,"(20, 6)","(12, 25)",17,96,58,171,9,148,124,281
673,0.04,"(1, 20)","(17, 0)",8,146,65,219,4,153,124,281
674,0.04,"(20, 4)","(15, 22)",7,366,157,530,9,194,170,373
675,0.18,"(24, 22)","(28, 23)",16,76,44,136,11,74,49,134
676,0.06,"(17, 19)","(26, 4)",5,156,63,224,6,98,71,175
677,0.08,"(9, 0)","(21, 27)",6,216,88,310,3,148,118,269
678,0.16,"(23, 17)","(20, 12)",9,76,38,123,9,69,45,123
679,0.2,"(14, 3)","(8, 15)",14,106,58,178,20,81,68,169
680,0.12,"(20, 16)","(2, 6)",8,296,139,443,11,208,186,405
681,0.06,"(15, 7)","(20, 25)",12,216,115,343,17,118,102,237
682,0.16,"(11, 16)","(24, 2)",6,96,39,141,4,110,81,195
683,0.18,"(24, 11)","(18, 29)",4,226,110,340,7,157,131,295
684,0.08,"(3, 6)","(22, 7)",4,166,72,242,3,90,60,153
685,0.12,"(10, 6)","(24, 1)",8,236,116,360,16,154,137,307
686,0.02,"(12, 13)","(12, 15)",10,56,29,95,4,75,46,125
687,0.12,"(12, 18)","(29, 22)",5,126,61,192,5,145,117,267
688,0.08,"(6, 4)","(7, 12)",10,116,58,184,4,93,64,161
689,0.12,"(11, 29)","(13, 14)",5,96,42,143,25,105,97,227
690,0.12,"(9, 22)","(4, 24)",3,56,18,77,3,59,29,91
691,0.1,"(8, 5)","(2, 27)",15,266,138,419,10,79,56,145
692,0.04,"(17, 24)","(0, 2)",8,126,62,196,12,78,57,147
693,0.02,"(13, 2)","(8, 3)",3,46,12,61,6,119,92,217
694,0.16,"(5, 12)","(14, 23)",8,146,65,219,15,110,92,217
695,0.14,"(11, 28)","(18, 7)",7,106,53,166,6,118,91,215
696,0.06,"(17, 10)","(2, 15)",10,246,113,369,5,129,101,235
697,0.08,"(10, 27)","(29, 13)",15,126,71,212,7,150,124,281
698,0.06,"(3, 6)","(14, 1)",6,76,32,114,5,128,100,233
699,0.02,"(27, 19)","(14, 4)",3,166,60,229,4,101,72,177
700,0.14,"(28, 29)","(8, 0)",6,236,120,362,7,101,75,183
701,0.12,"(1, 19)","(25, 14)",5,106,51,162,8,112,87,207
702,0.16,"(8, 17)","(7, 20)",4,46,22,72,3,50,17,70
703,0.2,"(18, 28)","(28, 14)",13,246,127,386,10,85,62,157
704,0.06,"(16, 27)","(12, 0)",8,246,108,362,9,157,133,299
705,0.04,"(29, 9)","(1, 28)",6,146,61,213,5,86,58,149
706,0.08,"(25, 12)","(15, 1)",5,136,70,211,17,193,177,387
707,0.06,"(3, 8)","(12, 27)",4,86,40,130,10,65,42,117
708,0.1,"(0, 1)","(24, 6)",13,156,85,254,12,136,115,263
709,0.06,"(28, 13)","(23, 8)",8,166,68,242,4,124,95,223
710,0.14,"(14, 17)","(27, 0)",18,126,77,221,10,168,145,323
711,0.14,"(18, 15)","(19, 4)",7,96,48,151,7,64,38,109
712,0.02,"(25, 19)","(29, 10)",12,116,59,187,8,171,146,325
713,0.18,"(21, 12)","(19, 6)",3,56,22,81,6,76,49,131
714,0.16,"(0, 24)","(19, 3)",7,116,59,182,13,70,50,133
715,0.14,"(17, 22)","(11, 18)",11,96,44,151,44,46,57,147
716,0.12,"(26, 27)","(13, 29)",4,106,46,156,4,63,34,101
717,0.14,"(16, 4)","(27, 12)",5,116,60,181,4,149,120,273
718,0.06,"(15, 12)","(16, 29)",6,156,79,241,21,101,89,211
719,0.14,"(20, 4)","(12, 13)",6,126,57,189,8,89,64,161
720,0.14,"(14, 18)","(0, 10)",6,136,67,209,7,57,31,95
721,0.1,"(14, 16)","(20, 2)",8,116,59,183,16,101,84,201
722,0.1,"(13, 23)","(10, 18)",4,56,24,84,7,107,81,195
723,0.12,"(12, 14)","(18, 11)",9,136,64,209,8,76,49,133
724,0.16,"(22, 15)","(7, 1)",13,176,87,276,11,116,94,221
725,0.16,"(24, 6)","(14, 11)",4,56,22,82,3,99,69,171
726,0.2,"(24, 2)","(17, 17)",6,96,45,147,4,97,68,169
727,0.02,"(13, 25)","(15, 3)",18,226,92,336,45,86,98,229
728,0.16,"(5, 5)","(18, 8)",6,96,44,146,8,89,64,161
729,0.2,"(11, 17)","(27, 3)",7,216,105,328,6,122,95,223
730,0.2,"(4, 17)","(10, 13)",11,186,92,289,16,62,45,123
731,0.16,"(25, 8)","(29, 24)",9,106,49,164,12,72,51,135
732,0.04,"(4, 10)","(18, 2)",10,166,85,261,5,222,194,421
733,0.12,"(11, 19)","(19, 13)",9,116,57,182,11,100,78,189
734,0.12,"(27, 13)","(4, 21)",5,156,74,235,11,90,68,169
735,0.18,"(5, 15)","(4, 4)",6,96,49,151,15,59,41,115
736,0.02,"(24, 27)","(11, 22)",11,166,67,244,6,74,47,127
737,0.2,"(5, 22)","(14, 3)",5,156,80,241,4,124,95,223
738,0.06,"(29, 9)","(25, 0)",4,166,75,245,8,75,50,133
739,0.18,"(25, 8)","(20, 23)",5,96,45,146,9,61,37,107
740,0.12,"(17, 6)","(25, 14)",5,116,56,177,7,82,56,145
741,0.14,"(21, 15)","(6, 12)",16,46,36,98,21,131,119,271
742,0.1,"(21, 12)","(2, 8)",10,56,35,101,4,61,32,97
743,0.08,"(19, 7)","(19, 20)",14,126,69,209,9,98,74,181
744,0.16,"(20, 8)","(24, 9)",8,126,63,197,6,66,39,111
745,0.18,"(0, 3)","(10, 29)",3,86,37,126,5,113,85,203
746,0.02,"(10, 27)","(18, 7)",10,186,90,286,12,95,74,181
747,0.2,"(22, 10)","(22, 2)",7,76,30,113,7,68,42,117
748,0.1,"(16, 11)","(22, 2)",9,106,56,171,7,177,151,335
749,0.14,"(8, 12)","(2, 14)",16,76,43,135,10,43,20,73
750,0.14,"(9, 20)","(8, 29)",9,116,49,174,4,94,65,163
751,0.12,"(0, 19)","(15, 28)",3,96,40,139,4,89,60,153
752,0.1,"(18, 6)","(0, 1)",13,116,64,193,11,117,95,223
753,0.06,"(26, 25)","(0, 21)",7,196,87,290,6,153,126,285
754,0.06,"(1, 21)","(10, 18)",4,86,30,120,7,52,26,85
755,0.08,"(15, 29)","(10, 4)",4,136,60,200,7,69,43,119
756,0.1,"(15, 27)","(18, 6)",7,126,55,188,6,110,83,199
757,0.08,"(16, 15)","(12, 27)",8,196,98,302,17,191,175,383
758,0.2,"(21, 13)","(16, 29)",8,116,49,173,6,230,203,439
759,0.14,"(11, 12)","(8, 15)",4,106,54,164,4,69,40,113
760,0.02,"(10, 26)","(3, 3)",6,166,65,237,11,167,145,323
761,0.04,"(19, 11)","(17, 21)",16,186,81,283,9,126,102,237
762,0.14,"(26, 17)","(11, 10)",9,76,37,122,8,104,79,191
763,0.02,"(1, 1)","(13, 28)",5,196,78,279,6,213,186,405
764,0.2,"(26, 1)","(17, 11)",5,126,54,185,3,66,36,105
765,0.04,"(25, 20)","(8, 5)",10,136,58,204,10,148,125,283
766,0.14,"(19, 10)","(22, 14)",3,56,23,82,4,76,47,127
767,0.2,"(27, 1)","(4, 29)",6,126,64,196,4,134,105,243
768,0.06,"(15, 23)","(12, 29)",5,146,61,212,11,75,53,139
769,0.1,"(8, 22)","(4, 18)",5,56,24,85,6,46,19,71
770,0.16,"(10, 19)","(10, 29)",6,106,51,163,8,139,114,261
771,0.06,"(20, 25)","(11, 15)",13,96,50,159,9,104,80,193
772,0.16,"(3, 12)","(10, 25)",11,96,51,158,11,123,101,235
773,0.08,"(26, 28)","(7, 4)",7,206,103,316,13,111,91,215
774,0.2,"(21, 8)","(4, 16)",6,176,82,264,7,79,53,139
775,0.16,"(14, 1)","(26, 16)",5,186,76,267,6,103,76,185
776,0.16,"(12, 26)","(18, 0)",9,136,67,212,11,150,128,289
777,0.12,"(1, 5)","(11, 6)",5,96,45,146,6,88,61,155
778,0.2,"(19, 26)","(19, 9)",6,66,32,104,22,70,59,151
779,0.02,"(22, 0)","(0, 22)",3,136,59,198,7,97,71,175
780,0.08,"(26, 28)","(1, 5)",11,106,61,178,4,102,73,179
781,0.2,"(28, 0)","(13, 17)",8,86,45,139,6,180,153,339
782,0.14,"(9, 28)","(15, 3)",5,116,54,175,5,118,90,213
783,0.12,"(0, 17)","(14, 8)",21,156,91,268,7,78,52,137
784,0.1,"(14, 11)","(6, 18)",11,146,67,224,3,108,78,189
785,0.2,"(19, 24)","(23, 8)",4,136,54,194,5,105,77,187
786,0.04,"(0, 26)","(4, 4)",16,186,99,301,10,74,51,135
787,0.18,"(29, 22)","(9, 18)",41,176,116,333,5,79,51,135
788,0.12,"(12, 25)","(26, 12)",5,116,53,174,6,106,79,191
789,0.12,"(24, 12)","(22, 24)",7,196,95,298,7,75,49,131
790,0.06,"(2, 10)","(6, 19)",5,66,32,103,6,79,52,137
791,0.2,"(5, 28)","(13, 25)",3,86,33,122,7,97,71,175
792,0.06,"(18, 25)","(9, 0)",5,196,91,292,8,197,172,377
793,0.12,"(27, 0)","(24, 19)",5,126,61,192,6,70,43,119
794,0.14,"(15, 1)","(1, 1)",10,66,36,112,5,118,90,213
795,0.12,"(29, 0)","(25, 13)",3,186,79,268,3,75,45,123
796,0.06,"(29, 16)","(2, 4)",10,246,122,378,5,73,45,123
797,0.14,"(18, 0)","(12, 2)",10,46,20,76,7,49,22,78
798,0.06,"(19, 23)","(29, 21)",5,116,47,168,6,105,78,189
799,0.04,"(15, 23)","(3, 2)",5,146,52,203,5,86,58,149
800,0.12,"(1, 16)","(13, 6)",6,156,73,235,6,140,113,259
801,0.2,"(16, 23)","(8, 13)",21,96,63,180,7,84,58,149
802,0.16,"(9, 4)","(21, 12)",7,106,47,160,4,86,57,147
803,0.14,"(16, 20)","(16, 18)",5,26,9,40,7,44,17,68
804,0.02,"(12, 3)","(6, 3)",9,176,79,264,3,41,10,54
805,0.12,"(1, 20)","(10, 24)",5,76,38,119,4,73,44,121
806,0.14,"(22, 13)","(20, 17)",8,36,20,64,3,78,48,129
807,0.12,"(18, 15)","(29, 16)",6,96,47,149,7,136,110,253
808,0.06,"(7, 0)","(7, 17)",9,86,41,136,9,89,65,163
809,0.2,"(5, 8)","(11, 28)",15,316,162,493,7,60,34,101
810,0.1,"(21, 29)","(8, 28)",9,66,34,109,8,55,30,93
811,0.16,"(21, 24)","(6, 28)",8,176,83,267,6,109,82,197
812,0.16,"(26, 11)","(19, 24)",18,126,74,218,8,138,113,259
813,0.18,"(3, 11)","(5, 11)",9,36,14,59,10,51,28,89
814,0.16,"(8, 23)","(1, 6)",5,156,72,233,6,130,103,239
815,0.16,"(18, 0)","(22, 25)",4,226,110,340,7,129,103,239
816,0.16,"(14, 7)","(15, 20)",4,126,57,187,3,83,53,139
817,0.1,"(0, 18)","(11, 9)",6,186,83,275,7,121,95,223
818,0.2,"(16, 27)","(17, 29)",6,26,9,41,3,64,29,96
819,0.14,"(8, 0)","(0, 18)",6,86,38,130,7,79,53,139
820,0.16,"(16, 5)","(17, 23)",5,256,126,387,7,83,57,147
821,0.12,"(6, 15)","(24, 28)",8,216,100,324,5,117,89,211
822,0.16,"(25, 11)","(18, 2)",7,96,47,150,14,182,163,359
823,0.18,"(25, 12)","(12, 25)",18,166,91,275,18,94,79,191
824,0.08,"(1, 11)","(16, 26)",9,146,75,230,20,126,113,259
825,0.08,"(10, 17)","(12, 28)",5,86,40,131,7,70,44,121
826,0.16,"(13, 20)","(5, 7)",9,136,61,206,7,112,86,205
827,0.02,"(27, 5)","(20, 9)",5,216,75,296,12,101,80,193
828,0.06,"(24, 16)","(25, 0)",3,176,79,258,9,68,44,121
829,0.14,"(6, 14)","(23, 6)",9,106,44,159,9,95,71,175
830,0.16,"(23, 14)","(15, 24)",5,126,65,196,3,105,75,183
831,0.08,"(10, 14)","(6, 16)",6,146,65,217,5,119,91,215
832,0.02,"(17, 17)","(10, 16)",6,126,43,175,8,142,111,261
833,0.02,"(5, 6)","(18, 18)",11,246,106,363,8,96,71,175
834,0.1,"(7, 1)","(17, 16)",18,76,50,144,5,139,111,255
835,0.16,"(2, 26)","(22, 24)",11,166,79,256,9,124,100,233
836,0.04,"(14, 15)","(19, 2)",2,176,72,250,4,71,42,117
837,0.12,"(16, 13)","(9, 28)",3,166,76,245,3,84,54,141
838,0.14,"(8, 20)","(8, 27)",9,236,120,365,6,56,29,91
839,0.08,"(25, 2)","(28, 17)",5,136,58,199,8,138,113,259
840,0.12,"(0, 13)","(13, 12)",13,86,47,146,20,114,101,235
841,0.1,"(18, 22)","(3, 16)",11,116,54,181,6,74,47,127
842,0.18,"(10, 14)","(28, 29)",3,216,102,321,9,121,97,227
843,0.08,"(22, 6)","(4, 20)",6,126,57,189,16,90,73,179
844,0.08,"(3, 12)","(28, 20)",6,186,87,279,9,90,66,165
845,0.1,"(9, 13)","(13, 23)",10,126,65,201,6,108,81,195
846,0.08,"(17, 4)","(20, 29)",4,116,48,168,7,80,54,141
847,0.14,"(7, 6)","(16, 23)",6,136,67,209,3,94,64,161
848,0.2,"(19, 18)","(29, 16)",5,336,167,508,6,98,71,175
849,0.1,"(8, 18)","(14, 0)",5,146,63,214,6,70,43,119
850,0.2,"(0, 27)","(18, 10)",8,146,72,226,10,106,83,199
851,0.16,"(13, 12)","(4, 13)",4,96,44,144,16,87,70,173
852,0.2,"(6, 5)","(5, 22)",10,196,89,295,9,98,74,181
853,0.08,"(14, 21)","(17, 14)",9,136,68,213,11,101,79,191
854,0.16,"(24, 15)","(5, 13)",5,76,36,117,11,62,40,113
855,0.18,"(22, 1)","(21, 1)",8,16,10,34,6,48,21,75
856,0.06,"(11, 24)","(29, 9)",7,146,65,218,4,135,106,245
857,0.02,"(9, 1)","(17, 17)",6,516,231,753,5,210,182,397
858,0.14,"(4, 3)","(17, 8)",11,96,51,158,12,125,104,241
859,0.1,"(23, 4)","(27, 1)",7,176,83,266,6,77,49,132
860,0.1,"(7, 3)","(20, 19)",9,166,80,255,14,124,105,243
861,0.18,"(0, 19)","(24, 4)",6,146,70,222,6,99,72,177
862,0.04,"(1, 15)","(16, 15)",7,126,48,181,13,105,85,203
863,0.14,"(21, 20)","(2, 18)",16,136,79,231,3,60,30,93
864,0.08,"(10, 9)","(15, 29)",5,96,37,138,7,132,106,245
865,0.12,"(29, 23)","(13, 22)",11,146,63,220,8,58,33,99
866,0.16,"(12, 29)","(6, 19)",4,176,85,265,9,73,49,131
867,0.18,"(17, 24)","(19, 27)",13,126,51,190,7,69,41,117
868,0.02,"(11, 16)","(27, 2)",6,196,88,290,7,115,89,211
869,0.06,"(2, 17)","(5, 5)",5,86,41,132,5,68,40,113
870,0.06,"(9, 2)","(11, 0)",7,36,12,55,9,60,34,103
871,0.04,"(0, 10)","(29, 27)",8,156,75,239,10,158,135,303
872,0.06,"(16, 5)","(12, 6)",8,76,39,123,6,64,37,107
873,0.18,"(25, 2)","(25, 17)",6,96,48,150,9,92,68,169
874,0.1,"(22, 9)","(2, 5)",4,206,97,307,9,93,69,171
875,0.06,"(4, 0)","(14, 17)",12,216,103,331,4,130,101,235
876,0.02,"(5, 24)","(3, 19)",5,336,140,481,6,57,30,93
877,0.08,"(9, 18)","(3, 7)",5,236,105,346,4,121,92,217
878,0.08,"(0, 4)","(24, 0)",4,136,60,200,6,127,100,233
879,0.18,"(22, 9)","(21, 15)",8,86,44,138,11,75,53,139
880,0.14,"(1, 25)","(11, 29)",10,86,47,143,4,101,72,177
881,0.02,"(13, 10)","(16, 10)",8,106,57,171,10,118,95,223
882,0.02,"(29, 19)","(6, 22)",5,306,143,454,29,129,125,283
883,0.08,"(3, 13)","(13, 4)",9,156,75,240,5,86,58,149
884,0.16,"(8, 28)","(13, 20)",8,76,33,117,6,75,48,129
885,0.2,"(6, 24)","(27, 14)",6,86,45,137,3,156,126,285
886,0.06,"(20, 4)","(7, 26)",7,126,57,190,6,93,66,165
887,0.06,"(4, 19)","(23, 27)",4,126,52,182,9,83,59,151
888,0.04,"(29, 16)","(23, 7)",6,146,69,221,15,51,33,99
889,0.04,"(6, 14)","(12, 3)",6,216,90,312,9,138,114,261
890,0.2,"(29, 3)","(3, 14)",5,146,71,222,6,120,93,219
891,0.14,"(18, 7)","(3, 3)",4,76,28,108,9,124,100,233
892,0.02,"(3, 0)","(26, 10)",7,316,104,427,4,150,121,275
893,0.12,"(27, 17)","(9, 4)",12,86,52,150,6,87,60,153
894,0.06,"(2, 7)","(18, 14)",6,156,61,223,4,84,55,143
895,0.04,"(9, 28)","(28, 19)",9,236,112,357,6,128,101,235
896,0.02,"(19, 12)","(12, 23)",5,106,37,148,10,154,131,295
897,0.02,"(1, 10)","(8, 16)",6,126,43,175,6,62,35,103
898,0.04,"(22, 2)","(8, 0)",6,186,81,273,6,61,34,101
899,0.02,"(27, 3)","(28, 29)",5,286,139,430,5,82,54,141
900,0.12,"(19, 11)","(28, 10)",8,116,63,187,9,91,67,167
901,0.06,"(29, 5)","(10, 2)",13,146,75,234,17,140,124,281
902,0.1,"(9, 29)","(26, 4)",5,226,99,330,6,112,85,203
903,0.02,"(17, 21)","(25, 15)",4,236,103,343,4,168,139,311
904,0.08,"(18, 23)","(24, 26)",5,126,44,175,6,95,68,169
905,0.1,"(24, 1)","(0, 5)",9,166,81,256,5,160,132,297
906,0.2,"(17, 7)","(20, 23)",3,176,77,256,8,77,52,137
907,0.14,"(13, 23)","(13, 1)",6,176,83,265,10,63,40,113
908,0.14,"(13, 23)","(11, 16)",8,106,53,167,7,96,70,173
909,0.1,"(16, 8)","(12, 17)",4,86,31,121,4,94,65,163
910,0.08,"(17, 27)","(6, 25)",5,46,21,72,8,67,42,117
911,0.2,"(27, 1)","(25, 13)",3,116,42,161,3,95,65,163
912,0.08,"(4, 5)","(25, 21)",5,226,104,335,6,93,66,165
913,0.06,"(25, 0)","(27, 28)",3,206,87,296,3,87,57,147
914,0.06,"(23, 29)","(7, 16)",3,156,68,227,3,100,70,173
915,0.08,"(10, 28)","(29, 28)",7,126,57,190,4,155,126,285
916,0.02,"(0, 21)","(0, 14)",17,176,73,266,12,44,23,79
917,0.04,"(1, 10)","(27, 5)",9,246,103,358,9,136,112,257
918,0.2,"(4, 28)","(10, 11)",5,96,39,140,3,69,39,111
919,0.2,"(13, 27)","(8, 6)",12,246,127,385,10,121,98,229
920,0.08,"(9, 11)","(0, 13)",5,76,34,115,6,116,89,211
921,0.02,"(5, 1)","(18, 9)",4,186,69,259,4,101,72,177
922,0.02,"(7, 17)","(8, 22)",8,356,165,529,10,116,93,219
923,0.2,"(0, 26)","(17, 26)",4,226,107,337,3,149,119,271
924,0.08,"(1, 28)","(25, 20)",7,236,108,351,2,93,62,157
925,0.1,"(19, 25)","(1, 20)",21,136,74,231,8,64,39,111
926,0.14,"(3, 16)","(17, 10)",9,96,54,159,7,104,78,189
927,0.16,"(24, 26)","(7, 22)",12,126,56,194,11,166,144,321
928,0.02,"(24, 5)","(23, 1)",8,156,68,232,9,61,37,107
929,0.16,"(22, 19)","(6, 24)",6,166,84,256,8,97,72,177
930,0.2,"(16, 19)","(24, 0)",5,156,74,235,9,83,59,151
931,0.06,"(9, 7)","(19, 11)",6,196,88,290,7,87,61,155
932,0.12,"(13, 6)","(13, 0)",6,206,99,311,4,69,40,113
933,0.04,"(10, 5)","(19, 13)",4,166,65,235,12,141,120,273
934,0.14,"(28, 0)","(12, 4)",8,146,65,219,14,69,50,133
935,0.16,"(20, 5)","(26, 13)",29,76,62,167,14,64,45,123
936,0.2,"(28, 17)","(17, 25)",4,136,65,205,3,158,128,289
937,0.2,"(16, 16)","(16, 23)",12,46,28,86,7,96,70,173
938,0.16,"(5, 11)","(13, 3)",5,66,29,100,6,83,56,145
939,0.1,"(0, 23)","(24, 0)",15,116,68,199,32,98,97,227
940,0.12,"(12, 26)","(8, 15)",6,66,29,101,8,77,52,137
941,0.12,"(19, 2)","(22, 5)",9,96,43,148,7,52,23,82
942,0.14,"(9, 17)","(29, 26)",10,216,109,335,5,88,60,153
943,0.16,"(13, 0)","(15, 25)",3,106,45,154,43,77,87,207
944,0.14,"(25, 21)","(0, 19)",7,186,94,287,7,120,94,221
945,0.06,"(10, 27)","(28, 6)",5,216,80,301,9,107,83,199
946,0.14,"(19, 4)","(26, 13)",10,86,48,144,10,126,103,239
947,0.1,"(18, 26)","(26, 0)",5,156,69,230,6,107,80,193
948,0.14,"(4, 23)","(26, 23)",6,266,132,404,10,124,101,235
949,0.06,"(26, 27)","(28, 12)",6,166,73,245,9,133,109,251
950,0.12,"(0, 26)","(17, 26)",6,206,97,309,7,138,112,257
951,0.1,"(1, 29)","(17, 26)",4,176,82,262,2,89,58,149
952,0.02,"(20, 8)","(14, 23)",3,186,74,263,9,63,39,111
953,0.12,"(8, 15)","(26, 25)",6,196,96,298,6,133,106,245
954,0.1,"(0, 17)","(0, 19)",7,46,16,69,11,21,14,46
955,0.12,"(26, 20)","(12, 8)",4,136,65,205,7,95,69,171
956,0.16,"(15, 1)","(29, 0)",7,176,82,265,14,148,129,291
957,0.2,"(14, 7)","(14, 5)",6,76,37,119,9,47,23,79
958,0.06,"(17, 19)","(3, 1)",6,196,98,300,15,71,53,139
959,0.14,"(2, 17)","(1, 29)",10,166,83,259,15,71,53,139
960,0.18,"(19, 23)","(18, 0)",4,116,57,177,9,100,76,185
961,0.08,"(1, 20)","(25, 27)",5,166,73,244,7,75,49,131
962,0.14,"(1, 20)","(23, 19)",6,276,131,413,6,134,107,247
963,0.2,"(26, 17)","(29, 1)",6,186,91,283,15,74,56,145
964,0.14,"(0, 20)","(17, 15)",11,126,59,196,10,105,82,197
965,0.08,"(28, 4)","(21, 1)",5,156,73,234,7,51,25,83
966,0.08,"(24, 22)","(10, 27)",11,156,81,248,11,93,71,175
967,0.1,"(18, 13)","(11, 4)",3,116,55,174,9,115,91,215
968,0.2,"(15, 14)","(1, 27)",3,276,129,408,3,163,133,299
969,0.06,"(15, 17)","(9, 24)",6,116,47,169,8,56,31,95
970,0.14,"(21, 5)","(21, 14)",6,56,25,87,3,55,25,83
971,0.02,"(28, 2)","(2, 20)",3,306,126,435,10,169,146,325
972,0.08,"(8, 21)","(16, 8)",7,176,85,268,4,113,84,201
973,0.14,"(17, 1)","(18, 5)",3,76,32,111,6,73,41,120
974,0.08,"(23, 26)","(26, 20)",9,126,57,192,12,110,89,211
975,0.16,"(12, 22)","(6, 29)",6,136,68,210,4,77,48,129
976,0.16,"(6, 1)","(0, 23)",8,196,103,307,5,130,102,237
977,0.12,"(14, 9)","(16, 24)",7,126,59,192,4,65,36,105
978,0.04,"(29, 12)","(23, 7)",3,126,52,181,5,83,55,143
979,0.16,"(18, 27)","(0, 4)",8,216,104,328,4,85,56,145
980,0.08,"(23, 18)","(4, 2)",7,156,76,239,4,79,50,133
981,0.1,"(11, 10)","(29, 11)",21,96,62,179,9,164,140,313
982,0.06,"(16, 27)","(7, 7)",7,216,95,318,4,119,90,213
983,0.12,"(20, 29)","(14, 20)",8,126,62,196,10,99,76,185
984,0.06,"(13, 5)","(20, 4)",5,286,127,418,12,68,47,127
985,0.16,"(11, 17)","(1, 19)",5,106,38,149,16,63,46,125
986,0.08,"(7, 16)","(15, 8)",5,216,89,310,11,150,128,289
987,0.16,"(25, 21)","(27, 17)",14,116,57,187,8,134,109,251
988,0.12,"(16, 23)","(26, 0)",5,206,101,312,6,88,61,155
989,0.04,"(18, 8)","(14, 18)",5,76,36,117,4,150,121,275
990,0.18,"(8, 13)","(17, 11)",5,96,46,147,3,89,59,151
991,0.14,"(17, 12)","(17, 23)",10,96,47,153,7,73,47,127
992,0.08,"(24, 16)","(3, 25)",7,96,48,151,6,86,59,151
993,0.02,"(25, 19)","(6, 0)",5,276,119,400,4,121,92,217
994,0.2,"(13, 14)","(17, 4)",16,126,70,212,12,122,101,235
995,0.14,"(3, 0)","(22, 29)",9,146,76,231,6,103,76,185
996,0.1,"(9, 7)","(18, 6)",6,86,34,126,6,70,43,119
997,0.12,"(27, 0)","(4, 18)",8,116,54,178,6,114,87,207
998,0.2,"(2, 12)","(14, 18)",5,76,39,120,10,127,104,241
999,0.18,"(27, 3)","(3, 14)",4,166,74,244,4,117,88,209
,,,,7.959,142.23,67.2,217.389,8.346,102.414,77.739,188.499
