0,0.04,"(4, 6)","(4, 1)",5,91,48,144,13,130,88,231
1,0.04,"(13, 6)","(0, 7)",6,126,100,232,10,207,177,394
2,0.06,"(21, 27)","(28, 8)",10,91,63,164,4,53,49,106
3,0.08,"(0, 25)","(8, 25)",22,98,89,209,7,137,126,270
4,0.08,"(8, 17)","(28, 20)",8,119,75,202,6,116,102,224
5,0.02,"(20, 4)","(9, 29)",8,133,89,230,9,172,133,314
6,0.08,"(22, 14)","(5, 6)",9,140,106,255,18,144,133,295
7,0.02,"(21, 28)","(18, 24)",8,133,54,195,17,151,81,249
8,0.12,"(24, 19)","(15, 0)",10,84,80,174,20,95,97,212
9,0.18,"(9, 2)","(29, 8)",10,161,146,317,4,130,120,254
10,0.02,"(19, 27)","(27, 13)",15,147,128,290,7,242,239,488
11,0.04,"(21, 19)","(29, 13)",3,189,131,323,17,123,119,259
12,0.06,"(22, 22)","(9, 16)",8,63,36,107,11,123,113,247
13,0.06,"(17, 26)","(18, 14)",9,63,42,114,21,53,64,138
14,0.2,"(4, 28)","(11, 0)",4,126,99,229,4,116,109,229
15,0.08,"(3, 11)","(8, 5)",9,105,78,192,4,67,44,115
16,0.14,"(29, 8)","(7, 22)",2,77,56,135,4,67,64,135
17,0.2,"(9, 2)","(11, 20)",4,98,81,183,4,144,132,280
18,0.2,"(5, 24)","(15, 8)",4,98,78,180,2,53,39,94
19,0.18,"(24, 5)","(8, 2)",5,154,140,299,16,228,223,467
20,0.2,"(15, 16)","(12, 0)",4,56,33,93,5,95,82,182
21,0.16,"(28, 22)","(1, 11)",12,77,60,149,9,95,92,196
22,0.12,"(0, 16)","(16, 26)",27,112,98,237,4,116,104,224
23,0.2,"(23, 1)","(11, 22)",10,91,72,173,6,88,80,174
24,0.16,"(5, 10)","(5, 5)",7,84,75,166,4,46,31,81
25,0.12,"(8, 20)","(24, 11)",3,105,77,185,10,95,82,187
26,0.02,"(0, 2)","(21, 5)",3,252,150,405,7,102,57,166
27,0.16,"(14, 24)","(19, 2)",6,147,129,282,3,102,71,176
28,0.18,"(20, 1)","(18, 8)",4,28,18,50,16,39,34,89
29,0.08,"(14, 14)","(18, 5)",8,70,47,125,16,74,60,150
30,0.12,"(16, 17)","(19, 15)",9,189,167,365,3,151,127,281
31,0.16,"(5, 2)","(4, 26)",5,133,100,238,8,158,139,305
32,0.1,"(2, 3)","(6, 19)",8,126,86,220,6,144,122,272
33,0.12,"(12, 25)","(15, 0)",8,91,68,167,9,102,95,206
34,0.14,"(26, 17)","(24, 22)",8,70,53,131,11,137,126,274
35,0.1,"(23, 24)","(20, 20)",26,77,59,162,4,46,27,77
36,0.14,"(23, 29)","(5, 6)",7,84,71,162,5,123,102,230
37,0.2,"(4, 25)","(17, 22)",7,77,53,137,9,102,81,192
38,0.1,"(1, 13)","(17, 0)",5,77,62,144,23,172,186,381
39,0.18,"(16, 6)","(11, 15)",18,63,42,123,12,60,54,126
40,0.14,"(18, 18)","(21, 0)",7,70,42,119,4,39,33,76
41,0.1,"(14, 0)","(18, 7)",10,49,36,95,5,53,34,92
42,0.04,"(3, 8)","(27, 4)",4,133,89,226,3,109,90,202
43,0.02,"(27, 6)","(26, 26)",15,189,158,362,6,144,126,276
44,0.06,"(26, 3)","(11, 22)",7,77,64,148,5,151,110,266
45,0.16,"(0, 23)","(10, 11)",15,49,43,107,9,81,68,158
46,0.08,"(7, 7)","(18, 11)",7,126,92,225,6,53,51,110
47,0.16,"(1, 27)","(17, 7)",10,70,64,144,4,116,90,210
48,0.02,"(14, 24)","(7, 28)",7,42,19,68,6,25,18,49
49,0.12,"(5, 20)","(0, 22)",6,56,23,85,7,18,15,40
50,0.04,"(15, 9)","(22, 19)",4,105,69,178,9,144,101,254
51,0.1,"(14, 27)","(25, 17)",4,147,100,251,5,116,91,212
52,0.1,"(9, 6)","(6, 29)",9,84,73,166,11,67,63,141
53,0.02,"(26, 20)","(22, 19)",15,84,51,150,44,11,50,105
54,0.2,"(18, 29)","(29, 24)",10,77,69,156,26,305,311,642
55,0.2,"(8, 29)","(13, 12)",5,140,114,259,6,74,65,145
56,0.16,"(5, 25)","(12, 27)",7,105,79,191,5,102,73,180
57,0.02,"(26, 12)","(13, 2)",2,70,37,109,2,263,192,457
58,0.18,"(20, 11)","(5, 29)",3,77,53,133,4,102,91,197
59,0.08,"(15, 22)","(2, 16)",12,182,153,347,6,137,107,250
60,0.18,"(7, 12)","(12, 18)",5,112,84,201,5,53,40,98
61,0.08,"(24, 1)","(28, 5)",7,91,46,144,4,46,37,87
62,0.12,"(4, 10)","(21, 4)",8,189,172,369,22,67,68,157
63,0.02,"(26, 2)","(14, 28)",10,189,148,347,4,88,72,164
64,0.1,"(0, 11)","(0, 15)",6,35,25,66,11,18,17,46
65,0.14,"(19, 10)","(16, 5)",9,42,27,78,5,46,44,95
66,0.1,"(12, 10)","(16, 17)",4,98,73,175,10,39,38,87
67,0.1,"(23, 29)","(20, 22)",5,63,36,104,6,60,47,113
68,0.2,"(2, 10)","(4, 5)",10,84,67,161,10,60,55,125
69,0.18,"(4, 23)","(0, 28)",6,63,49,118,5,67,30,102
70,0.12,"(21, 15)","(13, 17)",10,140,125,275,8,18,17,43
71,0.12,"(0, 9)","(29, 8)",2,84,67,153,2,116,91,209
72,0.04,"(14, 14)","(9, 1)",32,133,109,274,10,102,98,210
73,0.16,"(0, 29)","(20, 2)",5,133,100,238,7,81,63,151
74,0.06,"(1, 22)","(23, 15)",10,168,137,315,11,151,135,297
75,0.1,"(24, 25)","(21, 19)",8,98,71,177,9,67,59,135
76,0.18,"(27, 29)","(3, 18)",11,105,90,206,13,123,121,257
77,0.06,"(4, 9)","(0, 26)",10,126,92,228,6,74,41,121
78,0.18,"(0, 9)","(27, 12)",6,98,65,169,9,102,101,212
79,0.08,"(15, 13)","(26, 22)",11,126,81,218,6,116,76,198
80,0.08,"(2, 23)","(3, 0)",11,84,69,164,9,137,128,274
81,0.12,"(23, 24)","(19, 23)",6,35,20,61,6,39,24,69
82,0.08,"(5, 16)","(25, 7)",11,98,79,188,3,95,89,187
83,0.18,"(7, 28)","(17, 16)",7,112,89,208,5,81,70,156
84,0.06,"(6, 17)","(8, 10)",20,77,63,160,8,81,65,154
85,0.18,"(13, 5)","(27, 10)",7,98,70,175,8,95,80,183
86,0.2,"(5, 5)","(2, 29)",4,147,125,276,7,144,135,286
87,0.04,"(28, 22)","(2, 20)",6,189,149,344,3,165,145,313
88,0.1,"(7, 8)","(18, 28)",6,168,143,317,9,116,96,221
89,0.1,"(25, 1)","(7, 20)",28,119,106,253,17,74,69,160
90,0.16,"(26, 15)","(17, 3)",3,147,121,271,4,95,90,189
91,0.04,"(6, 13)","(16, 0)",4,91,53,148,5,116,83,204
92,0.16,"(21, 23)","(9, 21)",8,49,36,93,11,81,84,176
93,0.14,"(8, 21)","(27, 29)",9,84,68,161,6,109,104,219
94,0.14,"(21, 8)","(8, 27)",9,77,59,145,13,109,103,225
95,0.12,"(5, 21)","(16, 21)",5,84,69,158,3,109,81,193
96,0.06,"(3, 8)","(17, 9)",6,175,122,303,9,130,113,252
97,0.2,"(3, 10)","(23, 0)",5,168,153,326,7,74,71,152
98,0.2,"(0, 15)","(28, 23)",3,119,87,209,5,116,113,234
99,0.14,"(24, 29)","(9, 28)",5,63,49,117,15,81,78,174
100,0.18,"(21, 20)","(23, 23)",6,91,67,164,8,60,50,118
101,0.2,"(18, 7)","(13, 1)",6,63,42,111,7,32,32,71
102,0.18,"(18, 22)","(26, 11)",18,77,68,163,4,74,68,146
103,0.14,"(19, 11)","(0, 21)",12,70,47,129,10,151,146,307
104,0.14,"(10, 6)","(21, 1)",3,84,60,147,2,109,89,200
105,0.12,"(19, 24)","(27, 25)",10,63,44,117,5,60,50,115
106,0.16,"(8, 1)","(29, 0)",11,112,90,213,23,144,160,327
107,0.16,"(26, 12)","(4, 18)",6,84,67,157,5,102,85,192
108,0.14,"(5, 10)","(26, 3)",8,112,82,202,5,123,110,238
109,0.12,"(27, 5)","(6, 19)",7,105,88,200,10,67,63,140
110,0.06,"(6, 5)","(28, 21)",9,84,74,167,5,116,91,212
111,0.2,"(11, 6)","(2, 7)",15,56,47,118,7,32,28,67
112,0.02,"(23, 28)","(1, 24)",12,217,126,355,5,130,95,230
113,0.04,"(18, 7)","(13, 11)",10,56,36,102,7,39,20,66
114,0.1,"(17, 14)","(7, 14)",11,105,77,193,7,60,40,107
115,0.02,"(7, 3)","(22, 0)",8,63,43,114,9,123,67,199
116,0.08,"(21, 27)","(3, 29)",5,77,65,147,4,102,75,181
117,0.14,"(27, 28)","(13, 2)",4,91,80,175,4,81,75,160
118,0.2,"(0, 10)","(20, 1)",7,84,71,162,3,95,79,177
119,0.14,"(13, 9)","(1, 16)",5,98,57,160,8,109,102,219
120,0.08,"(5, 18)","(25, 23)",4,105,67,176,4,123,99,226
121,0.18,"(28, 12)","(3, 1)",3,98,78,179,4,67,65,136
122,0.1,"(18, 29)","(3, 12)",21,98,91,210,9,123,111,243
123,0.16,"(11, 16)","(12, 6)",14,70,62,146,5,67,65,137
124,0.2,"(0, 26)","(23, 22)",8,182,165,355,9,137,117,263
125,0.12,"(17, 28)","(18, 8)",6,70,56,132,6,81,80,167
126,0.02,"(12, 6)","(24, 15)",9,280,179,468,7,123,100,230
127,0.18,"(4, 25)","(11, 15)",11,70,66,147,12,74,74,160
128,0.1,"(5, 15)","(11, 23)",9,147,113,269,11,67,57,135
129,0.02,"(25, 27)","(26, 21)",9,161,92,262,6,228,138,372
130,0.04,"(13, 17)","(9, 9)",6,49,24,79,7,109,82,198
131,0.12,"(18, 12)","(16, 1)",29,105,101,235,8,81,76,165
132,0.06,"(18, 29)","(15, 28)",18,28,23,69,7,81,42,130
133,0.16,"(4, 17)","(14, 14)",5,112,97,214,7,95,92,194
134,0.2,"(7, 17)","(21, 13)",6,63,50,119,5,102,78,185
135,0.16,"(0, 4)","(13, 19)",4,63,46,113,3,46,39,88
136,0.02,"(24, 12)","(19, 2)",19,147,86,252,9,235,163,407
137,0.08,"(29, 25)","(3, 17)",8,119,81,208,5,158,145,308
138,0.04,"(3, 17)","(4, 24)",8,91,73,172,7,102,56,165
139,0.14,"(0, 13)","(18, 22)",6,91,77,174,6,81,73,160
140,0.06,"(7, 25)","(29, 26)",5,63,48,116,3,116,101,220
141,0.16,"(28, 12)","(20, 21)",4,91,64,159,4,53,50,107
142,0.06,"(8, 27)","(18, 17)",14,196,127,337,6,95,74,175
143,0.06,"(15, 11)","(0, 0)",16,182,172,370,8,144,145,297
144,0.18,"(0, 13)","(25, 15)",4,98,75,177,6,60,62,128
145,0.14,"(15, 2)","(16, 5)",8,28,11,47,7,32,23,62
146,0.16,"(12, 7)","(8, 29)",15,119,105,239,6,88,83,177
147,0.06,"(19, 5)","(4, 4)",7,70,58,135,17,151,142,310
148,0.02,"(26, 0)","(10, 24)",4,105,61,170,14,326,269,609
149,0.04,"(20, 7)","(21, 27)",5,147,119,271,24,109,91,224
150,0.14,"(29, 4)","(4, 15)",3,112,93,208,8,74,65,147
151,0.02,"(14, 22)","(12, 12)",5,112,73,190,6,123,101,230
152,0.18,"(29, 7)","(0, 4)",3,98,71,172,11,109,110,230
153,0.02,"(10, 11)","(24, 17)",11,126,86,223,9,130,109,248
154,0.16,"(17, 10)","(13, 6)",10,56,33,99,9,25,24,58
155,0.14,"(13, 0)","(20, 0)",21,63,65,149,17,46,45,108
156,0.16,"(28, 21)","(24, 21)",2,56,26,84,5,11,12,28
157,0.12,"(2, 14)","(10, 11)",14,49,41,104,8,67,43,118
158,0.14,"(1, 29)","(9, 2)",4,140,105,249,7,88,86,181
159,0.08,"(29, 26)","(10, 17)",4,147,111,262,3,95,81,179
160,0.1,"(24, 19)","(24, 23)",11,49,40,100,8,144,133,285
161,0.16,"(10, 18)","(10, 2)",6,70,61,137,10,74,61,145
162,0.14,"(26, 3)","(19, 12)",7,77,45,129,10,53,42,105
163,0.02,"(12, 21)","(19, 16)",3,63,49,115,4,60,47,111
164,0.04,"(19, 28)","(26, 5)",5,126,95,226,6,158,130,294
165,0.1,"(2, 17)","(18, 8)",7,91,70,168,12,137,114,263
166,0.1,"(17, 10)","(29, 28)",5,84,74,163,7,88,83,178
167,0.2,"(7, 5)","(21, 9)",4,84,71,159,4,109,97,210
168,0.02,"(8, 3)","(10, 7)",6,77,47,130,8,228,164,400
169,0.06,"(6, 12)","(5, 19)",7,133,83,223,6,102,66,174
170,0.16,"(4, 20)","(21, 25)",14,147,129,290,12,60,62,134
171,0.06,"(8, 15)","(12, 5)",21,133,103,257,7,123,101,231
172,0.06,"(19, 11)","(25, 8)",9,84,52,145,8,81,55,144
173,0.14,"(25, 14)","(12, 18)",6,77,43,126,5,130,114,249
174,0.1,"(16, 24)","(27, 22)",13,91,78,182,5,81,63,149
175,0.14,"(2, 25)","(10, 28)",6,70,45,121,6,53,46,105
176,0.08,"(9, 17)","(23, 16)",7,98,78,183,5,130,85,220
177,0.08,"(17, 21)","(21, 3)",9,49,36,94,9,74,72,155
178,0.04,"(18, 24)","(21, 11)",5,63,49,117,8,151,115,274
179,0.14,"(29, 6)","(27, 26)",7,105,76,188,5,60,54,119
180,0.1,"(27, 19)","(25, 1)",9,112,85,206,11,39,45,95
181,0.2,"(7, 9)","(18, 3)",6,217,201,424,7,67,64,138
182,0.12,"(28, 13)","(1, 4)",4,84,52,140,7,67,57,131
183,0.12,"(3, 0)","(17, 24)",8,133,108,249,5,109,107,221
184,0.02,"(21, 2)","(0, 22)",5,196,125,326,4,207,131,342
185,0.18,"(22, 9)","(2, 18)",3,98,71,172,10,81,82,173
186,0.04,"(19, 19)","(5, 19)",7,105,92,204,5,130,98,233
187,0.14,"(22, 2)","(9, 3)",3,49,26,78,4,25,19,48
188,0.1,"(12, 25)","(14, 6)",6,126,89,221,4,123,99,226
189,0.02,"(9, 28)","(21, 3)",10,182,142,334,6,144,80,230
190,0.1,"(23, 15)","(8, 25)",16,105,77,198,11,95,87,193
191,0.12,"(4, 10)","(11, 4)",6,84,53,143,8,95,87,190
192,0.08,"(0, 14)","(19, 2)",3,112,67,182,5,81,63,149
193,0.16,"(0, 14)","(15, 19)",12,84,70,166,9,95,76,180
194,0.16,"(11, 20)","(10, 8)",4,42,26,72,16,116,116,248
195,0.18,"(24, 24)","(18, 13)",7,98,79,184,10,81,79,170
196,0.02,"(24, 22)","(29, 18)",5,105,47,157,10,242,173,425
197,0.06,"(19, 9)","(27, 7)",8,112,61,181,5,123,115,243
198,0.2,"(9, 27)","(5, 21)",4,49,31,84,5,60,51,116
199,0.08,"(15, 21)","(12, 10)",10,77,60,147,9,102,62,173
200,0.14,"(0, 18)","(6, 25)",4,70,43,117,5,67,68,140
201,0.08,"(18, 8)","(16, 24)",4,175,136,315,5,53,54,112
202,0.14,"(14, 23)","(19, 28)",21,56,57,134,4,151,145,300
203,0.02,"(8, 29)","(0, 10)",15,154,153,322,6,291,253,550
204,0.08,"(3, 19)","(13, 20)",8,84,75,167,9,46,47,102
205,0.16,"(27, 14)","(12, 17)",4,70,42,116,6,53,35,94
206,0.1,"(20, 4)","(16, 8)",8,56,30,94,5,32,20,57
207,0.1,"(26, 25)","(4, 23)",9,63,45,117,22,144,144,310
208,0.02,"(5, 29)","(6, 8)",13,84,71,168,7,151,96,254
209,0.12,"(2, 23)","(14, 12)",2,119,97,218,3,53,35,91
210,0.04,"(2, 16)","(26, 8)",4,119,96,219,3,109,82,194
211,0.04,"(20, 3)","(1, 23)",6,294,240,540,6,116,101,223
212,0.08,"(17, 17)","(26, 25)",3,77,54,134,5,95,70,170
213,0.08,"(25, 18)","(29, 3)",11,42,39,92,7,74,62,143
214,0.18,"(3, 15)","(29, 26)",12,133,109,254,12,123,110,245
215,0.12,"(24, 6)","(28, 5)",10,70,33,113,18,53,55,126
216,0.08,"(18, 20)","(9, 24)",6,70,46,122,9,109,97,215
217,0.12,"(9, 19)","(22, 0)",4,154,137,295,12,123,130,265
218,0.02,"(24, 25)","(29, 27)",5,105,61,171,4,67,30,101
219,0.18,"(22, 22)","(25, 29)",17,77,79,173,9,95,92,196
220,0.04,"(15, 15)","(28, 12)",6,119,80,205,17,172,164,353
221,0.14,"(27, 11)","(26, 3)",9,63,58,130,13,46,39,98
222,0.16,"(24, 4)","(26, 11)",16,42,39,97,5,81,65,151
223,0.06,"(11, 13)","(5, 16)",3,63,21,87,3,53,26,82
224,0.2,"(9, 4)","(22, 26)",10,98,88,196,8,81,70,159
225,0.02,"(14, 27)","(29, 19)",8,182,148,338,7,123,108,238
226,0.18,"(19, 14)","(16, 14)",3,1,3,7,4,32,26,62
227,0.02,"(11, 3)","(18, 1)",10,70,52,132,7,123,77,207
228,0.16,"(8, 23)","(22, 4)",6,98,75,179,8,53,46,107
229,0.14,"(29, 3)","(17, 23)",4,140,96,240,3,130,117,250
230,0.18,"(16, 22)","(1, 27)",4,112,92,208,9,109,91,209
231,0.04,"(24, 23)","(29, 15)",9,168,117,294,4,102,102,208
232,0.04,"(7, 4)","(4, 28)",9,175,147,331,7,144,116,267
233,0.02,"(11, 20)","(26, 20)",8,84,55,147,25,46,67,138
234,0.12,"(28, 0)","(29, 5)",2,56,24,82,6,39,34,79
235,0.16,"(13, 27)","(3, 3)",15,126,125,266,13,74,75,162
236,0.04,"(5, 5)","(10, 17)",5,119,62,186,13,46,54,113
237,0.1,"(17, 22)","(27, 4)",9,105,80,194,6,74,69,149
238,0.02,"(15, 19)","(13, 7)",8,77,40,125,11,116,76,203
239,0.04,"(27, 26)","(21, 6)",12,140,129,281,17,151,143,311
240,0.08,"(20, 13)","(8, 8)",19,91,66,176,8,74,71,153
241,0.02,"(29, 14)","(6, 19)",7,217,157,381,11,102,101,214
242,0.04,"(4, 25)","(2, 16)",5,28,17,50,10,53,36,99
243,0.16,"(28, 19)","(12, 3)",10,91,57,158,4,109,95,208
244,0.1,"(21, 16)","(15, 24)",4,147,109,260,6,39,32,77
245,0.02,"(3, 18)","(9, 12)",6,56,31,93,7,116,68,191
246,0.08,"(10, 10)","(18, 25)",13,133,112,258,5,46,43,94
247,0.14,"(7, 26)","(19, 13)",9,140,112,261,15,116,127,258
248,0.12,"(16, 26)","(0, 23)",12,119,81,212,7,137,129,273
249,0.08,"(4, 8)","(7, 4)",7,56,42,105,21,88,80,189
250,0.1,"(14, 17)","(21, 4)",9,217,181,407,8,74,74,156
251,0.1,"(21, 9)","(5, 20)",9,91,80,180,17,46,56,119
252,0.04,"(15, 10)","(17, 13)",5,105,45,155,12,137,109,258
253,0.18,"(9, 26)","(8, 4)",9,77,66,152,17,151,158,326
254,0.12,"(6, 3)","(10, 22)",4,84,59,147,21,60,53,134
255,0.2,"(8, 24)","(11, 3)",10,98,79,187,8,39,40,87
256,0.06,"(7, 19)","(17, 6)",11,77,71,159,12,81,68,161
257,0.1,"(21, 9)","(26, 20)",8,105,68,181,5,60,53,118
258,0.08,"(20, 19)","(10, 1)",22,140,123,285,8,137,123,268
259,0.18,"(0, 17)","(17, 14)",3,140,116,259,4,53,41,98
260,0.06,"(9, 5)","(11, 3)",8,91,67,166,5,53,24,82
261,0.02,"(11, 1)","(19, 20)",3,112,95,210,7,193,112,312
262,0.14,"(19, 27)","(11, 21)",8,119,92,219,8,60,47,115
263,0.12,"(5, 18)","(16, 1)",21,105,89,215,9,130,119,258
264,0.14,"(16, 19)","(18, 24)",18,63,66,147,6,39,40,85
265,0.04,"(12, 0)","(4, 3)",5,133,94,232,7,123,65,195
266,0.2,"(13, 23)","(24, 16)",5,49,39,93,7,53,44,104
267,0.02,"(3, 28)","(13, 5)",4,147,90,241,4,67,52,123
268,0.04,"(17, 2)","(1, 27)",11,154,122,287,11,123,99,233
269,0.06,"(25, 12)","(28, 22)",22,84,72,178,9,74,71,154
270,0.1,"(26, 2)","(13, 24)",12,105,87,204,8,74,61,143
271,0.08,"(22, 21)","(19, 26)",7,77,54,138,7,60,37,104
272,0.12,"(8, 22)","(3, 28)",5,42,17,64,6,60,31,97
273,0.2,"(29, 3)","(9, 2)",5,105,95,205,5,137,129,271
274,0.04,"(26, 7)","(0, 6)",4,161,115,280,5,123,82,210
275,0.1,"(7, 13)","(26, 23)",4,112,92,208,8,53,48,109
276,0.2,"(20, 20)","(21, 23)",12,42,27,81,7,60,48,115
277,0.16,"(22, 26)","(17, 5)",16,56,56,128,6,81,76,163
278,0.16,"(1, 11)","(9, 19)",10,91,66,167,21,46,57,124
279,0.02,"(8, 9)","(12, 7)",14,147,83,244,8,95,73,176
280,0.2,"(9, 22)","(29, 27)",5,168,148,321,7,116,104,227
281,0.2,"(29, 26)","(26, 21)",5,56,31,92,19,60,58,137
282,0.1,"(12, 22)","(14, 2)",11,91,88,190,8,109,93,210
283,0.2,"(28, 5)","(9, 16)",16,84,63,163,8,102,91,201
284,0.1,"(20, 4)","(27, 26)",12,91,68,171,5,123,100,228
285,0.1,"(4, 3)","(19, 12)",14,112,78,204,21,144,146,311
286,0.08,"(2, 25)","(15, 14)",7,63,50,120,4,88,49,141
287,0.06,"(10, 0)","(20, 8)",5,119,88,212,19,109,89,217
288,0.14,"(26, 14)","(23, 7)",9,35,20,64,3,53,30,86
289,0.12,"(6, 21)","(8, 11)",4,77,47,128,12,60,60,132
290,0.18,"(11, 4)","(25, 6)",13,126,115,254,7,102,86,195
291,0.12,"(29, 26)","(0, 14)",4,77,67,148,3,123,99,225
292,0.14,"(6, 10)","(13, 16)",14,63,56,133,11,32,33,76
293,0.06,"(28, 8)","(7, 5)",16,77,53,146,8,116,99,223
294,0.18,"(19, 2)","(4, 16)",13,77,65,155,10,39,39,88
295,0.2,"(18, 7)","(9, 6)",5,49,27,81,10,46,31,87
296,0.02,"(22, 13)","(8, 2)",4,210,150,364,7,151,130,288
297,0.02,"(18, 17)","(10, 15)",4,119,66,189,4,109,67,180
298,0.18,"(2, 26)","(9, 29)",8,49,41,98,3,221,212,436
299,0.08,"(1, 27)","(14, 19)",3,161,134,298,7,137,125,269
300,0.06,"(22, 8)","(4, 4)",8,77,71,156,4,109,68,181
301,0.14,"(22, 29)","(4, 15)",4,112,84,200,9,60,51,120
302,0.14,"(3, 15)","(27, 21)",6,112,96,214,3,88,72,163
303,0.02,"(4, 26)","(0, 3)",7,98,82,187,10,60,59,129
304,0.06,"(23, 10)","(14, 0)",26,98,82,206,11,81,81,173
305,0.08,"(17, 14)","(13, 22)",7,98,74,179,10,39,42,91
306,0.14,"(10, 4)","(8, 18)",7,77,52,136,4,109,90,203
307,0.16,"(2, 16)","(21, 26)",4,175,149,328,6,53,45,104
308,0.2,"(15, 0)","(21, 22)",2,70,52,124,4,109,91,204
309,0.04,"(17, 26)","(6, 17)",7,119,101,227,7,200,126,333
310,0.12,"(5, 18)","(25, 8)",6,133,92,231,6,74,59,139
311,0.16,"(7, 5)","(18, 12)",8,56,48,112,6,130,110,246
312,0.04,"(12, 16)","(16, 12)",5,63,44,112,3,158,107,268
313,0.08,"(25, 26)","(28, 0)",10,77,56,143,10,95,85,190
314,0.18,"(29, 0)","(6, 18)",1,91,56,148,1,144,123,268
315,0.06,"(0, 3)","(16, 23)",10,154,125,289,2,109,92,203
316,0.1,"(12, 28)","(25, 16)",5,77,59,141,7,123,85,215
317,0.04,"(29, 28)","(12, 20)",6,49,36,91,8,116,97,221
318,0.16,"(2, 8)","(28, 28)",4,357,332,693,5,158,141,304
319,0.2,"(18, 21)","(29, 14)",1,154,126,281,9,214,203,426
320,0.2,"(9, 29)","(18, 13)",5,56,36,97,3,46,31,80
321,0.04,"(29, 24)","(4, 4)",7,112,99,218,3,102,82,187
322,0.1,"(29, 15)","(20, 25)",6,56,41,103,8,74,68,150
323,0.02,"(3, 20)","(26, 24)",4,154,77,235,2,109,81,192
324,0.12,"(17, 20)","(14, 14)",4,98,70,172,40,53,62,155
325,0.12,"(9, 4)","(23, 22)",14,154,132,300,13,116,97,226
326,0.18,"(8, 29)","(2, 24)",7,28,17,52,4,60,35,99
327,0.18,"(22, 15)","(25, 10)",6,63,37,106,15,95,95,205
328,0.04,"(5, 19)","(20, 24)",16,147,109,272,7,109,96,212
329,0.06,"(9, 17)","(16, 6)",5,119,62,186,10,102,89,201
330,0.14,"(10, 20)","(3, 2)",6,77,45,128,8,102,94,204
331,0.14,"(10, 17)","(13, 18)",18,98,73,189,10,46,50,106
332,0.06,"(27, 24)","(25, 25)",3,28,8,39,8,95,48,151
333,0.1,"(7, 19)","(14, 21)",9,98,73,180,4,74,46,124
334,0.2,"(22, 20)","(10, 5)",14,161,146,321,16,95,94,205
335,0.12,"(4, 9)","(20, 3)",5,105,95,205,7,116,107,230
336,0.12,"(3, 20)","(26, 29)",7,161,149,317,12,74,82,168
337,0.2,"(18, 4)","(6, 8)",4,42,32,78,7,123,115,245
338,0.18,"(18, 29)","(20, 14)",21,63,46,130,7,67,47,121
339,0.2,"(27, 24)","(3, 20)",5,91,70,166,24,130,116,270
340,0.1,"(4, 20)","(20, 20)",17,84,76,177,9,95,95,199
341,0.02,"(24, 11)","(3, 17)",4,91,45,140,5,186,145,336
342,0.02,"(6, 13)","(21, 20)",9,49,44,102,11,116,90,217
343,0.1,"(16, 26)","(8, 6)",10,119,106,235,11,81,67,159
344,0.16,"(6, 23)","(9, 18)",5,56,31,92,5,67,53,125
345,0.12,"(5, 26)","(16, 9)",5,98,73,176,5,137,121,263
346,0.08,"(21, 12)","(27, 16)",7,70,52,129,6,235,222,463
347,0.02,"(10, 10)","(10, 24)",4,175,95,274,9,242,157,408
348,0.04,"(24, 20)","(1, 29)",3,105,76,184,6,109,96,211
349,0.12,"(2, 0)","(9, 2)",11,49,34,94,11,60,49,120
350,0.08,"(9, 27)","(1, 29)",6,42,29,77,4,18,15,37
351,0.14,"(24, 19)","(15, 19)",15,49,33,97,5,53,32,90
352,0.06,"(6, 21)","(5, 23)",6,84,47,137,11,60,25,96
353,0.12,"(6, 1)","(23, 0)",14,84,82,180,9,74,67,150
354,0.06,"(17, 8)","(21, 15)",12,63,49,124,12,67,66,145
355,0.02,"(22, 1)","(16, 11)",9,84,61,154,6,158,105,269
356,0.18,"(15, 8)","(21, 15)",7,98,77,182,4,60,45,109
357,0.18,"(10, 22)","(5, 21)",5,49,19,73,5,60,49,114
358,0.2,"(17, 26)","(10, 10)",5,56,35,96,18,67,71,156
359,0.14,"(6, 5)","(21, 2)",4,56,45,105,7,81,76,164
360,0.14,"(11, 26)","(22, 12)",5,140,102,247,14,46,50,110
361,0.06,"(26, 4)","(7, 26)",9,154,118,281,7,116,77,200
362,0.04,"(23, 26)","(8, 24)",11,91,47,149,10,60,49,119
363,0.1,"(10, 7)","(21, 14)",8,112,95,215,17,81,93,191
364,0.02,"(8, 19)","(20, 10)",15,182,129,326,7,235,223,465
365,0.2,"(4, 7)","(19, 25)",5,70,45,120,5,102,68,175
366,0.16,"(19, 18)","(24, 27)",9,98,91,198,5,67,66,138
367,0.14,"(19, 5)","(28, 5)",7,63,50,120,10,137,124,271
368,0.1,"(18, 22)","(23, 2)",5,168,128,301,6,67,65,138
369,0.16,"(26, 9)","(29, 6)",6,112,80,198,13,81,78,172
370,0.1,"(25, 6)","(12, 2)",4,119,79,202,4,53,51,108
371,0.2,"(21, 10)","(4, 8)",20,105,87,212,8,116,98,222
372,0.02,"(1, 5)","(3, 25)",3,189,89,281,3,109,71,183
373,0.14,"(23, 23)","(18, 16)",5,56,29,90,4,67,50,121
374,0.04,"(4, 1)","(10, 29)",3,140,114,257,3,256,168,427
375,0.2,"(5, 11)","(19, 6)",8,105,91,204,7,116,112,235
376,0.02,"(4, 5)","(16, 9)",9,259,172,440,4,228,176,408
377,0.04,"(6, 2)","(20, 22)",4,84,51,139,7,130,111,248
378,0.2,"(7, 8)","(14, 26)",14,77,59,150,19,60,64,143
379,0.08,"(0, 25)","(21, 15)",6,77,65,148,4,102,91,197
380,0.1,"(22, 9)","(18, 2)",11,112,98,221,12,95,67,174
381,0.04,"(13, 1)","(6, 15)",6,133,107,246,5,60,52,117
382,0.18,"(26, 10)","(13, 4)",7,98,81,186,8,95,73,176
383,0.14,"(3, 25)","(9, 24)",7,70,42,119,11,39,36,86
384,0.06,"(15, 2)","(4, 28)",5,105,86,196,4,95,80,179
385,0.08,"(4, 7)","(4, 16)",6,42,31,79,7,46,36,89
386,0.14,"(7, 12)","(21, 9)",7,98,54,159,4,130,109,243
387,0.18,"(28, 15)","(3, 27)",3,84,65,152,5,200,186,391
388,0.16,"(9, 8)","(12, 8)",12,42,31,85,10,39,31,80
389,0.12,"(4, 5)","(1, 8)",9,126,82,217,5,67,51,123
390,0.06,"(9, 3)","(23, 3)",8,112,80,200,4,88,56,148
391,0.16,"(29, 14)","(0, 1)",20,105,105,230,29,88,100,217
392,0.2,"(13, 6)","(14, 29)",6,126,83,215,5,60,52,117
393,0.14,"(17, 12)","(17, 4)",4,91,64,159,8,102,80,190
394,0.16,"(18, 17)","(10, 24)",5,126,98,229,12,39,35,86
395,0.06,"(5, 28)","(25, 17)",6,140,108,254,14,102,93,209
396,0.16,"(28, 7)","(3, 13)",5,105,69,179,7,116,85,208
397,0.14,"(17, 13)","(2, 24)",3,77,45,125,3,102,86,191
398,0.14,"(4, 10)","(8, 19)",6,77,51,134,6,74,57,137
399,0.08,"(3, 14)","(21, 22)",4,210,157,371,7,95,67,169
400,0.1,"(21, 26)","(24, 0)",11,140,120,271,6,74,76,156
401,0.14,"(27, 14)","(0, 20)",4,91,67,162,18,179,174,371
402,0.02,"(21, 18)","(16, 26)",17,133,85,235,7,102,99,208
403,0.12,"(7, 23)","(16, 3)",6,126,85,217,5,123,110,238
404,0.04,"(18, 19)","(22, 27)",19,133,107,259,14,151,150,315
405,0.1,"(12, 25)","(22, 17)",4,63,53,120,19,39,54,112
406,0.04,"(10, 0)","(4, 8)",12,70,54,136,7,60,39,106
407,0.2,"(14, 27)","(27, 19)",11,91,70,172,5,60,46,111
408,0.06,"(15, 3)","(24, 13)",6,77,63,146,4,123,107,234
409,0.16,"(0, 19)","(13, 10)",3,84,49,136,9,67,40,116
410,0.06,"(8, 27)","(12, 17)",9,126,88,223,18,158,133,309
411,0.08,"(0, 1)","(18, 28)",7,126,105,238,8,172,146,326
412,0.1,"(8, 3)","(18, 28)",7,105,70,182,43,88,111,242
413,0.12,"(4, 8)","(11, 19)",7,84,62,153,4,102,93,199
414,0.08,"(25, 22)","(22, 28)",7,56,26,89,15,81,80,176
415,0.08,"(25, 21)","(5, 19)",7,140,109,256,12,88,89,189
416,0.02,"(1, 15)","(29, 22)",6,77,65,148,8,158,111,277
417,0.18,"(24, 16)","(12, 21)",12,49,35,96,10,46,44,100
418,0.08,"(5, 23)","(19, 28)",5,105,77,187,6,88,67,161
419,0.12,"(15, 3)","(24, 19)",4,84,55,143,7,74,66,147
420,0.02,"(6, 20)","(23, 25)",6,91,65,162,6,221,169,396
421,0.06,"(10, 16)","(25, 2)",7,112,88,207,5,74,64,143
422,0.02,"(29, 1)","(14, 4)",8,105,60,173,6,123,57,186
423,0.02,"(9, 13)","(19, 23)",16,147,94,257,6,88,72,166
424,0.04,"(18, 17)","(16, 29)",20,189,139,348,2,81,67,150
425,0.04,"(9, 5)","(15, 15)",4,91,74,169,5,88,68,161
426,0.18,"(6, 24)","(27, 3)",9,147,126,282,7,102,99,208
427,0.16,"(24, 16)","(25, 5)",9,63,47,119,6,88,71,165
428,0.16,"(6, 9)","(11, 15)",13,84,70,167,12,46,46,104
429,0.02,"(29, 14)","(6, 24)",14,168,103,285,6,102,83,191
430,0.06,"(22, 25)","(21, 10)",8,63,51,122,14,130,96,240
431,0.04,"(9, 8)","(17, 24)",4,112,73,189,6,130,108,244
432,0.18,"(20, 4)","(10, 4)",10,28,23,61,10,81,81,172
433,0.02,"(18, 24)","(22, 3)",10,189,107,306,10,109,93,212
434,0.12,"(16, 11)","(8, 2)",17,161,146,324,5,88,80,173
435,0.16,"(19, 27)","(25, 21)",6,84,47,137,7,88,78,173
436,0.02,"(18, 0)","(13, 18)",5,147,73,225,4,137,117,258
437,0.02,"(11, 12)","(4, 19)",5,217,90,312,4,179,146,329
438,0.08,"(16, 1)","(29, 22)",3,126,107,236,8,116,96,220
439,0.1,"(15, 25)","(25, 1)",6,112,69,187,4,60,45,109
440,0.14,"(25, 1)","(24, 3)",9,35,17,61,6,74,38,118
441,0.06,"(23, 7)","(28, 25)",32,98,101,231,7,109,85,201
442,0.12,"(5, 5)","(3, 15)",9,91,68,168,5,81,49,135
443,0.16,"(21, 13)","(24, 2)",5,91,65,161,9,39,44,92
444,0.1,"(17, 10)","(11, 25)",5,161,138,304,9,130,119,258
445,0.06,"(23, 23)","(5, 13)",4,84,49,137,4,88,63,155
446,0.04,"(12, 15)","(3, 5)",11,98,81,190,24,95,109,228
447,0.14,"(2, 7)","(26, 2)",6,161,124,291,6,137,126,269
448,0.12,"(27, 10)","(2, 6)",5,98,79,182,17,102,97,216
449,0.04,"(20, 19)","(4, 18)",4,147,108,259,7,88,51,146
450,0.06,"(27, 13)","(21, 1)",11,91,55,157,10,137,99,246
451,0.08,"(23, 2)","(7, 8)",8,182,154,344,13,88,79,180
452,0.06,"(27, 6)","(29, 15)",6,84,59,149,8,95,76,179
453,0.16,"(8, 27)","(23, 4)",8,119,88,215,8,158,150,316
454,0.18,"(7, 9)","(9, 7)",5,63,42,110,5,60,51,116
455,0.08,"(18, 17)","(2, 25)",5,133,94,232,6,109,78,193
456,0.16,"(19, 11)","(23, 14)",14,42,42,98,17,67,59,143
457,0.14,"(28, 22)","(26, 7)",9,77,54,140,4,88,64,156
458,0.06,"(22, 12)","(3, 2)",8,105,71,184,5,144,98,247
459,0.12,"(11, 25)","(20, 26)",21,126,124,271,5,60,50,115
460,0.18,"(21, 27)","(9, 14)",4,105,84,193,8,53,47,108
461,0.08,"(8, 0)","(15, 0)",8,105,73,186,5,95,94,194
462,0.14,"(29, 10)","(0, 12)",4,70,56,130,2,46,43,91
463,0.14,"(9, 10)","(0, 0)",7,126,117,250,4,151,151,306
464,0.14,"(23, 27)","(27, 4)",14,210,185,409,12,102,103,217
465,0.12,"(6, 10)","(11, 16)",5,77,66,148,6,123,107,236
466,0.18,"(20, 12)","(1, 29)",20,98,100,218,4,60,51,115
467,0.14,"(20, 22)","(15, 28)",5,63,44,112,11,95,72,178
468,0.1,"(18, 18)","(14, 13)",8,35,17,60,8,67,40,115
469,0.08,"(16, 28)","(17, 3)",21,133,105,259,6,109,90,205
470,0.12,"(23, 0)","(10, 11)",7,70,51,128,5,81,69,155
471,0.06,"(2, 19)","(5, 29)",3,168,136,307,5,88,47,140
472,0.14,"(14, 16)","(5, 7)",12,210,200,422,5,46,35,86
473,0.04,"(22, 7)","(28, 25)",5,133,101,239,11,88,69,168
474,0.06,"(25, 27)","(17, 13)",10,91,54,155,3,81,76,160
475,0.16,"(13, 29)","(13, 1)",5,147,130,282,8,123,115,246
476,0.04,"(26, 19)","(5, 16)",16,133,111,260,6,179,143,328
477,0.14,"(21, 9)","(29, 5)",5,63,50,118,7,53,50,110
478,0.2,"(13, 17)","(1, 18)",4,84,65,153,5,81,71,157
479,0.1,"(1, 11)","(28, 22)",4,126,100,230,3,102,89,194
480,0.2,"(21, 13)","(10, 28)",7,105,89,201,6,88,82,176
481,0.06,"(26, 24)","(18, 14)",4,98,56,158,3,137,108,248
482,0.06,"(29, 23)","(3, 10)",3,63,44,110,4,123,85,212
483,0.12,"(3, 24)","(20, 23)",6,126,109,241,6,81,72,159
484,0.08,"(9, 7)","(27, 4)",14,84,62,160,6,123,98,227
485,0.06,"(28, 22)","(21, 29)",3,112,64,179,8,53,53,114
486,0.18,"(3, 21)","(4, 24)",8,28,14,50,7,46,32,85
487,0.02,"(10, 6)","(1, 28)",7,161,114,282,10,109,88,207
488,0.06,"(23, 17)","(9, 26)",4,119,101,224,7,130,111,248
489,0.06,"(1, 11)","(7, 12)",4,70,26,100,5,53,27,85
490,0.02,"(5, 2)","(17, 25)",4,238,146,388,5,74,47,126
491,0.04,"(2, 8)","(10, 11)",11,63,44,118,5,67,41,113
492,0.18,"(29, 14)","(3, 6)",7,133,107,247,18,60,61,139
493,0.02,"(11, 6)","(14, 19)",5,287,216,508,7,165,109,281
494,0.04,"(26, 8)","(13, 12)",9,105,60,174,15,60,64,139
495,0.04,"(3, 3)","(3, 2)",8,42,16,66,2,165,90,257
496,0.16,"(21, 5)","(26, 7)",5,42,28,75,5,46,23,74
497,0.08,"(25, 2)","(19, 1)",8,56,43,107,6,39,22,67
498,0.2,"(14, 25)","(9, 16)",8,112,83,203,8,60,49,117
499,0.02,"(25, 1)","(27, 8)",7,203,152,362,6,95,63,164
500,0.14,"(3, 25)","(24, 12)",4,189,169,362,3,109,97,209
501,0.14,"(1, 19)","(6, 2)",4,84,67,155,7,179,167,353
502,0.08,"(10, 21)","(28, 24)",9,119,105,233,5,88,72,165
503,0.16,"(15, 22)","(13, 21)",16,1,16,33,11,11,15,37
504,0.12,"(27, 21)","(22, 20)",8,56,40,104,6,109,66,181
505,0.16,"(17, 3)","(8, 15)",3,49,34,86,4,81,61,146
506,0.02,"(18, 28)","(27, 0)",10,189,168,367,6,67,57,130
507,0.14,"(12, 0)","(20, 27)",4,70,49,123,3,130,98,231
508,0.06,"(11, 7)","(8, 18)",14,56,49,119,8,74,50,132
509,0.04,"(8, 13)","(5, 19)",12,91,80,183,5,130,95,230
510,0.1,"(0, 1)","(24, 9)",2,98,69,169,2,95,77,174
511,0.06,"(0, 8)","(14, 28)",6,77,57,140,5,123,78,206
512,0.08,"(19, 26)","(10, 16)",10,91,79,180,5,74,59,138
513,0.2,"(25, 28)","(26, 1)",5,105,76,186,6,305,282,593
514,0.2,"(4, 10)","(27, 9)",10,126,115,251,9,123,116,248
515,0.12,"(21, 11)","(6, 22)",5,105,65,175,16,60,72,148
516,0.16,"(7, 3)","(8, 6)",6,84,60,150,11,60,55,126
517,0.08,"(10, 3)","(3, 27)",3,161,129,293,7,123,111,241
518,0.1,"(18, 5)","(6, 11)",8,84,52,144,4,60,58,122
519,0.06,"(12, 15)","(6, 29)",10,126,99,235,30,179,184,393
520,0.02,"(14, 23)","(22, 9)",8,217,130,355,7,214,143,364
521,0.12,"(28, 0)","(7, 12)",9,119,108,236,3,102,94,199
522,0.04,"(21, 11)","(28, 19)",13,168,156,337,6,74,64,144
523,0.16,"(8, 15)","(25, 16)",11,63,57,131,14,81,72,167
524,0.18,"(10, 15)","(2, 12)",4,49,24,77,6,46,26,78
525,0.2,"(18, 27)","(16, 14)",15,105,70,190,18,53,49,120
526,0.08,"(4, 0)","(5, 7)",5,77,45,127,5,53,42,100
527,0.02,"(29, 12)","(13, 0)",4,217,198,419,15,172,143,330
528,0.06,"(28, 1)","(12, 9)",5,70,55,130,7,67,54,128
529,0.2,"(9, 26)","(17, 3)",10,98,73,181,5,151,134,290
530,0.14,"(0, 10)","(29, 23)",6,98,78,182,9,102,95,206
531,0.18,"(7, 2)","(0, 7)",18,42,40,100,6,53,24,83
532,0.02,"(6, 20)","(22, 14)",3,77,49,129,16,109,101,226
533,0.08,"(11, 7)","(13, 10)",3,49,23,75,7,102,63,172
534,0.06,"(1, 15)","(11, 25)",3,63,46,112,4,60,48,112
535,0.14,"(22, 9)","(26, 13)",6,91,52,149,14,60,49,123
536,0.18,"(24, 29)","(13, 0)",10,119,103,232,5,60,60,125
537,0.1,"(5, 28)","(11, 27)",14,63,48,125,7,46,35,88
538,0.2,"(14, 20)","(22, 18)",13,70,59,142,7,109,102,218
539,0.08,"(4, 18)","(9, 27)",6,140,106,252,23,67,77,167
540,0.14,"(1, 11)","(9, 16)",10,70,46,126,8,95,71,174
541,0.12,"(7, 10)","(3, 1)",5,91,74,170,5,39,34,78
542,0.12,"(24, 16)","(6, 28)",13,84,71,168,8,81,77,166
543,0.04,"(21, 6)","(12, 9)",10,147,120,277,4,179,104,287
544,0.2,"(10, 7)","(16, 27)",14,63,48,125,9,74,58,141
545,0.16,"(12, 16)","(7, 10)",6,91,70,167,8,39,25,72
546,0.04,"(12, 22)","(21, 9)",14,175,131,320,13,165,172,350
547,0.18,"(25, 27)","(5, 16)",5,140,108,253,14,95,92,201
548,0.12,"(29, 23)","(15, 21)",39,126,132,297,16,60,44,120
549,0.04,"(6, 24)","(26, 10)",7,56,49,112,6,165,122,293
550,0.04,"(10, 20)","(16, 8)",3,126,80,209,6,172,123,301
551,0.06,"(9, 8)","(14, 20)",7,161,98,266,12,102,65,179
552,0.02,"(17, 1)","(17, 24)",12,119,77,208,19,179,141,339
553,0.12,"(4, 0)","(20, 2)",7,119,88,214,3,130,99,232
554,0.02,"(26, 14)","(4, 5)",18,189,158,365,5,235,156,396
555,0.08,"(14, 29)","(27, 10)",7,133,95,235,5,95,59,159
556,0.04,"(25, 6)","(29, 17)",9,133,105,247,11,109,85,205
557,0.04,"(2, 6)","(3, 2)",14,21,21,56,4,60,45,109
558,0.06,"(26, 9)","(27, 12)",5,63,29,97,7,46,37,90
559,0.16,"(17, 15)","(0, 12)",5,175,156,336,5,95,76,176
560,0.02,"(1, 7)","(29, 0)",4,161,118,283,5,116,84,205
561,0.12,"(2, 6)","(6, 14)",6,42,26,74,5,46,31,82
562,0.06,"(19, 1)","(19, 16)",7,182,135,324,4,123,105,232
563,0.14,"(5, 21)","(24, 1)",5,63,44,112,4,74,57,135
564,0.08,"(11, 14)","(14, 27)",11,140,110,261,24,109,102,235
565,0.02,"(22, 13)","(21, 6)",4,217,110,331,3,116,46,165
566,0.2,"(19, 2)","(1, 4)",6,126,102,234,7,144,141,292
567,0.18,"(16, 25)","(29, 12)",4,259,249,512,12,130,133,275
568,0.1,"(25, 11)","(4, 13)",5,91,64,160,7,32,34,73
569,0.2,"(9, 7)","(29, 13)",7,112,101,220,12,109,110,231
570,0.08,"(20, 10)","(26, 27)",6,84,54,144,27,74,91,192
571,0.02,"(9, 7)","(19, 7)",8,168,131,307,12,81,73,166
572,0.14,"(5, 23)","(25, 10)",19,91,87,197,5,123,114,242
573,0.2,"(1, 12)","(18, 3)",16,91,75,182,12,60,62,134
574,0.16,"(6, 8)","(26, 4)",17,98,83,198,15,116,113,244
575,0.08,"(10, 13)","(18, 5)",13,63,47,123,4,123,104,231
576,0.1,"(3, 2)","(19, 3)",11,105,83,199,4,67,53,124
577,0.2,"(6, 23)","(4, 9)",7,77,55,139,8,81,81,170
578,0.14,"(22, 29)","(7, 5)",10,126,107,243,4,88,76,168
579,0.08,"(28, 7)","(16, 29)",6,105,84,195,11,88,74,173
580,0.08,"(25, 26)","(24, 26)",4,49,27,80,6,11,13,30
581,0.08,"(27, 16)","(12, 10)",3,154,121,278,3,88,60,151
582,0.02,"(4, 21)","(20, 2)",5,245,176,426,10,200,154,364
583,0.2,"(14, 10)","(17, 0)",4,98,81,183,4,81,65,150
584,0.12,"(24, 24)","(5, 21)",13,98,87,198,12,102,98,212
585,0.2,"(11, 8)","(12, 29)",15,70,71,156,8,74,60,142
586,0.16,"(14, 16)","(0, 17)",10,84,65,159,11,102,94,207
587,0.1,"(21, 29)","(12, 24)",10,42,27,79,12,74,71,157
588,0.1,"(21, 15)","(24, 13)",7,49,27,83,10,32,16,58
589,0.2,"(16, 12)","(24, 29)",6,56,43,105,6,158,150,314
590,0.2,"(13, 22)","(4, 26)",5,77,58,140,7,130,128,265
591,0.02,"(27, 4)","(3, 6)",6,287,185,478,3,179,149,331
592,0.2,"(22, 18)","(13, 5)",7,161,154,322,7,60,49,116
593,0.16,"(8, 21)","(4, 3)",16,84,73,173,5,102,84,191
594,0.04,"(9, 17)","(21, 0)",24,133,123,280,12,130,122,264
595,0.2,"(15, 9)","(2, 5)",4,77,63,144,4,228,221,453
596,0.08,"(13, 10)","(25, 2)",18,133,106,257,8,158,117,283
597,0.18,"(22, 24)","(23, 16)",8,56,42,106,15,88,69,172
598,0.12,"(1, 25)","(15, 0)",18,112,112,242,10,158,140,308
599,0.14,"(28, 11)","(27, 9)",4,42,17,63,11,18,14,43
600,0.18,"(20, 3)","(4, 11)",5,56,36,97,6,46,48,100
601,0.04,"(24, 19)","(15, 10)",3,147,94,244,4,39,39,82
602,0.18,"(25, 21)","(19, 16)",6,49,41,96,4,60,44,108
603,0.06,"(15, 27)","(6, 10)",5,91,55,151,10,95,72,177
604,0.12,"(29, 12)","(15, 22)",10,77,54,141,4,67,50,121
605,0.02,"(5, 2)","(15, 13)",4,119,78,201,4,81,51,136
606,0.14,"(12, 6)","(29, 17)",4,133,101,238,3,109,88,200
607,0.04,"(17, 14)","(22, 1)",18,140,116,274,27,130,120,277
608,0.08,"(26, 21)","(15, 21)",8,119,88,215,4,32,27,63
609,0.16,"(9, 5)","(10, 27)",4,56,46,106,3,109,95,207
610,0.06,"(26, 17)","(7, 5)",5,140,77,222,7,95,67,169
611,0.18,"(17, 25)","(15, 9)",2,91,62,155,10,67,59,136
612,0.06,"(20, 0)","(18, 9)",4,56,23,83,5,39,29,73
613,0.14,"(24, 15)","(4, 3)",15,98,94,207,6,137,112,255
614,0.12,"(13, 0)","(7, 9)",3,42,31,76,4,60,50,114
615,0.08,"(29, 5)","(18, 17)",7,77,57,141,5,102,85,192
616,0.04,"(23, 14)","(6, 27)",11,161,120,292,3,200,151,354
617,0.14,"(18, 13)","(22, 25)",8,70,64,142,11,137,131,279
618,0.14,"(26, 14)","(4, 21)",14,119,90,223,5,74,60,139
619,0.06,"(9, 14)","(20, 28)",3,126,95,224,4,123,109,236
620,0.04,"(2, 16)","(27, 28)",7,70,58,135,9,88,72,169
621,0.18,"(3, 10)","(27, 13)",3,182,147,332,10,88,85,183
622,0.18,"(1, 8)","(11, 11)",5,105,68,178,3,39,34,76
623,0.12,"(29, 3)","(15, 19)",5,133,101,239,3,74,62,139
624,0.12,"(15, 0)","(9, 3)",2,35,19,56,3,39,18,60
625,0.2,"(14, 4)","(0, 18)",9,91,72,172,9,81,80,170
626,0.06,"(21, 15)","(7, 8)",6,119,71,196,11,109,77,197
627,0.2,"(11, 19)","(1, 11)",10,161,147,318,8,67,69,144
628,0.04,"(5, 4)","(16, 6)",14,63,51,128,8,109,76,193
629,0.2,"(27, 6)","(5, 26)",7,119,112,238,20,81,73,174
630,0.14,"(9, 28)","(24, 22)",12,98,81,191,11,88,80,179
631,0.06,"(15, 20)","(3, 24)",6,84,46,136,5,39,32,76
632,0.06,"(10, 9)","(29, 12)",9,98,80,187,8,109,100,217
633,0.16,"(23, 9)","(12, 1)",10,105,93,208,4,102,85,191
634,0.14,"(15, 5)","(20, 0)",19,70,68,157,6,137,135,278
635,0.14,"(23, 4)","(14, 21)",19,77,68,164,8,144,120,272
636,0.06,"(6, 2)","(20, 18)",8,259,206,473,6,221,196,423
637,0.04,"(11, 21)","(21, 3)",11,147,131,289,6,81,70,157
638,0.14,"(23, 0)","(18, 29)",4,105,86,195,18,95,100,213
639,0.1,"(19, 14)","(7, 0)",6,182,167,355,5,123,113,241
640,0.02,"(26, 15)","(9, 1)",8,154,136,298,7,144,104,255
641,0.06,"(16, 11)","(25, 0)",17,91,74,182,8,88,66,162
642,0.1,"(10, 25)","(26, 12)",6,112,74,192,4,67,54,125
643,0.1,"(11, 14)","(28, 10)",4,126,106,236,16,81,72,169
644,0.2,"(19, 22)","(7, 2)",3,161,134,298,4,151,142,297
645,0.08,"(0, 15)","(2, 7)",3,112,64,179,6,67,34,107
646,0.2,"(12, 20)","(3, 8)",11,168,148,327,5,102,94,201
647,0.08,"(0, 12)","(16, 3)",7,112,77,196,13,60,56,129
648,0.14,"(10, 1)","(18, 12)",6,119,99,224,6,67,47,120
649,0.2,"(19, 13)","(2, 14)",4,70,48,122,7,137,121,265
650,0.08,"(6, 27)","(28, 7)",6,84,61,151,5,81,79,165
651,0.02,"(19, 26)","(9, 13)",15,91,89,195,7,172,118,297
652,0.1,"(27, 27)","(2, 10)",8,70,58,136,4,88,65,157
653,0.04,"(25, 0)","(23, 22)",16,49,51,116,5,165,134,304
654,0.04,"(29, 24)","(1, 8)",3,119,66,188,14,200,191,405
655,0.06,"(13, 21)","(25, 22)",9,98,83,190,7,123,124,254
656,0.06,"(23, 5)","(22, 28)",6,119,90,215,14,102,72,188
657,0.2,"(5, 21)","(10, 13)",6,84,65,155,6,74,63,143
658,0.04,"(13, 2)","(15, 26)",60,161,186,407,11,221,191,423
659,0.06,"(21, 7)","(23, 13)",8,119,65,192,5,102,53,160
660,0.02,"(20, 28)","(17, 18)",5,119,100,224,9,144,103,256
661,0.2,"(4, 29)","(22, 24)",5,140,116,261,6,130,121,257
662,0.06,"(28, 18)","(5, 20)",11,147,118,276,10,95,75,180
663,0.2,"(22, 3)","(29, 12)",7,77,48,132,7,221,211,439
664,0.08,"(13, 14)","(5, 10)",5,84,42,131,8,116,115,239
665,0.04,"(16, 25)","(25, 25)",6,91,56,153,5,74,49,128
666,0.18,"(14, 13)","(16, 14)",8,28,11,47,8,53,34,95
667,0.04,"(13, 9)","(8, 6)",4,112,47,163,12,116,55,183
668,0.18,"(21, 18)","(13, 22)",5,56,31,92,7,53,39,99
669,0.14,"(22, 26)","(5, 6)",5,182,163,350,12,53,56,121
670,0.12,"(23, 0)","(4, 12)",5,91,78,174,9,67,58,134
671,0.2,"(12, 11)","(12, 16)",2,28,13,43,2,144,123,269
672,0.2,"(5, 26)","(21, 22)",5,112,79,196,14,102,90,206
673,0.12,"(28, 7)","(20, 24)",16,98,81,195,8,116,101,225
674,0.06,"(10, 29)","(2, 19)",8,70,57,135,12,53,38,103
675,0.1,"(21, 26)","(28, 8)",6,91,83,180,5,102,89,196
676,0.12,"(19, 4)","(2, 21)",11,105,80,196,6,95,67,168
677,0.14,"(28, 24)","(14, 5)",3,140,114,257,14,95,87,196
678,0.18,"(1, 10)","(28, 21)",7,63,53,123,7,151,142,300
679,0.1,"(10, 9)","(16, 17)",9,168,129,306,7,88,69,164
680,0.18,"(27, 11)","(4, 17)",17,168,153,338,9,60,49,118
681,0.18,"(21, 23)","(9, 26)",8,105,82,195,7,102,74,183
682,0.16,"(22, 6)","(17, 12)",19,42,34,95,15,25,33,73
683,0.18,"(0, 24)","(11, 14)",6,70,56,132,8,60,55,123
684,0.16,"(7, 27)","(20, 3)",4,105,79,188,6,200,196,402
685,0.02,"(29, 22)","(27, 0)",9,84,67,160,20,123,82,225
686,0.14,"(26, 29)","(26, 18)",7,63,42,112,12,74,77,163
687,0.16,"(0, 17)","(20, 26)",8,105,86,199,3,130,106,239
688,0.06,"(24, 1)","(18, 29)",8,112,99,219,6,137,103,246
689,0.08,"(0, 8)","(21, 20)",9,56,49,114,6,81,56,143
690,0.04,"(6, 10)","(16, 17)",6,112,72,190,9,137,81,227
691,0.14,"(17, 15)","(22, 8)",14,161,135,310,8,88,83,179
692,0.14,"(0, 28)","(13, 3)",7,98,88,193,4,95,79,178
693,0.1,"(2, 2)","(24, 3)",10,119,95,224,7,60,51,118
694,0.04,"(9, 25)","(9, 24)",6,70,34,110,6,39,24,69
695,0.14,"(28, 17)","(3, 14)",8,112,93,213,10,81,68,159
696,0.06,"(11, 13)","(7, 8)",6,133,99,238,8,67,61,136
697,0.2,"(8, 12)","(10, 1)",6,105,77,188,5,67,58,130
698,0.18,"(2, 11)","(1, 15)",3,63,41,107,4,60,50,114
699,0.06,"(17, 0)","(17, 11)",4,70,43,117,12,81,74,167
700,0.04,"(10, 25)","(25, 21)",11,189,147,347,6,144,100,250
701,0.06,"(28, 27)","(26, 13)",6,140,77,223,6,67,48,121
702,0.06,"(9, 21)","(16, 3)",4,42,32,78,8,144,120,272
703,0.16,"(23, 3)","(12, 6)",7,91,69,167,12,46,40,98
704,0.02,"(17, 23)","(29, 14)",9,168,135,312,9,151,120,280
705,0.04,"(27, 18)","(25, 2)",4,133,93,230,7,53,45,105
706,0.2,"(10, 8)","(6, 3)",9,91,66,166,8,67,58,133
707,0.2,"(18, 5)","(5, 0)",3,112,90,205,7,116,108,231
708,0.04,"(13, 1)","(12, 1)",11,21,12,44,8,18,13,39
709,0.16,"(7, 24)","(4, 14)",11,112,82,205,12,67,69,148
710,0.18,"(12, 13)","(25, 4)",7,98,89,194,5,130,118,253
711,0.16,"(28, 25)","(18, 13)",6,84,76,166,9,116,87,212
712,0.18,"(0, 27)","(9, 0)",4,105,80,189,5,123,117,245
713,0.04,"(9, 16)","(1, 14)",11,91,57,159,10,102,101,213
714,0.06,"(2, 3)","(27, 20)",10,161,140,311,3,109,99,211
715,0.12,"(18, 19)","(2, 10)",5,140,104,249,4,60,41,105
716,0.12,"(1, 0)","(13, 1)",13,77,51,141,10,60,53,123
717,0.06,"(7, 7)","(29, 2)",5,126,88,219,20,123,105,248
718,0.18,"(19, 0)","(18, 0)",4,1,4,9,3,18,6,27
719,0.2,"(23, 7)","(27, 15)",7,140,128,275,7,81,79,167
720,0.04,"(9, 11)","(24, 28)",13,140,125,278,13,144,107,264
721,0.02,"(11, 2)","(18, 16)",9,126,88,223,6,207,151,364
722,0.14,"(14, 29)","(2, 2)",9,147,129,285,14,88,80,182
723,0.04,"(23, 21)","(22, 8)",4,84,51,139,7,200,146,353
724,0.1,"(20, 23)","(13, 14)",11,91,63,165,6,74,45,125
725,0.12,"(14, 2)","(17, 22)",6,98,86,190,6,123,98,227
726,0.14,"(5, 5)","(4, 5)",18,21,19,58,5,25,18,48
727,0.02,"(19, 28)","(8, 17)",5,112,66,183,4,109,58,171
728,0.06,"(28, 21)","(28, 29)",6,98,53,157,11,81,52,144
729,0.06,"(18, 3)","(3, 22)",3,140,98,241,3,74,57,134
730,0.14,"(5, 29)","(17, 1)",8,56,49,113,7,109,106,222
731,0.04,"(18, 8)","(22, 14)",9,140,71,220,5,102,65,172
732,0.14,"(1, 8)","(29, 13)",6,91,83,180,8,102,87,197
733,0.08,"(1, 27)","(29, 2)",5,98,79,182,14,116,99,229
734,0.04,"(29, 28)","(14, 21)",8,91,42,141,10,158,101,269
735,0.1,"(4, 6)","(6, 28)",7,126,95,228,4,109,91,204
736,0.04,"(20, 16)","(20, 24)",7,168,107,282,8,74,51,133
737,0.2,"(3, 27)","(13, 28)",5,84,64,153,3,46,31,80
738,0.14,"(24, 11)","(29, 0)",7,63,53,123,5,116,110,231
739,0.2,"(25, 28)","(18, 2)",14,98,76,188,6,67,59,132
740,0.04,"(17, 15)","(28, 29)",3,140,95,238,4,53,41,98
741,0.2,"(17, 9)","(16, 2)",10,98,76,184,8,46,38,92
742,0.2,"(23, 3)","(16, 22)",6,133,94,233,5,95,79,179
743,0.18,"(20, 26)","(27, 11)",5,147,98,250,6,109,94,209
744,0.18,"(2, 2)","(13, 4)",3,49,29,81,2,39,29,70
745,0.1,"(29, 10)","(8, 15)",16,98,85,199,6,88,70,164
746,0.08,"(5, 26)","(7, 12)",6,91,76,173,6,123,70,199
747,0.06,"(21, 5)","(5, 21)",14,77,68,159,9,144,122,275
748,0.16,"(14, 4)","(21, 22)",5,63,48,116,7,74,72,153
749,0.1,"(1, 20)","(14, 28)",6,154,129,289,5,88,83,176
750,0.12,"(18, 2)","(0, 19)",7,77,46,130,7,67,64,138
751,0.18,"(12, 2)","(16, 13)",11,84,69,164,5,46,28,79
752,0.18,"(7, 22)","(18, 7)",9,70,53,132,4,67,64,135
753,0.2,"(1, 20)","(29, 20)",12,210,194,416,8,60,59,127
754,0.04,"(7, 3)","(26, 8)",5,182,114,301,6,158,114,278
755,0.16,"(8, 29)","(20, 20)",5,105,71,181,10,81,60,151
756,0.14,"(5, 0)","(28, 19)",4,119,103,226,7,88,86,181
757,0.12,"(16, 3)","(12, 28)",4,154,123,281,7,137,137,281
758,0.08,"(16, 25)","(19, 14)",10,70,47,127,6,88,53,147
759,0.08,"(7, 5)","(27, 0)",21,140,143,304,9,81,78,168
760,0.02,"(22, 21)","(22, 4)",7,98,63,168,25,228,181,434
761,0.18,"(13, 28)","(21, 11)",7,91,78,176,4,95,87,186
762,0.08,"(27, 12)","(9, 1)",12,77,71,160,13,130,121,264
763,0.12,"(12, 9)","(26, 21)",6,77,63,146,21,95,82,198
764,0.12,"(16, 6)","(26, 13)",5,119,76,200,17,95,97,209
765,0.06,"(8, 9)","(13, 16)",5,161,124,290,6,88,69,163
766,0.14,"(16, 11)","(26, 27)",7,91,68,166,9,81,78,168
767,0.2,"(23, 5)","(0, 29)",20,133,138,291,12,130,132,274
768,0.16,"(0, 20)","(14, 16)",18,119,100,237,11,60,61,132
769,0.2,"(0, 5)","(24, 7)",5,105,86,196,3,130,119,252
770,0.02,"(5, 10)","(12, 17)",4,126,64,194,12,39,47,98
771,0.12,"(0, 8)","(7, 6)",9,63,32,104,11,116,105,232
772,0.2,"(6, 29)","(20, 3)",3,98,81,182,5,81,69,155
773,0.2,"(27, 18)","(4, 17)",6,70,46,122,6,60,52,118
774,0.18,"(23, 12)","(20, 6)",6,49,36,91,21,81,77,179
775,0.2,"(16, 6)","(16, 16)",6,49,30,85,8,67,64,139
776,0.18,"(1, 17)","(13, 25)",8,77,68,153,6,74,65,145
777,0.08,"(28, 9)","(26, 28)",7,63,50,120,13,102,100,215
778,0.16,"(7, 11)","(7, 4)",7,84,68,159,15,67,54,136
779,0.16,"(14, 9)","(15, 15)",9,84,56,149,8,74,63,145
780,0.02,"(16, 19)","(14, 27)",4,154,85,243,9,88,93,190
781,0.12,"(10, 3)","(3, 9)",7,91,67,165,8,60,43,111
782,0.04,"(11, 29)","(5, 9)",3,84,44,131,2,165,134,301
783,0.04,"(12, 15)","(15, 20)",27,140,96,263,7,165,100,272
784,0.06,"(16, 13)","(14, 21)",6,77,52,135,8,151,117,276
785,0.2,"(19, 13)","(9, 27)",6,98,76,180,6,102,86,194
786,0.08,"(19, 16)","(13, 29)",4,112,91,207,6,102,73,181
787,0.14,"(6, 13)","(29, 19)",5,63,45,113,11,81,56,148
788,0.14,"(18, 10)","(17, 21)",15,70,66,151,5,116,107,228
789,0.02,"(3, 11)","(28, 27)",5,70,61,136,7,95,87,189
790,0.02,"(9, 14)","(28, 29)",5,238,190,433,7,130,97,234
791,0.18,"(8, 25)","(25, 0)",8,105,83,196,15,123,116,254
792,0.12,"(20, 18)","(19, 20)",7,49,23,79,7,32,13,52
793,0.06,"(25, 26)","(23, 17)",8,63,51,122,9,95,76,180
794,0.02,"(24, 23)","(28, 7)",18,252,215,485,13,95,76,184
795,0.1,"(24, 7)","(29, 24)",19,77,70,166,6,109,101,216
796,0.08,"(21, 5)","(27, 3)",4,42,29,75,6,53,46,105
797,0.14,"(16, 20)","(7, 16)",5,49,30,84,5,39,23,67
798,0.08,"(22, 25)","(17, 20)",20,49,44,113,3,102,83,188
799,0.18,"(16, 5)","(27, 12)",7,70,49,126,8,81,76,165
800,0.04,"(19, 15)","(26, 0)",6,63,53,122,5,116,104,225
801,0.18,"(15, 5)","(18, 28)",4,91,81,176,8,81,84,173
802,0.2,"(22, 12)","(14, 15)",6,70,48,124,6,67,61,134
803,0.2,"(28, 8)","(0, 3)",13,175,159,347,3,109,100,212
804,0.1,"(19, 3)","(11, 16)",5,91,62,158,6,95,69,170
805,0.02,"(4, 27)","(0, 14)",3,224,155,382,2,60,40,102
806,0.18,"(16, 5)","(15, 4)",5,42,23,70,8,1,8,17
807,0.06,"(9, 28)","(20, 14)",6,210,163,379,4,172,126,302
808,0.1,"(6, 14)","(28, 15)",5,126,100,231,8,102,94,204
809,0.18,"(11, 29)","(17, 14)",16,56,44,116,7,74,54,135
810,0.16,"(28, 29)","(26, 10)",7,77,60,144,5,144,145,294
811,0.18,"(2, 20)","(5, 15)",5,49,28,82,3,25,22,50
812,0.06,"(14, 11)","(27, 24)",7,126,108,241,7,81,68,156
813,0.16,"(12, 25)","(4, 22)",9,56,28,93,10,32,27,69
814,0.04,"(23, 4)","(3, 5)",9,126,74,209,4,179,117,300
815,0.12,"(11, 8)","(15, 13)",33,112,111,256,8,46,39,93
816,0.14,"(15, 15)","(28, 17)",2,112,83,197,3,116,91,210
817,0.2,"(17, 27)","(7, 10)",3,98,76,177,2,74,47,123
818,0.1,"(16, 29)","(5, 12)",23,42,51,116,4,123,101,228
819,0.06,"(24, 14)","(14, 24)",7,112,103,222,6,53,42,101
820,0.18,"(14, 24)","(6, 27)",10,196,174,380,7,242,222,471
821,0.2,"(2, 4)","(9, 20)",7,84,52,143,4,116,102,222
822,0.16,"(23, 7)","(26, 25)",8,126,100,234,8,116,114,238
823,0.1,"(13, 9)","(16, 7)",6,49,23,78,7,39,22,68
824,0.1,"(3, 12)","(6, 21)",4,91,62,157,5,81,59,145
825,0.08,"(29, 1)","(14, 14)",3,98,69,170,6,60,50,116
826,0.1,"(25, 0)","(25, 5)",8,63,43,114,9,53,35,97
827,0.2,"(4, 29)","(17, 13)",8,98,88,194,12,81,83,176
828,0.2,"(29, 19)","(6, 2)",5,98,69,172,43,95,125,263
829,0.16,"(19, 11)","(19, 15)",8,28,20,56,13,53,40,106
830,0.06,"(20, 0)","(2, 7)",6,203,161,370,6,109,73,188
831,0.02,"(28, 7)","(23, 22)",9,231,164,404,7,137,80,224
832,0.16,"(4, 10)","(9, 24)",11,98,80,189,11,46,49,106
833,0.12,"(3, 20)","(23, 15)",5,105,85,195,4,60,55,119
834,0.1,"(8, 15)","(2, 2)",16,119,109,244,5,46,36,87
835,0.14,"(26, 19)","(3, 15)",5,84,69,158,5,102,89,196
836,0.18,"(15, 1)","(26, 5)",6,84,65,155,21,88,101,210
837,0.08,"(0, 23)","(9, 23)",3,91,75,169,8,32,27,67
838,0.08,"(29, 25)","(8, 21)",18,84,64,166,10,123,108,241
839,0.14,"(15, 9)","(11, 7)",12,28,20,60,8,11,14,33
840,0.16,"(26, 22)","(14, 4)",13,91,72,176,17,74,73,164
841,0.2,"(24, 18)","(27, 4)",9,126,105,240,9,88,89,186
842,0.1,"(6, 2)","(2, 13)",4,126,82,212,5,39,26,70
843,0.2,"(26, 9)","(26, 2)",7,77,52,136,8,53,46,107
844,0.2,"(16, 26)","(6, 29)",4,63,48,115,10,53,52,115
845,0.14,"(10, 6)","(12, 20)",10,77,69,156,7,67,57,131
846,0.18,"(4, 25)","(29, 21)",17,112,106,235,5,53,48,106
847,0.2,"(28, 27)","(6, 4)",5,98,83,186,5,60,58,123
848,0.18,"(4, 22)","(11, 15)",8,56,50,114,11,46,42,99
849,0.04,"(25, 3)","(20, 3)",14,42,28,84,24,74,72,170
850,0.02,"(26, 24)","(22, 18)",6,56,48,110,6,53,29,88
851,0.18,"(7, 22)","(5, 17)",7,56,42,105,4,32,22,58
852,0.04,"(25, 24)","(24, 23)",5,119,53,177,6,32,14,52
853,0.08,"(20, 23)","(6, 3)",16,56,58,130,4,60,49,113
854,0.16,"(0, 25)","(10, 28)",14,63,42,119,17,32,39,88
855,0.2,"(4, 24)","(16, 24)",8,91,61,160,6,67,57,130
856,0.16,"(1, 13)","(11, 27)",11,98,77,186,6,67,65,138
857,0.14,"(6, 14)","(18, 11)",10,70,61,141,6,116,102,224
858,0.18,"(4, 28)","(1, 22)",12,56,38,106,12,32,30,74
859,0.08,"(7, 4)","(6, 8)",5,63,23,91,7,46,30,83
860,0.12,"(0, 8)","(8, 17)",14,77,67,158,13,39,36,88
861,0.02,"(24, 9)","(15, 9)",6,210,143,359,18,186,114,318
862,0.2,"(8, 5)","(29, 7)",6,91,80,177,13,67,65,145
863,0.08,"(16, 8)","(20, 3)",4,56,39,99,7,95,84,186
864,0.14,"(5, 21)","(4, 21)",5,35,10,50,12,39,30,81
865,0.1,"(12, 16)","(13, 8)",5,98,60,163,7,137,124,268
866,0.12,"(22, 3)","(23, 10)",5,105,80,190,5,53,39,97
867,0.08,"(17, 12)","(4, 7)",9,105,84,198,5,81,57,143
868,0.06,"(24, 15)","(0, 25)",7,119,84,210,7,74,59,140
869,0.02,"(15, 14)","(28, 23)",6,98,74,178,3,109,82,194
870,0.06,"(10, 9)","(9, 2)",7,112,70,189,17,158,113,288
871,0.12,"(0, 19)","(12, 2)",4,168,136,308,5,95,85,185
872,0.2,"(5, 10)","(21, 1)",5,133,106,244,8,158,135,301
873,0.16,"(5, 29)","(19, 4)",6,84,60,150,5,158,136,299
874,0.08,"(28, 15)","(12, 21)",4,84,64,152,4,74,62,140
875,0.04,"(8, 11)","(29, 9)",11,196,141,348,13,193,148,354
876,0.2,"(8, 17)","(5, 29)",4,203,189,396,5,102,80,187
877,0.04,"(9, 19)","(1, 10)",7,63,29,99,5,46,29,80
878,0.2,"(23, 11)","(1, 14)",7,168,144,319,18,158,158,334
879,0.16,"(14, 9)","(0, 14)",9,105,88,202,4,109,103,216
880,0.04,"(18, 13)","(5, 18)",4,203,183,390,12,116,93,221
881,0.16,"(1, 17)","(3, 9)",6,49,22,77,4,95,65,164
882,0.02,"(14, 10)","(7, 26)",3,252,181,436,7,172,80,259
883,0.04,"(9, 11)","(23, 12)",11,98,82,191,20,186,163,369
884,0.02,"(29, 23)","(21, 5)",12,224,149,385,9,179,132,320
885,0.12,"(13, 25)","(9, 10)",4,84,54,142,3,95,81,179
886,0.1,"(12, 20)","(5, 18)",18,56,47,121,6,32,15,53
887,0.14,"(5, 18)","(11, 28)",4,84,46,134,7,67,54,128
888,0.18,"(11, 28)","(11, 19)",6,98,67,171,11,32,28,71
889,0.02,"(3, 23)","(23, 26)",3,154,125,282,10,67,73,150
890,0.14,"(27, 8)","(14, 15)",4,91,56,151,6,81,58,145
891,0.14,"(27, 19)","(11, 11)",7,70,61,138,8,74,68,150
892,0.16,"(20, 19)","(26, 26)",18,91,91,200,4,67,60,131
893,0.18,"(15, 24)","(10, 22)",3,42,14,59,4,18,18,40
894,0.1,"(7, 21)","(17, 26)",9,105,81,195,6,81,77,164
895,0.12,"(26, 8)","(19, 0)",6,105,91,202,4,102,102,208
896,0.06,"(6, 11)","(4, 6)",14,28,24,66,10,25,31,66
897,0.14,"(26, 21)","(19, 4)",5,119,98,222,9,67,54,130
898,0.12,"(1, 14)","(19, 15)",12,70,56,138,6,88,67,161
899,0.14,"(5, 23)","(0, 17)",13,42,38,93,10,53,51,114
900,0.2,"(23, 12)","(11, 4)",13,84,69,166,4,130,114,248
901,0.16,"(10, 27)","(24, 20)",4,112,81,197,5,74,65,144
902,0.1,"(3, 15)","(20, 6)",4,119,93,216,12,53,49,114
903,0.18,"(20, 4)","(25, 3)",8,63,40,111,7,39,36,82
904,0.14,"(12, 0)","(24, 7)",5,91,58,154,5,67,48,120
905,0.12,"(8, 19)","(28, 17)",3,133,106,242,6,95,78,179
906,0.12,"(25, 2)","(1, 5)",8,140,110,258,4,102,85,191
907,0.16,"(7, 1)","(8, 5)",3,84,62,149,4,32,20,56
908,0.14,"(9, 4)","(20, 27)",11,119,97,227,5,74,60,139
909,0.02,"(9, 15)","(1, 8)",8,168,117,293,6,207,112,325
910,0.06,"(14, 6)","(16, 4)",6,28,9,43,15,60,46,121
911,0.18,"(23, 29)","(26, 19)",16,49,41,106,7,46,34,87
912,0.02,"(1, 6)","(8, 13)",8,119,48,175,21,109,104,234
913,0.12,"(3, 24)","(19, 28)",7,63,52,122,9,102,90,201
914,0.14,"(24, 14)","(7, 12)",20,126,92,238,4,60,41,105
915,0.08,"(26, 3)","(10, 15)",10,105,76,191,6,60,51,117
916,0.18,"(27, 5)","(24, 2)",4,35,18,57,5,32,20,57
917,0.1,"(27, 27)","(26, 7)",7,77,54,138,3,123,89,215
918,0.14,"(3, 16)","(5, 9)",2,63,37,102,7,53,46,106
919,0.14,"(3, 26)","(7, 16)",6,77,57,140,5,67,47,119
920,0.08,"(17, 29)","(26, 25)",4,77,45,126,4,74,53,131
921,0.04,"(24, 11)","(23, 22)",8,133,110,251,7,200,148,355
922,0.06,"(8, 27)","(18, 0)",4,126,76,206,6,74,76,156
923,0.04,"(4, 11)","(18, 5)",4,105,75,184,6,179,129,314
924,0.1,"(25, 10)","(18, 19)",9,49,38,96,4,130,102,236
925,0.12,"(12, 21)","(24, 26)",3,154,121,278,11,67,64,142
926,0.12,"(15, 27)","(5, 13)",4,77,49,130,10,67,54,131
927,0.12,"(27, 9)","(13, 18)",5,70,45,120,7,60,51,118
928,0.02,"(15, 17)","(25, 13)",7,119,77,203,16,186,136,338
929,0.1,"(19, 24)","(29, 28)",7,98,75,180,9,95,89,193
930,0.18,"(9, 10)","(18, 10)",10,105,82,197,9,60,64,133
931,0.16,"(24, 23)","(15, 4)",6,112,86,204,14,102,100,216
932,0.12,"(4, 15)","(13, 18)",14,42,42,98,6,74,57,137
933,0.02,"(5, 23)","(26, 22)",4,147,94,245,4,116,75,195
934,0.12,"(13, 25)","(16, 23)",26,42,54,122,3,25,18,46
935,0.08,"(14, 11)","(1, 23)",15,91,86,192,7,88,68,163
936,0.04,"(22, 29)","(17, 26)",15,56,29,100,4,60,24,88
937,0.2,"(25, 12)","(1, 16)",7,91,64,162,11,109,88,208
938,0.2,"(25, 26)","(17, 15)",8,133,102,243,9,53,54,116
939,0.1,"(13, 13)","(19, 6)",5,126,101,232,11,81,61,153
940,0.2,"(29, 17)","(4, 26)",11,98,79,188,2,102,77,181
941,0.06,"(22, 18)","(10, 10)",3,112,77,192,7,88,72,167
942,0.2,"(7, 1)","(10, 1)",5,42,23,70,15,25,35,75
943,0.18,"(13, 26)","(4, 10)",10,56,52,118,4,60,46,110
944,0.06,"(23, 5)","(6, 2)",7,70,42,119,10,81,85,176
945,0.06,"(1, 0)","(4, 0)",5,63,36,104,3,46,19,68
946,0.2,"(12, 2)","(3, 0)",3,63,42,108,3,32,23,58
947,0.08,"(24, 1)","(14, 29)",4,112,72,188,4,88,76,168
948,0.04,"(20, 14)","(28, 17)",13,105,81,199,6,95,80,181
949,0.2,"(25, 26)","(4, 13)",5,70,52,127,11,95,71,177
950,0.16,"(17, 22)","(22, 0)",7,84,66,157,20,95,101,216
951,0.2,"(19, 19)","(28, 26)",6,70,51,127,7,144,137,288
952,0.12,"(25, 19)","(21, 12)",4,70,43,117,6,109,81,196
953,0.04,"(15, 9)","(7, 13)",32,77,68,177,4,39,29,72
954,0.02,"(0, 24)","(27, 5)",7,245,149,401,6,158,109,273
955,0.04,"(5, 6)","(26, 16)",21,119,102,242,5,151,130,286
956,0.12,"(1, 0)","(21, 22)",10,147,136,293,4,102,87,193
957,0.18,"(2, 14)","(11, 4)",3,105,77,185,4,60,43,107
958,0.2,"(28, 22)","(14, 24)",4,56,38,98,3,39,23,65
959,0.04,"(0, 4)","(23, 5)",10,168,146,324,9,60,48,117
960,0.08,"(24, 0)","(12, 2)",7,119,64,190,6,102,70,178
961,0.02,"(2, 24)","(26, 11)",7,154,94,255,13,235,203,451
962,0.06,"(15, 26)","(27, 1)",8,119,102,229,12,186,159,357
963,0.18,"(11, 28)","(21, 28)",4,56,34,94,6,95,83,184
964,0.18,"(23, 29)","(29, 10)",12,133,111,256,15,81,78,174
965,0.14,"(12, 0)","(23, 27)",5,140,114,259,4,123,90,217
966,0.08,"(29, 22)","(15, 27)",7,147,99,253,3,102,89,194
967,0.12,"(11, 20)","(0, 11)",3,126,115,244,8,39,32,79
968,0.1,"(26, 23)","(27, 29)",7,49,39,95,4,60,43,107
969,0.14,"(5, 18)","(5, 26)",8,56,41,105,3,46,27,76
970,0.06,"(0, 13)","(13, 18)",3,119,85,207,3,144,110,257
971,0.16,"(23, 8)","(24, 20)",4,98,75,177,5,60,40,105
972,0.12,"(15, 1)","(0, 5)",7,112,81,200,3,144,134,281
973,0.14,"(5, 19)","(17, 28)",5,168,142,315,5,81,58,144
974,0.14,"(28, 25)","(11, 8)",16,84,60,160,5,53,43,101
975,0.16,"(17, 18)","(24, 2)",4,140,114,258,4,144,138,286
976,0.1,"(16, 19)","(1, 1)",12,154,148,314,10,60,51,121
977,0.2,"(8, 12)","(22, 7)",8,105,81,194,6,81,77,164
978,0.08,"(10, 26)","(11, 19)",14,98,79,191,5,81,49,135
979,0.18,"(1, 2)","(28, 29)",5,98,82,185,5,102,72,179
980,0.12,"(24, 4)","(10, 7)",4,98,82,184,6,81,58,145
981,0.2,"(22, 0)","(18, 16)",5,175,146,326,13,151,129,293
982,0.02,"(13, 10)","(0, 27)",5,91,56,152,6,88,90,184
983,0.12,"(4, 6)","(14, 0)",8,77,54,139,8,74,78,160
984,0.2,"(18, 2)","(20, 1)",15,140,110,265,26,25,43,94
985,0.18,"(12, 19)","(24, 9)",8,91,62,161,10,32,38,80
986,0.08,"(15, 0)","(19, 6)",6,70,59,135,9,53,39,101
987,0.18,"(6, 7)","(27, 10)",4,266,251,521,17,67,74,158
988,0.08,"(17, 25)","(24, 1)",4,133,106,243,9,158,147,314
989,0.12,"(14, 2)","(2, 23)",4,91,61,156,5,102,82,189
990,0.12,"(12, 21)","(14, 10)",9,49,32,90,7,60,57,124
991,0.08,"(10, 16)","(9, 26)",6,112,82,200,7,172,164,343
992,0.04,"(1, 10)","(15, 26)",4,140,103,247,5,144,133,282
993,0.16,"(12, 21)","(13, 14)",5,77,62,144,9,74,74,157
994,0.02,"(15, 22)","(7, 2)",8,266,205,479,7,158,115,280
995,0.02,"(22, 17)","(25, 9)",6,105,68,179,12,284,220,516
996,0.04,"(16, 16)","(26, 14)",12,175,148,335,15,95,76,186
997,0.1,"(1, 19)","(18, 13)",3,84,53,140,10,102,81,193
998,0.12,"(2, 19)","(3, 0)",4,105,59,168,11,74,78,163
999,0.02,"(25, 15)","(10, 2)",8,224,165,397,7,158,119,284
,,,,8.202,104.037,78.847,191.086,8.1,96.691,80.925,185.716
