0,0.04,"(29, 12)","(7, 10)",7,96,64,167,9,146,90,245
1,0.1,"(1, 18)","(28, 29)",5,96,78,179,6,116,111,233
2,0.08,"(19, 13)","(23, 29)",4,76,61,141,4,76,49,129
3,0.08,"(20, 4)","(26, 17)",5,121,95,221,5,126,83,214
4,0.14,"(10, 1)","(24, 4)",22,76,70,168,4,76,59,139
5,0.14,"(10, 26)","(9, 11)",11,81,81,173,6,46,35,87
6,0.16,"(9, 26)","(5, 22)",3,26,11,40,5,96,46,147
7,0.08,"(26, 6)","(10, 22)",15,111,110,236,17,116,97,230
8,0.08,"(24, 24)","(18, 24)",8,26,23,57,5,86,40,131
9,0.06,"(26, 21)","(5, 5)",7,86,70,163,8,96,85,189
10,0.02,"(3, 24)","(21, 7)",7,91,77,175,5,156,120,281
11,0.08,"(26, 9)","(12, 12)",6,61,54,121,16,76,63,155
12,0.18,"(19, 25)","(15, 26)",11,26,25,62,5,56,27,88
13,0.08,"(4, 8)","(24, 28)",34,71,83,188,18,96,96,210
14,0.2,"(9, 11)","(17, 11)",6,81,63,150,4,106,79,189
15,0.2,"(7, 26)","(9, 2)",5,131,114,250,6,76,55,137
16,0.04,"(8, 16)","(21, 14)",5,206,168,379,7,156,117,280
17,0.1,"(28, 24)","(29, 27)",2,81,60,143,3,56,26,85
18,0.14,"(10, 12)","(4, 9)",4,61,53,118,5,76,37,118
19,0.08,"(26, 24)","(18, 3)",6,141,116,263,5,156,138,299
20,0.16,"(26, 21)","(18, 0)",9,71,58,138,4,66,55,125
21,0.06,"(26, 25)","(28, 14)",12,56,51,119,12,46,43,101
22,0.06,"(23, 3)","(1, 6)",7,106,87,200,9,126,80,215
23,0.08,"(12, 29)","(14, 23)",10,96,73,179,10,86,52,148
24,0.18,"(2, 22)","(13, 25)",6,106,92,204,5,156,124,285
25,0.2,"(22, 24)","(18, 22)",8,21,16,45,4,16,14,34
26,0.02,"(4, 25)","(10, 17)",6,46,37,89,6,146,78,230
27,0.02,"(0, 12)","(12, 14)",4,256,173,433,8,176,119,303
28,0.12,"(26, 28)","(18, 16)",6,71,52,129,8,76,63,147
29,0.04,"(15, 9)","(18, 9)",11,111,69,191,7,136,68,211
30,0.12,"(15, 1)","(1, 9)",15,56,54,125,7,76,57,140
31,0.16,"(3, 21)","(10, 9)",9,61,56,126,8,96,86,190
32,0.14,"(1, 0)","(10, 29)",23,161,161,345,7,106,70,183
33,0.12,"(29, 17)","(6, 10)",2,86,70,158,8,86,66,160
34,0.1,"(16, 21)","(29, 22)",5,51,42,98,8,96,80,184
35,0.08,"(12, 25)","(14, 3)",6,71,51,128,5,66,50,121
36,0.12,"(1, 6)","(21, 7)",3,86,60,149,3,96,63,162
37,0.06,"(22, 27)","(4, 0)",5,141,96,242,3,96,63,162
38,0.06,"(21, 2)","(17, 26)",4,71,55,130,8,166,116,290
39,0.02,"(3, 20)","(15, 7)",3,191,183,377,17,166,86,269
40,0.12,"(5, 22)","(25, 3)",5,146,125,276,4,126,103,233
41,0.08,"(26, 19)","(5, 0)",7,61,57,125,10,86,82,178
42,0.02,"(29, 6)","(20, 21)",4,56,46,106,2,326,141,469
43,0.2,"(0, 3)","(1, 15)",7,56,36,99,14,36,27,77
44,0.14,"(2, 2)","(10, 14)",9,51,40,100,21,76,66,163
45,0.12,"(14, 24)","(27, 24)",6,111,93,210,3,116,85,204
46,0.12,"(19, 25)","(23, 16)",4,96,78,178,5,76,65,146
47,0.2,"(4, 27)","(8, 28)",3,26,17,46,4,76,51,131
48,0.18,"(11, 19)","(16, 25)",19,166,164,349,15,86,72,173
49,0.12,"(18, 29)","(20, 6)",16,81,78,175,6,156,108,270
50,0.18,"(19, 16)","(17, 24)",7,86,70,163,10,76,65,151
51,0.16,"(19, 17)","(12, 12)",16,36,35,87,6,36,25,67
52,0.16,"(1, 0)","(24, 1)",2,161,138,301,4,126,87,217
53,0.08,"(24, 29)","(18, 1)",6,116,97,219,16,156,108,280
54,0.14,"(23, 6)","(26, 1)",6,56,47,109,6,96,75,177
55,0.14,"(27, 11)","(7, 29)",5,66,57,128,10,106,75,191
56,0.14,"(3, 13)","(25, 11)",5,206,192,403,10,186,155,351
57,0.02,"(1, 24)","(13, 17)",4,156,108,268,7,276,194,477
58,0.04,"(8, 4)","(24, 11)",9,86,84,179,3,96,59,158
59,0.06,"(28, 18)","(17, 10)",3,81,58,142,6,86,58,150
60,0.08,"(23, 21)","(25, 2)",6,51,42,99,12,196,173,381
61,0.16,"(5, 8)","(6, 12)",10,56,41,107,8,46,31,85
62,0.12,"(8, 10)","(12, 5)",7,31,23,61,6,66,49,121
63,0.02,"(26, 10)","(4, 19)",9,216,178,403,3,166,98,267
64,0.08,"(27, 8)","(12, 9)",19,91,87,197,14,66,50,130
65,0.1,"(23, 24)","(14, 15)",3,71,51,125,6,106,60,172
66,0.04,"(29, 25)","(16, 25)",2,36,23,61,7,36,24,67
67,0.02,"(0, 12)","(15, 5)",7,196,165,368,5,106,72,183
68,0.18,"(0, 22)","(21, 9)",16,111,113,240,2,96,64,162
69,0.16,"(23, 8)","(3, 7)",5,136,110,251,8,86,65,159
70,0.06,"(5, 14)","(27, 27)",10,96,87,193,17,76,64,157
71,0.08,"(12, 15)","(15, 17)",19,36,38,93,6,66,54,126
72,0.06,"(25, 15)","(0, 25)",6,76,60,142,39,96,102,237
73,0.06,"(2, 22)","(22, 7)",9,111,97,217,3,96,86,185
74,0.04,"(20, 6)","(26, 25)",10,111,67,188,9,106,73,188
75,0.2,"(8, 25)","(13, 10)",7,41,34,82,6,96,54,156
76,0.02,"(26, 16)","(23, 6)",5,261,198,464,6,216,141,363
77,0.02,"(9, 16)","(19, 10)",25,256,244,525,5,76,40,121
78,0.12,"(29, 21)","(21, 29)",4,131,111,246,2,46,37,85
79,0.04,"(21, 2)","(22, 26)",4,211,177,392,3,196,112,311
80,0.16,"(28, 5)","(3, 1)",12,96,88,196,8,126,100,234
81,0.02,"(17, 1)","(28, 18)",5,151,131,287,9,186,95,290
82,0.04,"(5, 21)","(16, 10)",8,156,138,302,6,166,127,299
83,0.14,"(14, 5)","(18, 28)",5,96,86,187,14,96,86,196
84,0.14,"(16, 29)","(16, 1)",5,136,130,271,8,116,116,240
85,0.02,"(11, 18)","(6, 12)",8,161,91,260,8,66,32,106
86,0.12,"(10, 21)","(15, 15)",3,81,63,147,5,96,87,188
87,0.02,"(21, 7)","(16, 25)",15,236,207,458,23,286,206,515
88,0.04,"(29, 13)","(8, 3)",7,126,113,246,7,76,48,131
89,0.18,"(10, 10)","(16, 14)",4,96,75,175,9,126,78,213
90,0.08,"(17, 23)","(7, 29)",11,146,125,282,4,126,110,240
91,0.18,"(27, 24)","(10, 9)",11,81,70,162,8,196,134,338
92,0.02,"(4, 15)","(2, 10)",10,16,15,41,6,116,36,158
93,0.18,"(20, 26)","(2, 23)",5,121,115,241,10,76,63,149
94,0.16,"(0, 20)","(26, 24)",9,136,120,265,6,96,77,179
95,0.2,"(16, 25)","(20, 24)",23,41,41,105,13,146,119,278
96,0.08,"(10, 8)","(4, 0)",4,81,58,143,6,46,40,92
97,0.2,"(7, 2)","(20, 2)",9,126,112,247,4,66,48,118
98,0.08,"(29, 26)","(11, 4)",3,101,73,177,4,206,149,359
99,0.04,"(1, 28)","(8, 10)",6,126,102,234,10,116,87,213
100,0.18,"(27, 2)","(7, 15)",11,61,52,124,7,46,46,99
101,0.14,"(24, 25)","(27, 0)",4,96,79,179,3,96,85,184
102,0.02,"(8, 22)","(7, 2)",8,176,145,329,6,166,62,234
103,0.04,"(10, 4)","(14, 7)",6,61,51,118,4,156,88,248
104,0.2,"(15, 13)","(16, 5)",7,36,26,69,7,66,56,129
105,0.14,"(21, 17)","(27, 8)",4,66,54,124,3,76,57,136
106,0.12,"(9, 20)","(14, 1)",8,116,97,221,13,86,59,158
107,0.1,"(17, 13)","(24, 10)",6,91,71,168,3,136,103,242
108,0.02,"(28, 16)","(18, 11)",3,41,23,67,4,196,117,317
109,0.1,"(13, 19)","(7, 11)",6,141,104,251,5,116,94,215
110,0.12,"(10, 14)","(12, 27)",7,101,79,187,7,146,100,253
111,0.18,"(27, 4)","(17, 17)",8,91,69,168,9,126,102,237
112,0.18,"(1, 17)","(17, 17)",3,56,40,99,4,76,61,141
113,0.06,"(1, 18)","(15, 23)",8,56,48,112,7,146,100,253
114,0.04,"(13, 6)","(0, 21)",8,61,47,116,3,176,130,309
115,0.08,"(12, 8)","(13, 19)",15,111,93,219,9,116,86,211
116,0.2,"(2, 24)","(0, 6)",6,111,85,202,6,86,79,171
117,0.2,"(8, 21)","(19, 24)",22,51,62,135,8,116,93,217
118,0.08,"(25, 0)","(7, 11)",3,116,87,206,2,86,56,144
119,0.14,"(14, 3)","(12, 1)",7,76,65,148,21,76,64,161
120,0.18,"(17, 8)","(17, 21)",19,106,114,239,7,56,46,109
121,0.12,"(2, 14)","(29, 18)",12,206,198,416,14,86,84,184
122,0.08,"(19, 10)","(12, 18)",7,61,48,116,5,46,28,79
123,0.08,"(11, 1)","(20, 19)",7,141,120,268,5,166,129,300
124,0.2,"(8, 2)","(18, 10)",26,66,79,171,10,96,64,170
125,0.06,"(14, 27)","(26, 3)",5,121,92,218,10,66,53,129
126,0.18,"(14, 9)","(23, 7)",4,51,42,97,6,86,68,160
127,0.12,"(20, 3)","(17, 16)",7,46,42,95,3,106,93,202
128,0.12,"(26, 8)","(22, 26)",15,51,45,111,7,96,85,188
129,0.12,"(19, 25)","(27, 23)",5,81,65,151,12,96,79,187
130,0.04,"(10, 6)","(18, 2)",15,156,142,313,17,126,104,247
131,0.1,"(24, 27)","(6, 6)",14,116,96,226,7,116,84,207
132,0.16,"(24, 5)","(17, 2)",3,36,26,65,7,76,38,121
133,0.02,"(3, 5)","(10, 7)",16,106,82,204,13,56,61,130
134,0.16,"(7, 23)","(6, 13)",4,51,43,98,9,66,56,131
135,0.04,"(2, 2)","(23, 2)",12,106,95,213,6,166,89,261
136,0.1,"(11, 14)","(28, 9)",12,71,66,149,8,96,79,183
137,0.12,"(17, 0)","(10, 0)",5,41,27,73,5,26,25,56
138,0.02,"(1, 14)","(2, 7)",3,21,9,33,4,156,56,216
139,0.06,"(21, 16)","(11, 28)",6,136,115,257,9,136,112,257
140,0.06,"(9, 26)","(25, 5)",9,131,121,261,8,116,94,218
141,0.2,"(3, 6)","(24, 21)",5,106,86,197,4,126,104,234
142,0.1,"(20, 12)","(13, 25)",5,86,60,151,13,126,88,227
143,0.04,"(13, 15)","(11, 20)",7,86,44,137,9,136,76,221
144,0.04,"(10, 4)","(26, 27)",3,111,84,198,6,66,53,125
145,0.14,"(22, 12)","(27, 7)",11,81,68,160,5,56,46,107
146,0.08,"(6, 10)","(3, 6)",6,61,30,97,7,116,91,214
147,0.1,"(17, 21)","(5, 25)",5,111,86,202,10,126,86,222
148,0.14,"(21, 26)","(27, 18)",5,71,55,131,5,66,55,126
149,0.1,"(7, 7)","(14, 2)",4,41,31,76,5,76,59,140
150,0.04,"(21, 22)","(25, 3)",8,121,96,225,10,196,109,315
151,0.2,"(2, 29)","(22, 20)",5,56,43,104,6,86,60,152
152,0.14,"(14, 28)","(11, 5)",7,166,155,328,3,116,79,198
153,0.12,"(23, 28)","(25, 27)",4,31,20,55,3,86,39,128
154,0.08,"(0, 1)","(4, 12)",10,116,100,226,7,96,58,161
155,0.1,"(17, 22)","(0, 18)",7,91,73,171,4,66,34,104
156,0.14,"(5, 10)","(18, 23)",6,111,103,220,7,106,83,196
157,0.1,"(18, 12)","(24, 8)",4,91,74,169,5,116,87,208
158,0.04,"(27, 6)","(0, 6)",11,106,90,207,5,106,60,171
159,0.12,"(23, 16)","(14, 7)",11,56,47,114,14,96,69,179
160,0.18,"(14, 10)","(3, 21)",4,86,76,166,4,66,55,125
161,0.04,"(2, 7)","(7, 6)",6,101,76,183,8,176,107,291
162,0.16,"(5, 13)","(10, 20)",7,86,57,150,6,76,65,147
163,0.16,"(15, 28)","(15, 1)",4,91,75,170,5,136,100,241
164,0.2,"(2, 2)","(3, 4)",12,41,30,83,12,26,20,58
165,0.12,"(18, 3)","(19, 11)",6,51,39,96,9,126,81,216
166,0.2,"(25, 24)","(24, 14)",7,61,46,114,3,76,36,115
167,0.1,"(19, 10)","(10, 1)",7,111,96,214,9,66,65,140
168,0.1,"(11, 18)","(16, 28)",8,46,39,93,5,116,88,209
169,0.08,"(18, 11)","(26, 7)",8,141,112,261,14,86,88,188
170,0.1,"(5, 29)","(3, 21)",11,56,37,104,7,36,28,71
171,0.06,"(11, 9)","(27, 6)",6,146,116,268,10,136,86,232
172,0.08,"(16, 20)","(6, 27)",11,116,101,228,6,116,80,202
173,0.2,"(13, 19)","(24, 2)",12,151,144,307,5,116,75,196
174,0.16,"(23, 3)","(17, 24)",6,81,72,159,9,96,82,187
175,0.1,"(13, 10)","(16, 22)",10,66,65,141,14,126,109,249
176,0.14,"(15, 25)","(20, 17)",6,41,34,81,7,76,75,158
177,0.02,"(0, 19)","(6, 23)",9,96,53,158,6,76,29,111
178,0.2,"(24, 11)","(26, 11)",9,41,38,88,7,76,49,132
179,0.1,"(25, 28)","(25, 8)",5,86,73,164,6,136,86,228
180,0.12,"(4, 11)","(24, 23)",12,46,43,101,5,116,70,191
181,0.1,"(28, 19)","(28, 25)",5,46,33,84,10,86,41,137
182,0.08,"(14, 24)","(21, 16)",8,106,82,196,5,216,138,359
183,0.08,"(27, 1)","(21, 5)",4,56,39,99,4,106,38,148
184,0.04,"(11, 26)","(10, 9)",20,136,123,279,17,96,83,196
185,0.08,"(2, 3)","(14, 3)",7,66,58,131,6,146,111,263
186,0.16,"(3, 21)","(8, 29)",14,96,93,203,10,96,66,172
187,0.12,"(3, 28)","(28, 14)",7,96,76,179,8,146,108,262
188,0.06,"(22, 7)","(8, 8)",5,41,31,77,6,46,28,80
189,0.1,"(14, 19)","(25, 19)",10,121,106,237,10,116,89,215
190,0.18,"(15, 0)","(13, 25)",6,86,66,158,7,56,50,113
191,0.1,"(29, 11)","(16, 23)",7,141,124,272,3,86,57,146
192,0.04,"(26, 18)","(18, 5)",7,121,98,226,25,126,104,255
193,0.1,"(5, 6)","(10, 4)",6,81,51,138,3,76,47,126
194,0.06,"(12, 9)","(14, 4)",8,101,86,195,10,86,66,162
195,0.16,"(0, 29)","(19, 26)",6,156,138,300,16,96,97,209
196,0.04,"(28, 19)","(25, 22)",5,66,40,111,4,66,35,105
197,0.06,"(23, 22)","(8, 25)",7,116,85,208,7,96,70,173
198,0.18,"(23, 2)","(10, 12)",10,61,51,122,4,126,83,213
199,0.04,"(12, 25)","(7, 18)",3,116,71,190,5,96,61,162
200,0.02,"(25, 12)","(15, 25)",7,276,208,491,9,216,138,363
201,0.04,"(5, 14)","(10, 17)",8,131,97,236,5,156,80,241
202,0.06,"(3, 26)","(14, 8)",5,131,111,247,6,136,73,215
203,0.04,"(22, 14)","(1, 5)",6,126,110,242,10,146,108,264
204,0.2,"(0, 9)","(5, 4)",6,41,36,83,4,66,52,122
205,0.2,"(4, 7)","(6, 9)",10,46,36,92,11,56,45,112
206,0.2,"(4, 23)","(19, 13)",12,76,63,151,6,66,51,123
207,0.18,"(24, 17)","(25, 9)",13,51,52,116,12,126,91,229
208,0.16,"(11, 0)","(10, 11)",8,61,54,123,4,66,37,107
209,0.14,"(9, 24)","(12, 14)",5,66,48,119,12,56,48,116
210,0.2,"(11, 24)","(14, 15)",6,41,28,75,4,96,71,171
211,0.04,"(18, 12)","(8, 29)",13,71,71,155,16,76,68,160
212,0.18,"(16, 8)","(21, 9)",6,61,48,115,6,106,71,183
213,0.18,"(17, 12)","(11, 23)",15,71,70,156,15,66,45,126
214,0.02,"(8, 19)","(21, 16)",11,186,165,362,5,226,97,328
215,0.1,"(18, 26)","(9, 7)",5,86,72,163,10,116,105,231
216,0.02,"(2, 17)","(26, 29)",18,111,114,243,16,66,67,149
217,0.18,"(4, 12)","(10, 5)",8,66,55,129,9,46,49,104
218,0.02,"(17, 4)","(21, 28)",7,146,117,270,6,176,116,298
219,0.04,"(19, 5)","(18, 25)",13,81,68,162,9,146,92,247
220,0.16,"(7, 27)","(10, 14)",5,91,77,173,5,86,56,147
221,0.14,"(0, 7)","(12, 4)",6,56,46,108,28,86,91,205
222,0.08,"(22, 1)","(29, 21)",27,91,103,221,5,96,59,160
223,0.14,"(14, 15)","(21, 23)",7,91,76,174,11,126,107,244
224,0.2,"(4, 7)","(20, 8)",11,61,57,129,8,106,77,191
225,0.04,"(22, 5)","(20, 0)",12,86,49,147,6,86,57,149
226,0.14,"(12, 25)","(2, 6)",6,106,80,192,5,126,101,232
227,0.16,"(3, 15)","(4, 0)",4,116,96,216,15,166,147,328
228,0.06,"(10, 22)","(13, 24)",14,71,50,135,5,116,70,191
229,0.04,"(7, 0)","(25, 14)",6,116,102,224,6,86,72,164
230,0.14,"(27, 8)","(10, 24)",5,96,75,176,12,156,124,292
231,0.06,"(19, 24)","(27, 14)",11,116,104,231,6,126,93,225
232,0.14,"(18, 2)","(10, 12)",9,111,93,213,6,106,79,191
233,0.12,"(25, 20)","(24, 7)",5,66,55,126,4,86,58,148
234,0.02,"(29, 29)","(7, 18)",5,81,61,147,8,276,190,474
235,0.02,"(29, 20)","(7, 0)",19,186,169,374,5,266,203,474
236,0.04,"(14, 19)","(18, 2)",5,161,111,277,8,186,118,312
237,0.12,"(13, 25)","(11, 14)",11,51,42,104,4,86,65,155
238,0.16,"(8, 29)","(20, 13)",6,66,57,129,4,116,106,226
239,0.02,"(10, 6)","(26, 29)",8,216,179,403,10,66,52,128
240,0.06,"(1, 4)","(12, 22)",8,136,109,253,19,76,73,168
241,0.18,"(28, 10)","(6, 4)",9,126,110,245,8,106,80,194
242,0.14,"(8, 14)","(4, 9)",5,161,135,301,6,66,47,119
243,0.1,"(29, 0)","(15, 2)",6,36,24,66,7,106,87,200
244,0.18,"(10, 0)","(10, 12)",6,76,64,146,13,106,90,209
245,0.04,"(1, 4)","(14, 4)",6,86,65,157,8,286,183,477
246,0.02,"(0, 8)","(14, 21)",7,201,156,364,10,266,140,416
247,0.14,"(8, 9)","(18, 23)",7,71,50,128,6,46,46,98
248,0.06,"(13, 18)","(13, 15)",7,31,19,57,7,26,10,43
249,0.18,"(3, 24)","(18, 6)",7,76,68,151,7,76,60,143
250,0.04,"(23, 11)","(1, 4)",13,91,79,183,8,206,140,354
251,0.14,"(11, 26)","(29, 5)",17,76,79,172,6,76,51,133
252,0.14,"(11, 7)","(15, 27)",8,121,111,240,6,156,117,279
253,0.12,"(1, 17)","(5, 24)",7,66,57,130,4,86,35,125
254,0.04,"(20, 13)","(5, 5)",3,206,143,352,8,146,82,236
255,0.2,"(11, 1)","(1, 18)",6,76,64,146,5,106,88,199
256,0.02,"(29, 25)","(18, 12)",6,71,50,127,5,136,58,199
257,0.16,"(12, 3)","(13, 17)",10,41,32,83,3,106,66,175
258,0.16,"(18, 26)","(20, 11)",2,96,81,179,2,136,101,239
259,0.14,"(3, 5)","(24, 27)",14,56,59,129,3,106,71,180
260,0.14,"(29, 0)","(9, 1)",2,56,38,96,2,136,91,229
261,0.02,"(26, 27)","(1, 21)",6,121,71,198,5,116,103,224
262,0.04,"(4, 21)","(6, 12)",3,91,62,156,4,146,99,249
263,0.04,"(15, 20)","(2, 19)",4,66,47,117,8,96,58,162
264,0.16,"(24, 26)","(9, 23)",13,66,57,136,3,76,43,122
265,0.04,"(20, 3)","(6, 29)",5,191,161,357,9,76,61,146
266,0.1,"(0, 10)","(3, 28)",4,46,39,89,4,56,39,99
267,0.06,"(12, 5)","(9, 26)",7,46,35,88,9,146,99,254
268,0.04,"(21, 11)","(11, 9)",12,96,88,196,4,106,71,181
269,0.04,"(13, 5)","(7, 11)",3,111,68,182,6,126,88,220
270,0.16,"(1, 16)","(0, 8)",5,26,16,47,5,56,37,98
271,0.04,"(17, 24)","(14, 14)",12,156,125,293,5,176,86,267
272,0.08,"(13, 20)","(2, 23)",12,91,77,180,4,66,53,123
273,0.18,"(24, 26)","(24, 11)",5,56,37,98,6,96,69,171
274,0.04,"(28, 5)","(3, 4)",6,71,51,128,4,156,123,283
275,0.2,"(5, 12)","(18, 9)",11,116,108,235,11,86,67,164
276,0.18,"(8, 25)","(1, 11)",4,166,148,318,5,96,43,144
277,0.14,"(12, 12)","(28, 26)",6,111,98,215,7,76,58,141
278,0.12,"(7, 15)","(12, 2)",5,101,80,186,5,126,92,223
279,0.02,"(6, 12)","(4, 19)",9,191,128,328,8,186,94,288
280,0.02,"(1, 4)","(7, 8)",9,91,51,151,13,196,80,289
281,0.14,"(1, 21)","(1, 8)",6,41,29,76,6,56,43,105
282,0.16,"(5, 20)","(6, 24)",23,81,83,187,7,46,26,79
283,0.16,"(21, 10)","(24, 2)",10,71,61,142,18,76,72,166
284,0.2,"(13, 26)","(20, 5)",7,151,135,293,4,116,97,217
285,0.1,"(12, 15)","(6, 2)",6,81,69,156,6,156,89,251
286,0.14,"(23, 10)","(27, 3)",12,106,100,218,14,116,94,224
287,0.02,"(1, 15)","(24, 29)",6,226,178,410,7,156,138,301
288,0.04,"(15, 6)","(24, 28)",10,151,113,274,21,176,110,307
289,0.12,"(8, 24)","(28, 21)",3,61,45,109,8,56,51,115
290,0.04,"(27, 10)","(8, 20)",4,76,47,127,7,236,123,366
291,0.06,"(24, 10)","(0, 20)",8,121,86,215,7,116,82,205
292,0.14,"(13, 8)","(24, 8)",4,106,87,197,4,106,79,189
293,0.14,"(16, 19)","(25, 14)",7,151,143,301,7,66,61,134
294,0.18,"(19, 1)","(22, 25)",4,91,79,174,4,166,128,298
295,0.1,"(1, 8)","(15, 7)",4,141,123,268,5,56,55,116
296,0.16,"(11, 22)","(1, 16)",9,81,61,151,5,76,31,112
297,0.2,"(16, 5)","(27, 13)",11,81,76,168,6,96,81,183
298,0.2,"(18, 22)","(4, 10)",6,56,49,111,6,76,47,129
299,0.2,"(9, 25)","(3, 20)",11,46,32,89,5,96,47,148
300,0.16,"(7, 19)","(12, 16)",7,61,48,116,4,76,35,115
301,0.08,"(17, 28)","(22, 24)",23,91,84,198,17,76,56,149
302,0.2,"(4, 19)","(12, 3)",9,71,57,137,12,106,89,207
303,0.08,"(14, 11)","(16, 22)",6,96,74,176,9,86,66,161
304,0.04,"(9, 26)","(7, 15)",5,216,182,403,6,176,114,296
305,0.14,"(12, 9)","(10, 16)",8,36,24,68,6,106,86,198
306,0.18,"(11, 7)","(17, 12)",5,66,60,131,15,156,142,313
307,0.08,"(25, 11)","(3, 4)",3,101,86,190,6,136,103,245
308,0.2,"(5, 13)","(17, 7)",7,71,63,141,6,86,57,149
309,0.14,"(6, 25)","(5, 2)",7,121,101,229,4,196,162,362
310,0.18,"(22, 27)","(16, 14)",8,131,121,260,5,86,49,140
311,0.1,"(4, 10)","(26, 10)",6,171,155,332,5,176,142,323
312,0.16,"(18, 3)","(21, 9)",7,56,41,104,12,116,90,218
313,0.08,"(10, 22)","(9, 8)",5,91,77,173,22,176,157,355
314,0.02,"(9, 24)","(11, 1)",8,111,87,206,7,146,91,244
315,0.08,"(29, 15)","(23, 28)",4,161,130,295,7,66,55,128
316,0.06,"(22, 10)","(17, 16)",9,56,45,110,10,36,40,86
317,0.14,"(3, 2)","(22, 21)",10,151,125,286,5,86,66,157
318,0.04,"(4, 18)","(5, 23)",18,36,38,92,4,96,54,154
319,0.1,"(15, 6)","(0, 16)",3,121,110,234,4,56,51,111
320,0.1,"(2, 23)","(24, 28)",3,81,68,152,7,196,156,359
321,0.14,"(10, 23)","(26, 19)",12,91,87,190,10,116,104,230
322,0.1,"(21, 19)","(0, 11)",7,126,108,241,8,186,171,365
323,0.18,"(12, 6)","(28, 14)",24,86,94,204,5,66,48,119
324,0.04,"(9, 17)","(10, 6)",7,121,101,229,7,86,54,147
325,0.02,"(15, 1)","(11, 1)",15,51,32,98,5,96,36,137
326,0.08,"(27, 13)","(19, 28)",7,146,130,283,5,66,58,129
327,0.14,"(24, 24)","(13, 14)",16,116,102,234,10,86,65,161
328,0.16,"(16, 10)","(12, 21)",8,56,47,111,6,116,79,201
329,0.04,"(27, 16)","(4, 19)",9,146,110,265,6,146,104,256
330,0.02,"(8, 4)","(5, 6)",4,56,23,83,4,46,13,63
331,0.14,"(15, 21)","(27, 8)",10,101,90,201,13,96,87,196
332,0.14,"(28, 25)","(22, 17)",6,51,43,100,2,66,46,114
333,0.14,"(20, 9)","(0, 29)",5,61,47,113,5,106,102,213
334,0.04,"(23, 12)","(23, 18)",8,126,112,246,3,106,28,137
335,0.16,"(1, 23)","(5, 18)",3,36,26,65,9,66,50,125
336,0.08,"(5, 14)","(19, 14)",4,81,70,155,4,146,90,240
337,0.16,"(20, 17)","(2, 7)",9,126,122,257,7,56,45,108
338,0.04,"(2, 8)","(15, 24)",6,136,122,264,6,146,105,257
339,0.06,"(11, 17)","(12, 5)",3,56,41,100,14,56,40,110
340,0.06,"(23, 26)","(9, 4)",10,86,77,173,6,106,64,176
341,0.06,"(1, 26)","(29, 4)",12,121,108,241,3,76,60,139
342,0.06,"(20, 21)","(24, 4)",6,86,64,156,3,156,113,272
343,0.02,"(18, 20)","(17, 0)",4,186,153,343,4,226,149,379
344,0.06,"(2, 20)","(26, 0)",9,56,54,119,15,96,87,198
345,0.14,"(19, 13)","(16, 15)",5,66,56,127,8,26,28,62
346,0.16,"(1, 28)","(25, 29)",7,96,86,189,2,136,111,249
347,0.2,"(29, 8)","(6, 8)",7,71,67,145,8,126,99,233
348,0.06,"(11, 5)","(8, 8)",8,46,30,84,8,76,34,118
349,0.18,"(6, 22)","(6, 27)",9,46,44,99,6,86,69,161
350,0.2,"(22, 2)","(0, 9)",5,51,39,95,24,86,75,185
351,0.2,"(26, 24)","(18, 9)",9,91,71,171,7,96,73,176
352,0.1,"(6, 19)","(16, 22)",24,61,59,144,7,76,51,134
353,0.08,"(17, 27)","(19, 20)",6,56,35,97,11,86,62,159
354,0.14,"(28, 0)","(23, 8)",8,86,70,164,13,86,59,158
355,0.14,"(12, 1)","(5, 18)",7,71,63,141,9,106,81,196
356,0.12,"(10, 8)","(4, 8)",8,61,35,104,4,136,85,225
357,0.02,"(10, 2)","(20, 17)",4,201,161,366,3,86,83,172
358,0.16,"(13, 24)","(15, 15)",23,86,81,190,9,126,101,236
359,0.16,"(28, 13)","(16, 1)",3,101,84,188,5,156,131,292
360,0.08,"(9, 15)","(2, 26)",6,191,160,357,7,76,57,140
361,0.04,"(14, 1)","(25, 16)",7,136,122,265,10,116,66,192
362,0.02,"(29, 18)","(26, 25)",5,66,39,110,7,116,34,157
363,0.12,"(28, 27)","(29, 24)",12,66,58,136,7,36,20,63
364,0.14,"(6, 19)","(2, 25)",7,71,56,134,10,66,52,128
365,0.2,"(18, 14)","(9, 5)",7,241,225,473,5,46,29,80
366,0.14,"(12, 18)","(15, 20)",2,46,28,76,18,76,40,134
367,0.04,"(14, 0)","(13, 5)",12,41,30,83,7,96,40,143
368,0.06,"(6, 1)","(24, 17)",5,86,67,158,9,116,104,229
369,0.06,"(22, 5)","(23, 3)",13,76,55,144,10,76,29,115
370,0.18,"(6, 21)","(21, 29)",11,226,226,463,16,206,210,432
371,0.2,"(11, 29)","(9, 9)",7,66,61,134,4,56,46,106
372,0.16,"(27, 4)","(17, 15)",13,61,51,125,4,126,105,235
373,0.14,"(5, 16)","(9, 0)",11,101,98,210,4,86,70,160
374,0.14,"(11, 27)","(2, 11)",4,106,88,198,10,96,74,180
375,0.1,"(17, 9)","(11, 21)",5,41,31,77,11,46,47,104
376,0.14,"(17, 23)","(5, 27)",7,111,100,218,12,96,84,192
377,0.08,"(24, 8)","(28, 29)",14,81,76,171,6,56,48,110
378,0.12,"(18, 25)","(2, 20)",9,81,56,146,4,86,63,153
379,0.16,"(7, 17)","(0, 14)",5,81,61,147,6,26,17,49
380,0.2,"(1, 29)","(20, 8)",2,71,52,125,2,66,52,120
381,0.2,"(0, 25)","(28, 29)",4,126,113,243,3,86,74,163
382,0.06,"(3, 13)","(19, 21)",3,66,51,120,3,116,61,180
383,0.12,"(2, 5)","(22, 2)",11,146,131,288,10,76,57,143
384,0.18,"(8, 13)","(4, 10)",7,26,17,50,6,46,28,80
385,0.2,"(8, 10)","(8, 1)",4,111,103,218,4,146,127,277
386,0.08,"(27, 0)","(0, 22)",30,101,106,237,5,96,85,186
387,0.14,"(20, 23)","(25, 0)",6,101,80,187,8,86,73,167
388,0.16,"(5, 18)","(0, 18)",5,21,12,38,6,76,39,121
389,0.02,"(26, 8)","(26, 11)",10,26,25,61,7,76,30,113
390,0.12,"(24, 28)","(10, 14)",3,131,116,250,5,56,45,106
391,0.04,"(20, 14)","(19, 24)",3,76,48,127,10,146,99,255
392,0.16,"(28, 5)","(22, 7)",16,36,31,83,14,106,65,185
393,0.06,"(25, 25)","(2, 24)",4,86,66,156,5,46,36,87
394,0.14,"(11, 11)","(11, 15)",6,21,16,43,11,56,40,107
395,0.12,"(8, 22)","(10, 29)",4,36,25,65,3,106,96,205
396,0.2,"(16, 14)","(12, 18)",7,71,60,138,10,36,37,83
397,0.14,"(17, 16)","(1, 26)",5,76,60,141,8,136,94,238
398,0.1,"(23, 9)","(3, 25)",6,96,83,185,12,86,76,174
399,0.18,"(26, 21)","(18, 4)",15,136,133,284,13,126,120,259
400,0.06,"(27, 24)","(3, 1)",11,96,78,185,7,106,83,196
401,0.1,"(28, 26)","(0, 27)",9,66,64,139,9,146,117,272
402,0.08,"(10, 21)","(19, 5)",17,96,84,197,7,156,119,282
403,0.06,"(21, 5)","(13, 14)",7,156,131,294,6,56,44,106
404,0.16,"(23, 3)","(8, 22)",6,81,66,153,7,156,133,296
405,0.1,"(20, 21)","(12, 12)",5,171,146,322,5,96,54,155
406,0.14,"(18, 15)","(24, 6)",8,116,111,235,6,66,56,128
407,0.18,"(21, 5)","(0, 13)",10,91,88,189,4,36,34,74
408,0.06,"(25, 27)","(6, 7)",7,101,66,174,13,116,90,219
409,0.06,"(5, 13)","(9, 17)",8,61,37,106,5,96,53,154
410,0.18,"(4, 3)","(7, 9)",5,41,27,73,5,56,34,95
411,0.12,"(25, 9)","(17, 15)",8,61,48,117,6,106,62,174
412,0.14,"(0, 0)","(21, 18)",3,146,126,275,2,66,55,123
413,0.12,"(26, 27)","(17, 7)",2,71,43,116,4,86,49,139
414,0.16,"(20, 5)","(3, 0)",6,151,132,289,9,146,120,275
415,0.2,"(1, 8)","(26, 0)",7,136,128,271,5,96,68,169
416,0.1,"(29, 6)","(1, 6)",11,91,82,184,7,96,72,175
417,0.02,"(26, 17)","(27, 23)",6,41,31,78,7,136,46,189
418,0.2,"(0, 2)","(13, 2)",13,136,130,279,18,166,154,338
419,0.08,"(16, 20)","(14, 6)",5,111,86,202,7,76,44,127
420,0.16,"(28, 1)","(26, 2)",4,16,5,25,16,1,16,33
421,0.02,"(19, 19)","(24, 27)",16,111,97,224,7,236,184,427
422,0.04,"(19, 12)","(18, 23)",4,46,32,82,6,106,52,164
423,0.14,"(4, 4)","(8, 29)",6,121,104,231,6,86,84,176
424,0.06,"(13, 12)","(5, 15)",25,101,108,234,6,66,64,136
425,0.08,"(17, 18)","(9, 11)",9,71,61,141,7,86,38,131
426,0.02,"(23, 15)","(6, 1)",3,91,75,169,10,106,72,188
427,0.06,"(27, 12)","(27, 21)",3,116,91,210,5,76,63,144
428,0.2,"(13, 29)","(3, 5)",3,96,77,176,17,116,94,227
429,0.16,"(15, 26)","(12, 4)",4,76,57,137,7,86,66,159
430,0.04,"(22, 5)","(27, 22)",11,56,55,122,9,106,70,185
431,0.1,"(25, 15)","(7, 25)",15,96,91,202,7,86,74,167
432,0.18,"(3, 15)","(0, 20)",3,46,22,71,3,146,132,281
433,0.14,"(27, 22)","(3, 24)",10,111,92,213,7,76,71,154
434,0.06,"(29, 28)","(3, 14)",2,76,66,144,5,76,51,132
435,0.14,"(10, 11)","(21, 0)",20,121,109,250,7,76,60,143
436,0.2,"(22, 18)","(19, 8)",4,81,69,154,8,86,62,156
437,0.2,"(16, 15)","(9, 0)",8,126,112,246,7,86,71,164
438,0.2,"(15, 25)","(28, 9)",6,91,69,166,11,76,69,156
439,0.06,"(5, 4)","(7, 5)",7,46,38,91,7,56,46,109
440,0.16,"(19, 19)","(18, 11)",6,51,31,88,5,76,67,148
441,0.04,"(13, 12)","(11, 28)",6,121,99,226,6,156,139,301
442,0.08,"(16, 5)","(18, 20)",3,91,71,165,5,156,92,253
443,0.18,"(11, 1)","(28, 7)",8,46,43,97,8,126,75,209
444,0.06,"(29, 28)","(17, 8)",14,211,167,392,5,126,77,208
445,0.02,"(3, 2)","(6, 13)",14,66,63,143,14,116,70,200
446,0.12,"(25, 24)","(28, 7)",5,91,81,177,7,126,88,221
447,0.06,"(0, 24)","(0, 21)",11,21,17,49,11,36,21,68
448,0.16,"(0, 2)","(27, 29)",13,91,88,192,3,96,81,180
449,0.16,"(2, 0)","(12, 24)",12,86,72,170,5,66,44,115
450,0.14,"(23, 10)","(19, 19)",12,76,65,153,11,36,34,81
451,0.2,"(16, 23)","(17, 8)",6,111,94,211,8,136,102,246
452,0.18,"(20, 18)","(2, 15)",7,151,137,295,10,76,48,134
453,0.18,"(22, 19)","(7, 16)",11,76,63,150,4,106,93,203
454,0.08,"(15, 0)","(0, 10)",10,71,62,143,16,96,84,196
455,0.08,"(20, 17)","(8, 12)",3,76,59,138,8,136,97,241
456,0.02,"(26, 0)","(1, 25)",5,156,118,279,7,206,134,347
457,0.1,"(8, 24)","(13, 13)",3,81,62,146,7,126,86,219
458,0.14,"(17, 5)","(17, 25)",9,76,61,146,6,86,68,160
459,0.06,"(12, 24)","(20, 1)",29,111,120,260,4,116,82,202
460,0.04,"(20, 23)","(18, 4)",8,91,80,179,5,56,44,105
461,0.1,"(4, 27)","(6, 23)",3,51,40,94,5,96,46,147
462,0.06,"(20, 9)","(24, 12)",19,106,96,221,20,76,52,148
463,0.2,"(5, 10)","(4, 27)",13,66,64,143,15,116,89,220
464,0.1,"(28, 20)","(3, 27)",4,126,99,229,11,166,136,313
465,0.2,"(14, 7)","(9, 23)",6,146,132,284,5,96,57,158
466,0.08,"(4, 15)","(25, 9)",15,111,104,230,6,106,55,167
467,0.06,"(24, 9)","(8, 17)",5,51,41,97,9,96,73,178
468,0.04,"(12, 5)","(19, 0)",8,36,29,73,7,56,40,103
469,0.06,"(28, 1)","(20, 15)",5,86,51,142,6,136,57,199
470,0.06,"(0, 28)","(4, 19)",29,31,41,101,4,36,24,64
471,0.18,"(6, 23)","(12, 13)",11,51,36,98,8,46,43,97
472,0.12,"(9, 17)","(23, 7)",10,116,93,219,9,76,58,143
473,0.08,"(17, 21)","(24, 23)",3,66,43,112,12,36,42,90
474,0.06,"(15, 0)","(7, 2)",5,51,39,95,4,76,36,116
475,0.16,"(9, 27)","(9, 10)",6,91,72,169,5,96,82,183
476,0.18,"(21, 7)","(19, 1)",11,96,85,192,13,86,59,158
477,0.12,"(26, 24)","(29, 7)",4,76,68,148,4,106,92,202
478,0.06,"(17, 18)","(23, 2)",14,101,84,199,7,136,92,235
479,0.06,"(1, 28)","(22, 29)",6,56,43,105,5,166,145,316
480,0.02,"(0, 5)","(2, 18)",11,171,150,332,5,106,47,158
481,0.04,"(2, 28)","(12, 14)",4,186,135,325,3,96,44,143
482,0.1,"(14, 23)","(19, 26)",6,101,87,194,9,76,65,150
483,0.08,"(17, 24)","(26, 6)",10,96,64,170,7,176,119,302
484,0.14,"(25, 27)","(26, 0)",6,231,221,458,5,86,68,159
485,0.14,"(26, 4)","(22, 15)",6,56,45,107,7,56,37,100
486,0.12,"(0, 21)","(15, 7)",4,111,90,205,4,106,53,163
487,0.08,"(20, 8)","(4, 9)",4,156,119,279,7,106,58,171
488,0.14,"(5, 15)","(22, 9)",8,146,123,277,4,136,107,247
489,0.08,"(4, 24)","(3, 12)",12,56,45,113,5,56,29,90
490,0.16,"(21, 3)","(25, 4)",10,46,39,95,4,66,48,118
491,0.12,"(28, 28)","(13, 5)",8,81,71,160,5,76,75,156
492,0.04,"(18, 8)","(8, 25)",11,81,67,159,7,246,172,425
493,0.04,"(16, 27)","(3, 23)",6,71,41,118,7,86,52,145
494,0.16,"(19, 25)","(23, 17)",12,131,121,264,5,86,64,155
495,0.2,"(3, 10)","(11, 18)",6,71,58,135,6,136,100,242
496,0.1,"(4, 11)","(7, 7)",4,36,23,63,8,56,47,111
497,0.2,"(7, 16)","(8, 21)",11,71,63,145,4,76,34,114
498,0.2,"(29, 4)","(21, 17)",37,76,86,199,9,106,88,203
499,0.16,"(28, 5)","(18, 19)",8,136,122,266,12,126,97,235
500,0.14,"(14, 2)","(1, 12)",3,116,104,223,5,186,163,354
501,0.1,"(9, 23)","(12, 28)",6,96,75,177,6,76,44,126
502,0.02,"(22, 22)","(19, 22)",5,101,51,157,5,96,45,146
503,0.1,"(20, 9)","(15, 20)",5,41,31,77,4,86,70,160
504,0.2,"(15, 10)","(26, 0)",5,66,54,125,4,156,126,286
505,0.18,"(29, 26)","(21, 22)",3,41,24,68,7,46,33,86
506,0.06,"(28, 5)","(2, 26)",6,151,129,286,8,96,60,164
507,0.04,"(10, 14)","(14, 9)",7,46,39,92,6,126,98,230
508,0.16,"(13, 13)","(15, 12)",8,21,11,40,6,36,10,52
509,0.2,"(22, 14)","(16, 12)",7,41,23,71,14,26,25,65
510,0.1,"(13, 5)","(15, 27)",19,116,104,239,8,96,54,158
511,0.04,"(13, 27)","(13, 28)",8,16,9,33,8,46,13,67
512,0.06,"(1, 15)","(13, 3)",14,81,64,159,8,136,101,245
513,0.12,"(25, 5)","(18, 26)",9,96,82,187,9,96,76,181
514,0.02,"(16, 1)","(8, 18)",11,66,59,136,9,76,65,150
515,0.14,"(1, 11)","(25, 10)",6,71,66,143,3,116,75,194
516,0.1,"(10, 29)","(25, 2)",6,56,49,111,4,66,46,116
517,0.08,"(24, 23)","(23, 4)",4,116,104,224,6,136,90,232
518,0.06,"(28, 7)","(29, 26)",3,71,53,127,7,76,61,144
519,0.04,"(14, 29)","(22, 7)",3,131,78,212,12,146,97,255
520,0.1,"(7, 26)","(1, 14)",10,46,34,90,20,66,56,142
521,0.06,"(1, 19)","(10, 16)",7,36,24,67,3,106,59,168
522,0.12,"(15, 22)","(29, 0)",5,376,369,750,12,56,52,120
523,0.08,"(4, 3)","(20, 19)",10,201,184,395,9,156,94,259
524,0.16,"(21, 16)","(9, 3)",8,71,53,132,5,56,51,112
525,0.04,"(20, 5)","(13, 10)",5,51,23,79,6,86,27,119
526,0.02,"(1, 29)","(15, 0)",2,151,99,252,4,126,84,214
527,0.02,"(23, 4)","(19, 23)",4,151,102,257,4,136,71,211
528,0.12,"(4, 10)","(18, 25)",4,116,96,216,6,76,50,132
529,0.12,"(10, 12)","(4, 6)",6,96,84,186,10,86,67,163
530,0.18,"(24, 27)","(10, 13)",5,61,49,115,9,76,66,151
531,0.02,"(29, 6)","(24, 8)",9,26,18,53,7,246,132,385
532,0.2,"(12, 13)","(5, 26)",16,96,90,202,5,146,115,266
533,0.06,"(12, 11)","(20, 0)",14,96,98,208,12,76,79,167
534,0.04,"(29, 8)","(7, 27)",4,81,60,145,8,136,80,224
535,0.18,"(9, 18)","(12, 6)",3,71,53,127,11,96,73,180
536,0.06,"(12, 14)","(12, 6)",5,86,59,150,4,116,76,196
537,0.08,"(0, 10)","(4, 6)",5,66,37,108,11,36,29,76
538,0.12,"(0, 0)","(9, 11)",8,76,65,149,6,76,50,132
539,0.08,"(20, 13)","(16, 16)",3,56,39,98,11,76,37,124
540,0.16,"(2, 28)","(21, 21)",7,101,86,194,5,116,93,214
541,0.04,"(26, 13)","(2, 25)",4,171,149,324,9,116,79,204
542,0.1,"(27, 25)","(29, 4)",4,61,50,115,5,106,97,208
543,0.12,"(6, 9)","(24, 5)",2,131,120,253,9,66,60,135
544,0.06,"(12, 14)","(28, 3)",6,71,59,136,12,106,83,201
545,0.14,"(2, 23)","(27, 7)",11,96,88,195,8,126,93,227
546,0.18,"(8, 2)","(19, 21)",11,66,58,135,13,66,55,134
547,0.04,"(24, 17)","(4, 29)",7,111,105,223,4,126,95,225
548,0.1,"(7, 27)","(1, 10)",15,81,82,178,12,166,126,304
549,0.2,"(18, 10)","(10, 22)",5,86,76,167,10,86,74,170
550,0.18,"(13, 12)","(27, 19)",8,116,106,230,13,156,121,290
551,0.04,"(25, 23)","(21, 0)",11,201,176,388,17,86,87,190
552,0.04,"(20, 17)","(25, 13)",9,96,82,187,6,126,56,188
553,0.16,"(12, 1)","(13, 12)",5,56,44,105,6,86,67,159
554,0.06,"(27, 2)","(1, 4)",4,116,94,214,7,66,58,131
555,0.16,"(24, 28)","(10, 20)",4,61,46,111,3,86,63,152
556,0.04,"(8, 12)","(22, 4)",6,166,137,309,14,126,77,217
557,0.1,"(6, 29)","(7, 12)",9,76,60,145,5,96,56,157
558,0.16,"(9, 17)","(29, 25)",4,216,196,416,3,96,78,177
559,0.2,"(5, 20)","(16, 28)",5,156,149,310,3,106,85,194
560,0.14,"(24, 17)","(11, 27)",6,81,70,157,7,66,47,120
561,0.02,"(18, 1)","(29, 26)",15,91,84,190,13,116,122,251
562,0.08,"(6, 13)","(2, 12)",9,41,23,73,3,56,18,77
563,0.04,"(12, 9)","(23, 29)",7,121,101,229,7,116,104,227
564,0.18,"(16, 2)","(9, 19)",8,66,63,137,17,76,64,157
565,0.04,"(24, 22)","(9, 0)",10,91,86,187,18,176,133,327
566,0.2,"(13, 5)","(9, 14)",11,81,79,171,10,96,67,173
567,0.04,"(8, 25)","(28, 10)",9,86,74,169,2,126,74,202
568,0.2,"(23, 11)","(14, 29)",6,161,145,312,11,106,82,199
569,0.14,"(4, 13)","(21, 0)",20,86,82,188,13,86,71,170
570,0.2,"(10, 6)","(18, 17)",6,81,74,161,9,36,38,83
571,0.14,"(8, 1)","(13, 2)",4,61,34,99,5,66,38,109
572,0.2,"(15, 1)","(13, 10)",10,106,99,215,5,86,62,153
573,0.1,"(15, 5)","(6, 25)",2,91,77,170,2,106,72,180
574,0.16,"(15, 28)","(15, 5)",10,71,58,139,14,56,47,117
575,0.14,"(5, 13)","(2, 21)",9,66,57,132,13,176,168,357
576,0.16,"(14, 23)","(5, 19)",9,131,113,253,17,36,40,93
577,0.08,"(5, 2)","(27, 10)",6,76,63,145,6,186,126,318
578,0.1,"(28, 10)","(25, 23)",5,61,45,111,5,116,76,197
579,0.08,"(29, 11)","(14, 21)",30,51,63,144,10,76,69,155
580,0.14,"(15, 1)","(29, 23)",5,136,126,267,4,136,102,242
581,0.2,"(19, 27)","(16, 26)",6,26,20,52,9,26,19,54
582,0.2,"(12, 29)","(6, 12)",6,86,62,154,5,96,69,170
583,0.08,"(13, 3)","(12, 17)",3,71,57,131,9,86,89,184
584,0.02,"(26, 15)","(8, 14)",3,96,88,187,5,136,77,218
585,0.04,"(17, 2)","(1, 22)",8,151,115,274,4,76,59,139
586,0.1,"(3, 9)","(4, 2)",11,86,79,176,5,116,50,171
587,0.12,"(25, 26)","(20, 6)",4,106,88,198,14,96,74,184
588,0.06,"(20, 7)","(28, 27)",10,71,67,148,19,116,85,220
589,0.12,"(26, 8)","(24, 0)",6,61,54,121,8,66,43,117
590,0.04,"(2, 24)","(23, 28)",5,111,101,217,4,136,74,214
591,0.14,"(8, 27)","(5, 17)",6,66,45,117,8,46,33,87
592,0.08,"(6, 7)","(17, 14)",4,36,28,68,11,216,174,401
593,0.04,"(24, 9)","(21, 16)",11,66,42,119,4,96,43,143
594,0.06,"(22, 29)","(8, 29)",6,106,85,197,9,66,49,124
595,0.02,"(3, 15)","(18, 3)",2,181,142,325,3,96,61,160
596,0.14,"(21, 10)","(2, 18)",5,66,59,130,5,76,59,140
597,0.16,"(22, 4)","(27, 10)",6,66,58,130,4,136,73,213
598,0.08,"(14, 15)","(10, 6)",4,156,125,285,10,136,104,250
599,0.18,"(8, 23)","(19, 13)",4,46,28,78,5,96,66,167
600,0.18,"(19, 0)","(23, 8)",4,51,40,95,24,76,71,171
601,0.18,"(28, 17)","(15, 26)",6,121,104,231,6,56,52,114
602,0.02,"(6, 20)","(4, 8)",9,46,44,99,4,36,25,65
603,0.06,"(14, 10)","(18, 26)",13,136,118,267,5,96,88,189
604,0.2,"(20, 4)","(21, 27)",8,91,72,171,8,96,80,184
605,0.04,"(4, 14)","(6, 14)",15,16,16,47,5,166,97,268
606,0.12,"(11, 26)","(16, 16)",4,91,76,171,5,126,90,221
607,0.14,"(7, 6)","(14, 15)",6,111,91,208,4,66,50,120
608,0.06,"(12, 29)","(4, 10)",10,76,57,143,6,136,93,235
609,0.1,"(7, 24)","(3, 15)",24,41,44,109,9,56,47,112
610,0.18,"(18, 26)","(24, 26)",4,61,50,115,6,106,80,192
611,0.1,"(23, 27)","(3, 1)",6,121,91,218,6,126,117,249
612,0.14,"(18, 25)","(1, 25)",4,116,101,221,7,136,110,253
613,0.12,"(15, 2)","(26, 22)",2,101,79,182,10,156,125,291
614,0.08,"(1, 23)","(13, 24)",2,91,70,163,2,96,66,164
615,0.02,"(14, 5)","(15, 23)",6,106,99,211,13,116,77,206
616,0.14,"(16, 4)","(1, 16)",6,51,41,98,25,96,102,223
617,0.16,"(0, 26)","(28, 8)",7,131,118,256,9,96,86,191
618,0.16,"(12, 22)","(28, 20)",4,116,105,225,6,96,72,174
619,0.04,"(17, 0)","(10, 1)",9,161,114,284,2,96,70,168
620,0.04,"(7, 10)","(29, 21)",8,91,79,178,14,86,85,185
621,0.04,"(18, 19)","(12, 17)",10,136,100,246,4,76,21,101
622,0.02,"(1, 24)","(4, 12)",4,131,67,202,5,66,47,118
623,0.02,"(23, 18)","(23, 24)",4,81,46,131,7,256,184,447
624,0.16,"(2, 3)","(26, 9)",7,96,87,190,11,126,107,244
625,0.12,"(16, 13)","(16, 14)",7,1,7,15,5,66,36,107
626,0.18,"(20, 17)","(29, 7)",9,91,82,182,8,116,100,224
627,0.06,"(0, 6)","(13, 27)",5,121,107,233,5,146,104,255
628,0.06,"(17, 3)","(13, 2)",6,71,41,118,10,56,39,105
629,0.04,"(12, 9)","(18, 16)",3,61,45,109,14,126,110,250
630,0.18,"(29, 1)","(13, 24)",3,86,66,155,6,126,94,226
631,0.16,"(18, 20)","(7, 20)",8,66,63,137,7,56,26,89
632,0.14,"(13, 5)","(2, 19)",6,76,68,150,21,106,97,224
633,0.04,"(22, 0)","(23, 21)",4,101,80,185,13,176,126,315
634,0.18,"(11, 17)","(23, 28)",10,91,75,176,13,96,89,198
635,0.14,"(13, 19)","(4, 6)",9,121,112,242,7,146,119,272
636,0.16,"(12, 9)","(19, 23)",5,76,53,134,4,76,56,136
637,0.14,"(14, 17)","(20, 4)",5,91,72,168,8,56,52,116
638,0.18,"(7, 15)","(12, 12)",5,56,49,110,13,116,81,210
639,0.2,"(12, 24)","(1, 22)",4,46,33,83,6,36,27,69
640,0.02,"(10, 28)","(4, 24)",5,86,48,139,7,116,71,194
641,0.12,"(29, 2)","(1, 19)",13,146,133,292,7,126,92,225
642,0.06,"(1, 0)","(16, 4)",13,166,132,311,5,86,84,175
643,0.18,"(25, 25)","(15, 2)",4,71,58,133,5,86,68,159
644,0.04,"(2, 20)","(8, 2)",11,76,55,142,19,76,53,148
645,0.1,"(6, 18)","(1, 0)",2,101,88,191,4,96,87,187
646,0.12,"(7, 28)","(2, 28)",4,46,24,74,3,36,12,51
647,0.16,"(24, 28)","(19, 1)",6,131,117,254,7,136,97,240
648,0.16,"(5, 12)","(12, 23)",4,66,47,117,9,66,64,139
649,0.12,"(14, 26)","(12, 23)",5,66,39,110,7,56,22,85
650,0.12,"(20, 26)","(4, 24)",3,36,28,67,3,36,24,63
651,0.04,"(12, 10)","(5, 28)",25,136,142,303,7,146,97,250
652,0.16,"(25, 28)","(16, 8)",12,86,70,168,15,136,105,256
653,0.08,"(9, 29)","(0, 18)",8,56,38,102,4,86,52,142
654,0.04,"(1, 19)","(4, 29)",8,126,85,219,5,106,48,159
655,0.04,"(26, 21)","(20, 0)",5,81,57,143,12,66,72,150
656,0.2,"(3, 23)","(7, 22)",3,41,21,65,6,36,29,71
657,0.16,"(9, 18)","(21, 16)",4,141,120,265,9,96,68,173
658,0.12,"(21, 25)","(7, 1)",6,161,135,302,7,96,79,182
659,0.08,"(16, 29)","(0, 25)",9,96,80,185,3,76,51,130
660,0.04,"(16, 11)","(7, 12)",3,116,83,202,5,96,36,137
661,0.04,"(22, 12)","(29, 10)",12,141,139,292,8,186,146,340
662,0.2,"(15, 29)","(25, 24)",2,96,72,170,7,126,104,237
663,0.14,"(25, 22)","(5, 2)",20,81,82,183,18,66,63,147
664,0.08,"(21, 4)","(11, 15)",14,76,64,154,17,96,49,162
665,0.14,"(21, 26)","(22, 16)",31,76,88,195,9,46,40,95
666,0.14,"(20, 5)","(19, 11)",6,56,40,102,10,106,67,183
667,0.1,"(5, 13)","(16, 23)",5,76,49,130,7,176,135,318
668,0.2,"(20, 15)","(24, 21)",9,86,72,167,28,66,88,182
669,0.14,"(9, 26)","(6, 20)",9,66,57,132,8,66,42,116
670,0.1,"(13, 22)","(11, 25)",15,126,109,250,8,86,29,123
671,0.18,"(13, 8)","(19, 20)",14,71,56,141,10,36,37,83
672,0.06,"(24, 16)","(22, 6)",5,56,38,99,6,86,61,153
673,0.12,"(14, 24)","(22, 22)",6,66,56,128,6,96,54,156
674,0.18,"(2, 15)","(14, 24)",3,76,66,145,5,116,78,199
675,0.08,"(18, 2)","(26, 5)",7,146,132,285,8,86,61,155
676,0.04,"(26, 16)","(25, 18)",7,66,52,125,8,136,87,231
677,0.02,"(24, 17)","(22, 16)",9,61,31,101,8,1,8,17
678,0.1,"(13, 20)","(3, 10)",6,121,101,228,5,66,42,113
679,0.18,"(8, 15)","(28, 29)",5,141,128,274,12,76,78,166
680,0.2,"(26, 9)","(24, 15)",16,41,35,92,9,36,30,75
681,0.04,"(2, 18)","(20, 25)",6,86,62,154,4,146,96,246
682,0.18,"(19, 6)","(3, 10)",6,76,60,142,8,46,34,88
683,0.14,"(0, 21)","(19, 5)",9,76,68,153,4,96,67,167
684,0.18,"(24, 24)","(12, 2)",5,146,130,281,10,86,73,169
685,0.04,"(9, 10)","(18, 27)",9,71,58,138,10,76,59,145
686,0.08,"(24, 0)","(29, 10)",16,121,111,248,5,106,96,207
687,0.18,"(18, 3)","(1, 18)",18,106,109,233,7,106,75,188
688,0.08,"(23, 10)","(18, 26)",5,96,72,173,13,76,68,157
689,0.14,"(2, 17)","(16, 25)",9,141,120,270,23,166,155,344
690,0.02,"(28, 15)","(13, 4)",7,126,83,216,4,236,167,407
691,0.08,"(18, 16)","(2, 18)",8,66,45,119,7,86,59,152
692,0.18,"(12, 17)","(17, 0)",5,146,132,283,4,76,67,147
693,0.12,"(2, 4)","(9, 12)",14,91,76,181,6,86,48,140
694,0.06,"(1, 11)","(29, 26)",6,96,70,172,7,86,70,163
695,0.04,"(11, 10)","(17, 1)",5,56,40,101,10,196,146,352
696,0.12,"(6, 20)","(12, 14)",9,71,51,131,13,76,43,132
697,0.08,"(22, 17)","(14, 20)",6,56,34,96,12,76,67,155
698,0.12,"(3, 12)","(22, 1)",9,81,63,153,11,126,84,221
699,0.18,"(18, 7)","(1, 13)",4,56,35,95,4,86,50,140
700,0.02,"(1, 21)","(24, 10)",5,221,156,382,5,246,170,421
701,0.12,"(2, 10)","(21, 13)",6,116,101,223,4,96,74,174
702,0.06,"(0, 19)","(20, 25)",2,91,77,170,5,196,134,335
703,0.02,"(19, 28)","(17, 16)",5,111,83,199,6,136,65,207
704,0.14,"(11, 22)","(18, 6)",14,56,46,116,7,116,89,212
705,0.14,"(23, 27)","(27, 25)",12,41,37,90,7,86,43,136
706,0.1,"(1, 7)","(29, 22)",11,96,80,187,19,56,69,144
707,0.16,"(27, 9)","(25, 7)",6,71,51,128,9,76,53,138
708,0.02,"(16, 6)","(2, 1)",10,251,231,492,4,106,85,195
709,0.2,"(21, 25)","(3, 5)",6,131,116,253,9,106,76,191
710,0.06,"(22, 24)","(16, 0)",4,101,92,197,11,186,120,317
711,0.18,"(17, 16)","(3, 11)",15,71,71,157,17,56,58,131
712,0.1,"(14, 12)","(28, 12)",25,101,100,226,7,66,53,126
713,0.14,"(11, 9)","(24, 21)",18,76,78,172,6,116,90,212
714,0.12,"(23, 10)","(28, 8)",4,56,47,107,6,56,27,89
715,0.06,"(3, 17)","(29, 16)",7,111,88,206,7,96,83,186
716,0.2,"(10, 1)","(3, 9)",8,101,89,198,5,146,141,292
717,0.1,"(8, 25)","(2, 24)",10,61,38,109,7,56,29,92
718,0.08,"(26, 8)","(23, 13)",4,91,60,155,6,36,29,71
719,0.02,"(21, 11)","(6, 12)",5,221,202,428,4,176,78,258
720,0.14,"(18, 0)","(2, 29)",7,76,68,151,5,96,67,168
721,0.18,"(6, 2)","(22, 3)",3,91,83,177,5,96,87,188
722,0.12,"(4, 9)","(0, 2)",4,36,17,57,3,26,14,43
723,0.08,"(0, 23)","(8, 24)",3,61,44,108,2,66,33,101
724,0.02,"(1, 13)","(0, 17)",15,81,53,149,5,86,55,146
725,0.1,"(0, 23)","(23, 25)",2,101,80,183,2,116,72,190
726,0.2,"(25, 12)","(11, 16)",4,51,38,93,6,106,86,198
727,0.18,"(3, 20)","(11, 24)",5,61,41,107,10,66,52,128
728,0.06,"(2, 8)","(15, 10)",4,136,102,242,6,126,87,219
729,0.2,"(17, 25)","(12, 4)",3,121,94,218,4,136,125,265
730,0.12,"(13, 25)","(8, 7)",7,166,146,319,6,146,91,243
731,0.14,"(21, 6)","(1, 26)",6,96,85,187,4,126,90,220
732,0.12,"(26, 4)","(3, 21)",5,91,76,172,7,86,58,151
733,0.14,"(24, 21)","(23, 11)",9,76,64,149,6,86,74,166
734,0.16,"(3, 26)","(27, 0)",5,101,92,198,8,76,62,146
735,0.02,"(16, 4)","(18, 22)",4,166,115,285,3,276,146,425
736,0.14,"(19, 11)","(8, 2)",7,141,117,265,10,46,42,98
737,0.14,"(19, 0)","(12, 3)",4,31,17,52,6,46,23,75
738,0.06,"(6, 24)","(20, 11)",25,91,97,213,3,116,95,214
739,0.18,"(25, 1)","(29, 23)",9,121,111,241,16,86,82,184
740,0.18,"(28, 4)","(10, 21)",4,101,70,175,7,76,68,151
741,0.1,"(7, 16)","(6, 28)",7,136,127,270,9,46,45,100
742,0.14,"(17, 6)","(17, 8)",10,41,29,80,5,46,16,67
743,0.08,"(3, 14)","(11, 21)",8,111,93,212,4,106,59,169
744,0.08,"(2, 20)","(7, 29)",7,41,32,80,3,86,48,137
745,0.08,"(17, 12)","(17, 21)",12,76,73,161,8,86,63,157
746,0.1,"(13, 10)","(13, 15)",7,101,78,186,6,46,41,93
747,0.04,"(15, 6)","(1, 3)",4,76,47,127,10,216,150,376
748,0.1,"(11, 5)","(2, 24)",10,111,95,216,7,86,46,139
749,0.16,"(11, 9)","(11, 25)",5,71,60,136,9,56,30,95
750,0.08,"(6, 5)","(21, 14)",4,86,72,162,4,106,75,185
751,0.16,"(5, 1)","(20, 25)",30,76,91,197,5,76,64,145
752,0.02,"(8, 29)","(11, 4)",10,241,174,425,4,76,58,138
753,0.14,"(7, 18)","(13, 29)",5,121,104,230,12,76,76,164
754,0.2,"(28, 14)","(15, 17)",6,41,28,75,13,86,77,176
755,0.08,"(24, 24)","(1, 19)",4,166,131,301,10,136,93,239
756,0.18,"(12, 20)","(9, 1)",7,61,49,117,6,86,79,171
757,0.1,"(5, 23)","(3, 14)",6,61,46,113,6,86,80,172
758,0.18,"(3, 29)","(0, 2)",13,151,140,304,7,66,58,131
759,0.12,"(2, 18)","(25, 16)",10,56,51,117,6,56,52,114
760,0.18,"(15, 27)","(8, 6)",6,81,76,163,9,126,93,228
761,0.02,"(11, 27)","(8, 14)",5,286,222,513,7,306,222,535
762,0.12,"(23, 26)","(23, 13)",4,66,46,116,7,116,79,202
763,0.04,"(18, 2)","(14, 18)",6,96,87,189,11,136,72,219
764,0.18,"(2, 10)","(1, 26)",3,71,55,129,4,66,45,115
765,0.08,"(0, 16)","(28, 28)",9,121,109,239,5,126,77,208
766,0.14,"(19, 0)","(27, 6)",7,96,77,180,2,56,36,94
767,0.04,"(19, 9)","(5, 12)",5,111,76,192,11,106,55,172
768,0.16,"(2, 19)","(20, 28)",7,141,133,281,9,96,76,181
769,0.14,"(29, 18)","(27, 15)",4,21,13,38,5,56,20,81
770,0.02,"(7, 3)","(7, 0)",6,41,22,69,5,56,26,87
771,0.18,"(19, 1)","(3, 6)",6,56,39,101,4,76,61,141
772,0.18,"(29, 18)","(13, 4)",5,56,42,103,5,66,50,121
773,0.2,"(2, 27)","(29, 10)",9,81,78,168,5,76,67,148
774,0.16,"(0, 16)","(9, 18)",21,91,89,201,5,86,60,151
775,0.06,"(23, 28)","(28, 22)",4,51,39,94,10,116,80,206
776,0.14,"(14, 24)","(10, 20)",13,41,35,89,7,76,50,133
777,0.2,"(1, 0)","(29, 25)",5,106,98,209,5,116,88,209
778,0.06,"(0, 25)","(0, 27)",22,16,23,61,12,1,12,25
779,0.16,"(27, 3)","(29, 18)",8,41,35,84,4,66,46,116
780,0.02,"(9, 29)","(15, 0)",12,151,115,278,4,226,203,433
781,0.12,"(17, 19)","(4, 5)",13,76,70,159,5,156,132,293
782,0.12,"(10, 21)","(29, 28)",11,101,92,204,5,86,64,155
783,0.1,"(7, 1)","(24, 28)",4,161,152,317,4,126,96,226
784,0.18,"(17, 20)","(28, 10)",17,96,96,209,14,106,78,198
785,0.16,"(11, 17)","(5, 22)",3,41,27,71,4,136,91,231
786,0.16,"(20, 6)","(6, 3)",12,36,31,79,5,66,39,110
787,0.02,"(4, 27)","(25, 0)",6,136,123,265,10,246,155,411
788,0.14,"(22, 10)","(25, 10)",21,21,24,66,5,56,27,88
789,0.08,"(18, 26)","(5, 28)",2,41,21,64,3,86,50,139
790,0.14,"(1, 11)","(20, 6)",9,86,81,176,8,76,62,146
791,0.14,"(15, 8)","(1, 10)",13,76,69,158,8,156,153,317
792,0.06,"(3, 8)","(14, 11)",12,86,70,168,6,156,106,268
793,0.12,"(26, 22)","(15, 22)",6,96,90,192,17,156,108,281
794,0.06,"(4, 24)","(27, 16)",9,81,73,163,25,116,89,230
795,0.08,"(28, 26)","(12, 12)",7,86,63,156,8,86,70,164
796,0.08,"(6, 27)","(12, 9)",8,131,106,245,9,156,127,292
797,0.2,"(27, 2)","(14, 22)",6,96,83,185,4,96,77,177
798,0.04,"(29, 9)","(18, 15)",8,181,154,343,6,156,134,296
799,0.02,"(9, 14)","(16, 24)",5,106,87,198,10,106,88,204
800,0.16,"(19, 2)","(21, 2)",5,21,8,34,4,26,23,53
801,0.14,"(21, 13)","(10, 28)",8,71,59,138,8,116,101,225
802,0.12,"(18, 4)","(20, 22)",6,46,37,89,3,136,91,230
803,0.1,"(23, 29)","(7, 12)",11,96,73,180,7,106,103,216
804,0.1,"(27, 8)","(7, 10)",7,76,72,155,3,126,72,201
805,0.14,"(27, 17)","(24, 10)",12,46,33,91,16,96,47,159
806,0.1,"(1, 16)","(11, 5)",7,106,92,205,7,56,34,97
807,0.06,"(18, 1)","(23, 14)",9,61,59,129,6,106,90,202
808,0.16,"(7, 12)","(15, 0)",28,81,91,200,8,86,83,177
809,0.14,"(24, 27)","(2, 21)",3,71,59,133,3,66,38,107
810,0.1,"(27, 23)","(14, 19)",4,61,51,116,8,76,54,138
811,0.08,"(29, 15)","(19, 29)",18,101,107,226,13,96,90,199
812,0.2,"(17, 29)","(12, 5)",4,121,107,232,4,126,102,232
813,0.06,"(27, 7)","(3, 13)",6,111,93,210,7,166,105,278
814,0.04,"(27, 27)","(8, 29)",8,96,82,186,5,106,73,184
815,0.02,"(1, 25)","(21, 23)",6,126,101,233,17,226,122,365
816,0.2,"(8, 13)","(12, 9)",12,36,33,81,19,66,70,155
817,0.04,"(6, 9)","(12, 23)",10,111,95,216,10,86,62,158
818,0.04,"(7, 4)","(23, 21)",5,186,168,359,6,176,133,315
819,0.1,"(19, 18)","(4, 23)",16,106,111,233,6,116,71,193
820,0.08,"(2, 5)","(4, 24)",6,96,79,181,12,116,66,194
821,0.06,"(6, 24)","(15, 11)",5,236,215,456,8,76,74,158
822,0.2,"(21, 12)","(13, 18)",8,86,75,169,5,126,116,247
823,0.08,"(14, 27)","(5, 7)",9,176,143,328,7,96,77,180
824,0.02,"(1, 10)","(28, 17)",10,131,95,236,8,76,69,153
825,0.04,"(29, 28)","(15, 5)",4,71,58,133,9,196,178,383
826,0.1,"(25, 16)","(20, 7)",16,56,53,125,7,96,68,171
827,0.1,"(12, 15)","(20, 14)",11,176,145,332,7,76,52,135
828,0.1,"(13, 15)","(10, 13)",6,71,54,131,4,26,7,37
829,0.16,"(8, 11)","(9, 21)",5,126,105,236,6,66,49,121
830,0.1,"(11, 13)","(10, 8)",20,51,58,129,16,56,45,117
831,0.16,"(16, 8)","(29, 4)",6,81,68,155,6,146,143,295
832,0.1,"(6, 8)","(15, 2)",8,81,74,163,6,126,105,237
833,0.14,"(8, 17)","(25, 3)",17,61,66,144,8,106,56,170
834,0.2,"(24, 9)","(2, 24)",8,86,79,173,14,76,77,167
835,0.02,"(20, 1)","(20, 22)",6,171,144,321,7,156,137,300
836,0.12,"(18, 27)","(9, 5)",3,71,47,121,6,96,67,169
837,0.1,"(24, 8)","(22, 4)",4,26,15,45,5,76,32,113
838,0.12,"(11, 25)","(22, 27)",6,51,41,98,12,96,65,173
839,0.16,"(17, 11)","(22, 2)",8,111,104,223,6,96,69,171
840,0.04,"(27, 16)","(7, 27)",9,151,132,292,3,106,85,194
841,0.04,"(23, 22)","(16, 23)",4,101,85,190,2,76,20,98
842,0.02,"(12, 4)","(21, 17)",10,86,63,159,17,176,121,314
843,0.2,"(20, 13)","(18, 2)",6,61,48,115,7,56,39,102
844,0.18,"(12, 13)","(28, 8)",5,56,40,101,4,106,77,187
845,0.12,"(10, 21)","(20, 7)",5,56,38,99,4,106,82,192
846,0.06,"(26, 24)","(28, 12)",8,56,40,104,9,56,50,115
847,0.02,"(14, 14)","(21, 6)",5,196,143,344,15,226,163,404
848,0.18,"(14, 25)","(11, 3)",8,116,107,231,4,96,66,166
849,0.02,"(0, 27)","(11, 14)",7,71,54,132,3,166,74,243
850,0.14,"(20, 16)","(12, 29)",10,151,138,299,8,196,175,379
851,0.16,"(20, 8)","(12, 10)",9,71,56,136,5,46,17,68
852,0.1,"(7, 28)","(12, 6)",6,96,82,184,5,146,112,263
853,0.04,"(0, 14)","(2, 16)",4,56,20,80,14,36,39,89
854,0.08,"(6, 15)","(9, 19)",11,86,72,169,9,106,74,189
855,0.2,"(20, 10)","(6, 25)",7,81,75,163,9,236,230,475
856,0.1,"(27, 3)","(24, 19)",6,66,52,124,6,36,33,75
857,0.14,"(4, 29)","(4, 18)",4,71,59,134,6,56,28,90
858,0.06,"(23, 24)","(14, 6)",10,111,84,205,10,136,82,228
859,0.16,"(8, 13)","(15, 14)",14,61,57,132,5,136,94,235
860,0.2,"(10, 20)","(2, 1)",9,121,112,242,22,116,113,251
861,0.06,"(4, 8)","(10, 14)",13,76,75,164,9,86,58,153
862,0.14,"(29, 17)","(15, 21)",3,86,59,148,7,86,43,136
863,0.2,"(25, 5)","(21, 0)",13,46,35,94,12,196,184,392
864,0.06,"(22, 12)","(4, 7)",8,96,81,185,6,76,45,127
865,0.2,"(9, 7)","(1, 26)",7,276,263,546,4,126,109,239
866,0.18,"(0, 7)","(14, 27)",5,76,62,143,5,136,102,243
867,0.02,"(6, 16)","(27, 15)",6,271,201,478,5,146,67,218
868,0.1,"(13, 20)","(9, 11)",17,101,80,198,9,106,69,184
869,0.06,"(20, 17)","(6, 0)",12,61,62,135,4,116,95,215
870,0.14,"(12, 23)","(6, 20)",8,66,45,119,6,76,63,145
871,0.08,"(29, 13)","(9, 14)",7,41,33,81,4,46,35,85
872,0.06,"(8, 10)","(9, 1)",12,86,87,185,7,66,42,115
873,0.08,"(9, 11)","(1, 4)",7,71,43,121,7,176,108,291
874,0.2,"(2, 27)","(27, 11)",7,101,93,201,6,146,125,277
875,0.06,"(5, 13)","(26, 16)",5,91,73,169,4,86,45,135
876,0.2,"(25, 25)","(9, 18)",9,61,51,121,10,106,98,214
877,0.18,"(25, 0)","(13, 22)",5,56,50,111,9,76,62,147
878,0.06,"(16, 23)","(15, 28)",9,66,49,124,6,56,37,99
879,0.02,"(13, 10)","(22, 18)",5,131,99,235,4,76,74,154
880,0.2,"(20, 1)","(23, 25)",6,106,86,198,8,146,117,271
881,0.04,"(16, 17)","(5, 10)",10,81,66,157,7,126,78,211
882,0.08,"(28, 6)","(3, 22)",4,96,80,180,5,126,82,213
883,0.14,"(9, 4)","(4, 23)",10,111,104,225,6,126,94,226
884,0.02,"(14, 25)","(8, 18)",22,106,81,209,5,216,125,346
885,0.08,"(4, 6)","(12, 5)",3,81,58,142,13,76,71,160
886,0.04,"(23, 28)","(7, 21)",6,81,65,152,5,196,110,311
887,0.2,"(27, 24)","(27, 15)",4,61,36,101,6,86,38,130
888,0.04,"(13, 4)","(4, 29)",4,101,85,190,13,156,112,281
889,0.18,"(27, 25)","(0, 1)",18,126,127,271,11,86,88,185
890,0.12,"(15, 22)","(18, 21)",10,31,16,57,10,66,47,123
891,0.18,"(19, 3)","(21, 8)",11,36,28,75,21,66,67,154
892,0.12,"(15, 23)","(4, 3)",4,156,148,308,13,106,82,201
893,0.02,"(20, 20)","(6, 17)",15,271,196,482,6,276,147,429
894,0.06,"(2, 16)","(29, 19)",25,151,152,328,34,126,134,294
895,0.14,"(17, 9)","(16, 0)",8,61,47,116,6,116,69,191
896,0.18,"(9, 29)","(6, 24)",8,41,24,73,8,56,48,112
897,0.02,"(25, 2)","(0, 4)",6,226,199,431,5,86,60,151
898,0.14,"(15, 24)","(2, 7)",2,56,46,104,5,66,43,114
899,0.18,"(3, 8)","(18, 20)",7,181,165,353,5,126,100,231
900,0.2,"(17, 27)","(20, 3)",5,66,53,124,5,96,54,155
901,0.2,"(1, 15)","(24, 20)",19,76,84,179,12,136,121,269
902,0.08,"(21, 26)","(1, 0)",3,116,100,219,9,106,100,215
903,0.12,"(0, 24)","(22, 0)",11,66,58,135,13,66,57,136
904,0.02,"(23, 11)","(19, 24)",5,146,107,258,3,166,87,256
905,0.2,"(19, 0)","(11, 28)",8,81,74,163,12,106,94,212
906,0.16,"(21, 0)","(19, 8)",6,31,22,59,9,36,31,76
907,0.06,"(1, 16)","(1, 10)",15,61,58,134,7,26,27,60
908,0.16,"(21, 26)","(12, 10)",13,56,49,118,4,76,62,142
909,0.02,"(2, 27)","(14, 6)",13,151,113,277,10,216,169,395
910,0.16,"(14, 19)","(29, 1)",14,91,89,194,6,196,179,381
911,0.1,"(13, 14)","(2, 2)",7,86,59,152,4,106,64,174
912,0.06,"(20, 12)","(22, 19)",10,136,112,258,6,166,123,295
913,0.14,"(20, 1)","(4, 14)",16,106,105,227,7,96,61,164
914,0.12,"(3, 2)","(29, 7)",9,101,88,198,7,186,151,344
915,0.08,"(24, 8)","(27, 18)",12,86,77,175,7,106,58,171
916,0.02,"(27, 8)","(14, 5)",5,316,233,554,5,186,83,274
917,0.04,"(1, 19)","(2, 18)",2,46,23,71,6,26,9,41
918,0.08,"(16, 8)","(17, 10)",9,51,36,96,4,96,50,150
919,0.12,"(15, 5)","(2, 21)",4,46,39,89,11,96,92,199
920,0.06,"(9, 6)","(1, 10)",5,86,62,153,9,86,57,152
921,0.04,"(28, 2)","(4, 10)",5,106,77,188,4,66,48,118
922,0.12,"(7, 1)","(21, 10)",3,91,78,172,2,96,73,171
923,0.2,"(18, 9)","(2, 10)",14,91,83,188,7,96,76,179
924,0.18,"(0, 26)","(26, 11)",7,101,93,201,2,116,73,191
925,0.1,"(8, 14)","(18, 2)",14,266,263,543,7,106,81,194
926,0.18,"(20, 14)","(1, 9)",4,101,94,199,5,66,62,133
927,0.14,"(5, 17)","(14, 9)",6,161,140,307,16,96,95,207
928,0.06,"(15, 3)","(2, 1)",13,86,68,167,8,56,45,109
929,0.06,"(27, 9)","(29, 6)",6,51,38,95,5,86,58,149
930,0.14,"(12, 24)","(22, 28)",15,76,75,166,6,76,50,132
931,0.1,"(11, 18)","(3, 7)",3,116,87,206,3,176,151,330
932,0.04,"(4, 9)","(25, 20)",12,166,117,295,14,96,57,167
933,0.04,"(11, 29)","(26, 18)",6,106,71,183,2,166,131,299
934,0.04,"(15, 25)","(5, 29)",6,81,59,146,5,56,28,89
935,0.16,"(5, 18)","(28, 29)",10,141,135,286,10,186,184,380
936,0.14,"(21, 28)","(6, 26)",3,51,37,91,3,46,26,75
937,0.14,"(28, 0)","(26, 6)",6,46,26,78,4,36,28,68
938,0.1,"(3, 6)","(18, 17)",8,111,100,219,6,136,113,255
939,0.02,"(12, 13)","(25, 9)",7,106,80,193,4,176,127,307
940,0.02,"(11, 26)","(27, 6)",8,201,180,389,9,166,113,288
941,0.2,"(15, 5)","(13, 29)",12,71,71,154,5,116,93,214
942,0.18,"(19, 19)","(23, 29)",13,106,96,215,9,146,131,286
943,0.16,"(24, 5)","(28, 21)",4,226,203,433,8,126,110,244
944,0.12,"(7, 21)","(9, 20)",5,61,39,105,13,46,23,82
945,0.06,"(14, 1)","(16, 22)",6,76,66,148,8,46,39,93
946,0.1,"(0, 26)","(27, 25)",4,101,77,182,54,106,145,305
947,0.16,"(28, 5)","(15, 9)",5,66,49,120,4,76,49,129
948,0.1,"(16, 16)","(9, 29)",5,91,78,174,20,136,112,268
949,0.2,"(2, 7)","(22, 11)",6,111,102,219,5,146,114,265
950,0.1,"(22, 16)","(17, 17)",6,41,29,76,7,46,28,81
951,0.02,"(4, 11)","(6, 19)",4,51,28,83,8,196,116,320
952,0.2,"(27, 15)","(3, 11)",7,156,138,301,5,116,93,214
953,0.02,"(8, 25)","(8, 28)",11,166,135,312,9,156,94,259
954,0.1,"(22, 9)","(4, 25)",4,81,62,147,8,106,84,198
955,0.14,"(18, 4)","(15, 1)",4,51,37,92,5,56,39,100
956,0.04,"(7, 10)","(2, 21)",12,36,32,80,40,66,71,177
957,0.2,"(10, 27)","(0, 12)",42,131,160,333,3,116,100,219
958,0.06,"(12, 22)","(27, 7)",34,146,156,336,9,116,70,195
959,0.02,"(12, 9)","(13, 25)",8,96,93,197,10,186,141,337
960,0.2,"(19, 11)","(2, 12)",20,171,166,357,5,106,69,180
961,0.08,"(27, 4)","(1, 0)",8,91,80,179,9,126,104,239
962,0.16,"(14, 27)","(20, 2)",7,121,105,233,7,96,71,174
963,0.18,"(0, 19)","(9, 5)",3,96,77,176,5,66,40,111
964,0.18,"(20, 16)","(3, 2)",8,71,54,133,12,86,75,173
965,0.08,"(21, 29)","(15, 7)",4,111,77,192,5,116,72,193
966,0.02,"(19, 10)","(18, 29)",5,106,95,206,5,306,182,493
967,0.2,"(16, 2)","(9, 5)",6,46,29,81,8,56,35,99
968,0.06,"(26, 14)","(11, 12)",9,116,92,217,6,66,43,115
969,0.02,"(22, 8)","(4, 4)",9,226,200,435,5,306,213,524
970,0.06,"(21, 10)","(24, 10)",4,46,29,79,5,46,30,81
971,0.2,"(0, 1)","(18, 16)",8,96,85,189,6,116,105,227
972,0.18,"(2, 6)","(8, 25)",5,91,82,178,10,66,43,119
973,0.16,"(27, 10)","(23, 29)",3,81,72,156,4,76,74,154
974,0.18,"(18, 3)","(15, 15)",7,41,30,78,9,56,41,106
975,0.08,"(20, 8)","(6, 8)",6,66,47,119,15,56,40,111
976,0.14,"(5, 11)","(23, 15)",9,46,44,99,7,236,180,423
977,0.16,"(21, 10)","(24, 3)",7,76,62,145,4,96,55,155
978,0.08,"(0, 1)","(25, 18)",2,106,89,197,6,146,123,275
979,0.04,"(9, 5)","(24, 4)",7,111,88,206,9,106,78,193
980,0.12,"(3, 13)","(18, 6)",5,96,68,169,6,96,76,178
981,0.12,"(19, 3)","(3, 18)",7,101,84,192,6,96,66,168
982,0.06,"(18, 5)","(8, 16)",7,76,50,133,10,46,37,93
983,0.14,"(14, 0)","(15, 2)",5,21,11,37,7,26,13,46
984,0.12,"(14, 15)","(5, 7)",15,106,91,212,25,56,56,137
985,0.14,"(24, 29)","(25, 13)",7,91,72,170,12,46,46,104
986,0.18,"(16, 7)","(29, 4)",3,141,132,276,6,146,140,292
987,0.14,"(2, 8)","(20, 28)",9,61,56,126,7,86,62,155
988,0.16,"(6, 18)","(5, 16)",6,46,30,82,8,76,47,131
989,0.16,"(7, 8)","(15, 7)",5,66,54,125,15,46,40,101
990,0.14,"(19, 19)","(16, 9)",6,66,45,117,8,46,42,96
991,0.18,"(27, 1)","(15, 11)",7,76,58,141,5,76,50,131
992,0.06,"(19, 0)","(26, 8)",6,76,58,140,13,56,59,128
993,0.08,"(26, 3)","(8, 19)",9,151,121,281,9,126,121,256
994,0.06,"(3, 4)","(25, 8)",7,131,100,238,15,96,80,191
995,0.16,"(4, 20)","(21, 28)",13,86,81,180,10,136,87,233
996,0.06,"(14, 27)","(7, 28)",7,61,49,117,4,66,23,93
997,0.08,"(11, 20)","(14, 14)",5,101,79,185,6,166,146,318
998,0.04,"(28, 5)","(1, 15)",4,121,78,203,10,126,108,244
999,0.02,"(7, 9)","(26, 23)",9,136,90,235,4,246,162,412
,,,,8.082,94.72,78.855,181.657,7.773,104.885,76.189,188.847
