0,0.14,"(29, 3)","(22, 22)",5,71,431,507,12,85,242,339
1,0.02,"(20, 10)","(16, 28)",5,111,200,316,6,64,182,252
2,0.02,"(23, 10)","(9, 20)",7,171,325,503,14,55,112,181
3,0.12,"(12, 3)","(0, 9)",11,36,48,95,6,43,36,85
4,0.1,"(3, 12)","(4, 10)",6,31,17,54,3,67,61,131
5,0.02,"(4, 3)","(25, 16)",11,61,140,212,6,175,323,504
6,0.16,"(24, 26)","(23, 3)",8,61,175,244,5,40,102,147
7,0.16,"(22, 4)","(20, 20)",4,36,86,126,6,79,215,300
8,0.1,"(3, 3)","(0, 16)",21,31,81,133,13,31,37,81
9,0.1,"(26, 2)","(20, 6)",30,36,63,129,7,46,40,93
10,0.16,"(27, 23)","(0, 5)",9,36,74,119,6,64,233,303
11,0.18,"(27, 15)","(25, 18)",12,26,50,88,15,37,28,80
12,0.04,"(8, 29)","(3, 7)",9,131,196,336,6,79,227,312
13,0.02,"(21, 4)","(21, 25)",5,86,167,258,12,70,203,285
14,0.2,"(16, 26)","(12, 2)",3,46,97,146,14,70,220,304
15,0.02,"(5, 17)","(15, 16)",12,151,208,371,5,79,147,231
16,0.16,"(0, 12)","(24, 22)",14,66,246,326,7,82,293,382
17,0.06,"(10, 3)","(11, 28)",6,76,158,240,10,76,158,244
18,0.12,"(17, 5)","(12, 13)",4,51,99,154,12,70,89,171
19,0.12,"(27, 18)","(16, 1)",4,46,175,225,8,79,177,264
20,0.1,"(19, 0)","(20, 13)",10,61,231,302,6,46,48,100
21,0.18,"(12, 3)","(18, 7)",7,111,574,692,7,76,186,269
22,0.02,"(19, 5)","(25, 12)",11,146,177,334,17,70,123,210
23,0.12,"(4, 21)","(17, 5)",2,51,228,281,2,49,64,115
24,0.04,"(22, 0)","(13, 12)",9,121,179,309,17,64,149,230
25,0.06,"(27, 6)","(23, 17)",11,86,128,225,8,82,91,181
26,0.08,"(4, 18)","(27, 3)",33,26,93,152,9,97,314,420
27,0.1,"(11, 2)","(6, 14)",6,56,149,211,16,70,87,173
28,0.08,"(28, 15)","(4, 1)",12,91,187,290,9,58,92,159
29,0.12,"(27, 3)","(29, 3)",5,21,46,72,7,40,44,91
30,0.06,"(22, 24)","(29, 11)",8,31,133,172,8,70,122,200
31,0.04,"(11, 22)","(9, 2)",3,121,155,279,5,70,202,277
32,0.06,"(11, 26)","(17, 20)",5,106,173,284,11,97,210,318
33,0.12,"(5, 20)","(4, 11)",6,51,56,113,12,55,99,166
34,0.04,"(27, 1)","(20, 9)",6,61,166,233,8,88,205,301
35,0.08,"(2, 7)","(29, 29)",6,6,52,64,7,31,60,98
36,0.04,"(4, 11)","(16, 1)",12,71,201,284,6,91,140,237
37,0.04,"(18, 8)","(1, 8)",4,66,127,197,5,79,77,161
38,0.18,"(12, 18)","(12, 7)",9,101,340,450,23,94,227,344
39,0.04,"(9, 28)","(2, 18)",5,136,287,428,8,67,127,202
40,0.06,"(7, 11)","(19, 5)",11,81,208,300,13,73,111,197
41,0.02,"(18, 13)","(26, 14)",8,46,83,137,9,142,245,396
42,0.06,"(21, 9)","(18, 5)",13,106,219,338,5,61,68,134
43,0.12,"(7, 24)","(2, 22)",13,41,36,90,5,34,13,52
44,0.1,"(18, 0)","(4, 12)",15,56,112,183,2,73,227,302
45,0.1,"(28, 24)","(11, 23)",4,26,53,83,6,76,190,272
46,0.18,"(16, 6)","(1, 19)",11,96,300,407,11,67,196,274
47,0.18,"(18, 24)","(8, 0)",10,31,96,137,7,37,75,119
48,0.12,"(22, 16)","(22, 25)",9,56,125,190,11,64,111,186
49,0.2,"(21, 6)","(5, 26)",10,46,93,149,3,52,92,147
50,0.08,"(7, 2)","(3, 21)",4,11,34,49,5,61,51,117
51,0.08,"(16, 14)","(5, 9)",7,36,84,127,4,70,96,170
52,0.16,"(20, 27)","(14, 3)",3,41,126,170,3,55,173,231
53,0.14,"(5, 15)","(28, 12)",4,86,363,453,10,67,192,269
54,0.06,"(19, 9)","(8, 0)",7,71,181,259,8,103,182,293
55,0.06,"(19, 4)","(0, 0)",6,16,86,108,6,37,143,186
56,0.14,"(22, 24)","(22, 4)",12,51,137,200,9,76,164,249
57,0.12,"(0, 12)","(27, 20)",6,71,291,368,4,58,95,157
58,0.1,"(15, 13)","(0, 12)",10,26,42,78,9,40,36,85
59,0.06,"(8, 27)","(2, 26)",4,126,254,384,12,40,33,85
60,0.04,"(14, 27)","(10, 15)",9,111,232,352,9,55,122,186
61,0.1,"(3, 17)","(9, 24)",4,31,91,126,4,115,308,427
62,0.08,"(3, 11)","(26, 15)",8,76,125,209,10,58,163,231
63,0.08,"(15, 17)","(6, 21)",8,21,51,80,11,61,143,215
64,0.04,"(23, 23)","(2, 9)",6,61,108,175,13,82,102,197
65,0.08,"(3, 7)","(17, 16)",6,46,84,136,7,100,236,343
66,0.16,"(12, 23)","(25, 21)",10,41,206,257,9,82,367,458
67,0.06,"(20, 11)","(7, 5)",9,86,118,213,4,64,170,238
68,0.18,"(10, 8)","(13, 6)",9,46,145,200,5,67,77,149
69,0.18,"(24, 16)","(3, 0)",11,36,70,117,16,37,58,111
70,0.1,"(29, 19)","(1, 1)",6,21,56,83,5,40,54,99
71,0.02,"(5, 8)","(4, 26)",3,151,161,315,6,91,111,208
72,0.02,"(16, 23)","(17, 6)",12,81,144,237,4,109,170,283
73,0.12,"(2, 16)","(12, 13)",4,116,193,313,5,61,103,169
74,0.2,"(2, 19)","(27, 17)",12,71,275,358,6,61,203,270
75,0.04,"(22, 7)","(29, 19)",4,46,131,181,4,58,111,173
76,0.14,"(16, 14)","(17, 10)",4,46,58,108,3,64,56,123
77,0.08,"(27, 21)","(1, 24)",5,41,111,157,4,79,107,190
78,0.04,"(18, 24)","(13, 22)",5,6,14,25,28,34,37,99
79,0.16,"(8, 11)","(9, 0)",5,26,47,78,18,52,170,240
80,0.18,"(28, 26)","(14, 4)",5,46,203,254,18,58,192,268
81,0.16,"(19, 7)","(13, 3)",9,51,87,147,3,55,125,183
82,0.18,"(11, 27)","(24, 16)",10,56,169,235,8,70,315,393
83,0.02,"(27, 26)","(22, 26)",10,91,84,185,12,37,23,72
84,0.02,"(21, 17)","(9, 16)",8,141,181,330,3,124,215,342
85,0.02,"(28, 19)","(23, 6)",8,221,453,682,3,79,114,196
86,0.14,"(9, 23)","(10, 11)",8,61,139,208,3,73,184,260
87,0.04,"(29, 11)","(23, 14)",12,86,221,319,8,43,26,77
88,0.12,"(13, 10)","(28, 9)",8,56,177,241,4,46,102,152
89,0.1,"(19, 3)","(0, 10)",5,41,76,122,6,88,181,275
90,0.16,"(26, 9)","(23, 23)",6,51,89,146,3,82,217,302
91,0.18,"(26, 13)","(7, 3)",4,21,99,124,3,67,318,388
92,0.1,"(12, 13)","(8, 13)",5,46,51,102,8,37,30,75
93,0.04,"(9, 14)","(0, 22)",9,71,142,222,14,67,90,171
94,0.2,"(28, 10)","(27, 14)",10,31,72,113,10,43,51,104
95,0.12,"(7, 18)","(12, 16)",6,31,44,81,12,61,71,144
96,0.12,"(17, 26)","(23, 14)",10,86,342,438,5,61,136,202
97,0.12,"(7, 28)","(12, 6)",5,76,161,242,9,70,101,180
98,0.02,"(4, 0)","(13, 20)",12,161,286,459,9,118,221,348
99,0.02,"(14, 14)","(14, 22)",23,71,134,228,7,94,194,295
100,0.1,"(7, 9)","(28, 22)",4,26,83,113,4,79,193,276
101,0.1,"(3, 11)","(16, 9)",6,71,232,309,17,55,206,278
102,0.04,"(6, 11)","(15, 21)",11,71,136,218,14,76,104,194
103,0.06,"(14, 20)","(10, 19)",3,81,179,263,6,55,30,91
104,0.18,"(6, 8)","(18, 14)",7,61,211,279,5,76,236,317
105,0.04,"(11, 12)","(15, 7)",8,26,66,100,7,76,102,185
106,0.02,"(4, 15)","(21, 6)",3,81,280,364,9,73,147,229
107,0.02,"(0, 27)","(19, 25)",6,106,151,263,27,43,96,166
108,0.14,"(8, 25)","(25, 8)",17,76,204,297,4,64,142,210
109,0.04,"(10, 23)","(10, 18)",11,51,67,129,27,103,242,372
110,0.08,"(28, 28)","(6, 15)",8,66,156,230,4,85,197,286
111,0.18,"(12, 1)","(7, 24)",3,66,228,297,5,61,211,277
112,0.04,"(1, 1)","(13, 2)",8,86,103,197,11,46,55,112
113,0.16,"(28, 2)","(13, 4)",4,51,256,311,5,103,256,364
114,0.2,"(2, 13)","(16, 14)",5,61,271,337,6,43,104,153
115,0.1,"(19, 14)","(4, 9)",4,76,108,188,5,58,75,138
116,0.12,"(12, 14)","(29, 3)",11,21,98,130,6,91,333,430
117,0.08,"(25, 23)","(7, 13)",6,61,85,152,7,58,127,192
118,0.14,"(14, 1)","(26, 3)",8,36,161,205,8,70,181,259
119,0.14,"(14, 19)","(8, 3)",8,66,209,283,16,55,314,385
120,0.12,"(1, 5)","(3, 23)",17,61,225,303,20,67,115,202
121,0.02,"(29, 28)","(16, 19)",4,71,85,160,8,115,250,373
122,0.2,"(13, 16)","(14, 25)",5,36,68,109,6,61,131,198
123,0.02,"(11, 20)","(3, 24)",10,61,63,134,8,82,234,324
124,0.1,"(8, 22)","(2, 2)",5,41,122,168,8,58,85,151
125,0.1,"(18, 27)","(0, 8)",7,66,198,271,5,73,124,202
126,0.14,"(21, 22)","(2, 11)",7,21,77,105,7,46,55,108
127,0.1,"(9, 25)","(20, 11)",8,71,235,314,3,79,216,298
128,0.04,"(8, 17)","(26, 5)",4,51,98,153,15,133,300,448
129,0.2,"(23, 26)","(19, 25)",10,11,24,45,5,52,86,143
130,0.04,"(17, 21)","(7, 4)",6,76,137,219,5,82,88,175
131,0.04,"(26, 19)","(4, 19)",6,41,69,116,6,124,255,385
132,0.06,"(14, 8)","(25, 27)",9,76,129,214,5,67,119,191
133,0.2,"(4, 20)","(23, 6)",8,76,265,349,5,67,194,266
134,0.06,"(10, 16)","(10, 6)",8,66,134,208,8,52,48,108
135,0.14,"(4, 23)","(5, 24)",11,61,78,150,39,37,47,123
136,0.06,"(12, 1)","(0, 8)",4,11,21,36,13,61,98,172
137,0.14,"(6, 11)","(6, 6)",7,36,59,102,8,43,33,84
138,0.14,"(6, 12)","(28, 12)",6,46,86,138,3,64,168,235
139,0.06,"(23, 22)","(5, 10)",12,81,195,288,11,76,168,255
140,0.08,"(9, 29)","(27, 12)",3,51,264,318,11,55,165,231
141,0.14,"(5, 19)","(18, 6)",8,76,288,372,4,73,125,202
142,0.08,"(14, 3)","(4, 0)",4,56,113,173,7,49,53,109
143,0.1,"(17, 16)","(1, 0)",9,81,139,229,9,73,151,233
144,0.1,"(16, 27)","(0, 10)",3,61,145,209,7,40,43,90
145,0.02,"(25, 19)","(28, 9)",13,81,240,334,3,160,168,331
146,0.06,"(20, 10)","(28, 29)",11,86,291,388,9,88,192,289
147,0.08,"(3, 19)","(18, 22)",5,71,233,309,8,73,186,267
148,0.2,"(24, 6)","(21, 7)",6,6,7,19,7,34,25,66
149,0.12,"(5, 9)","(1, 21)",5,41,170,216,8,61,92,161
150,0.06,"(15, 26)","(22, 6)",9,56,137,202,9,94,172,275
151,0.14,"(29, 20)","(4, 15)",6,51,144,201,6,67,107,180
152,0.08,"(23, 17)","(5, 0)",11,36,87,134,7,37,83,127
153,0.04,"(24, 15)","(9, 14)",16,96,141,253,9,82,217,308
154,0.02,"(17, 16)","(12, 0)",12,201,208,421,6,67,129,202
155,0.04,"(2, 2)","(5, 12)",12,51,93,156,16,97,107,220
156,0.16,"(16, 7)","(5, 23)",6,71,118,195,10,58,173,241
157,0.2,"(9, 14)","(8, 26)",10,41,207,258,7,67,198,272
158,0.02,"(4, 23)","(29, 8)",6,86,280,372,5,166,423,594
159,0.12,"(27, 0)","(22, 10)",5,66,113,184,5,67,223,295
160,0.02,"(10, 16)","(16, 20)",4,141,79,224,12,133,247,392
161,0.12,"(0, 13)","(7, 18)",9,56,92,157,24,46,121,191
162,0.12,"(7, 24)","(26, 7)",5,86,202,293,15,55,107,177
163,0.2,"(14, 0)","(7, 29)",16,46,249,311,14,76,342,432
164,0.18,"(0, 12)","(15, 4)",2,46,127,175,2,52,134,188
165,0.04,"(0, 3)","(29, 15)",9,61,123,193,12,67,107,186
166,0.04,"(13, 21)","(27, 3)",5,51,137,193,7,49,79,135
167,0.18,"(21, 22)","(6, 3)",10,36,82,128,8,52,87,147
168,0.18,"(15, 3)","(19, 23)",16,76,256,348,5,58,96,159
169,0.14,"(22, 28)","(20, 29)",12,26,25,63,6,49,43,98
170,0.1,"(27, 16)","(25, 1)",26,61,168,255,12,55,102,169
171,0.2,"(23, 13)","(1, 27)",5,31,55,91,14,40,64,118
172,0.06,"(18, 4)","(10, 10)",8,26,72,106,10,61,98,169
173,0.14,"(11, 1)","(7, 13)",6,71,296,373,6,55,46,107
174,0.14,"(13, 21)","(5, 10)",6,81,143,230,8,61,57,126
175,0.08,"(5, 11)","(7, 21)",6,66,105,177,4,34,34,72
176,0.1,"(17, 16)","(25, 7)",4,86,283,373,4,76,219,299
177,0.08,"(27, 24)","(1, 22)",6,56,155,217,3,46,84,133
178,0.18,"(16, 8)","(13, 1)",7,36,183,226,5,55,102,162
179,0.04,"(22, 18)","(18, 18)",15,21,27,63,12,97,168,277
180,0.02,"(16, 22)","(27, 0)",12,36,63,111,6,169,450,625
181,0.14,"(18, 7)","(3, 7)",10,66,322,398,15,40,52,107
182,0.08,"(27, 7)","(11, 11)",4,51,71,126,4,79,105,188
183,0.16,"(5, 19)","(4, 28)",5,26,37,68,13,43,48,104
184,0.16,"(17, 19)","(27, 21)",10,36,54,100,10,82,170,262
185,0.1,"(20, 25)","(3, 10)",5,36,97,138,9,64,237,310
186,0.14,"(17, 20)","(14, 2)",9,46,245,300,5,67,120,192
187,0.12,"(16, 10)","(19, 26)",8,81,131,220,5,76,132,213
188,0.14,"(15, 9)","(6, 14)",7,36,67,110,7,52,47,106
189,0.1,"(29, 12)","(15, 7)",5,36,178,219,14,43,53,110
190,0.16,"(21, 27)","(15, 25)",10,81,227,318,8,34,12,54
191,0.06,"(22, 20)","(18, 11)",6,61,131,198,6,103,182,291
192,0.18,"(5, 10)","(19, 21)",6,51,196,253,5,73,235,313
193,0.04,"(0, 1)","(18, 12)",3,141,308,452,6,55,144,205
194,0.1,"(3, 18)","(0, 19)",9,6,15,30,12,31,16,59
195,0.1,"(16, 2)","(25, 24)",6,36,120,162,10,64,90,164
196,0.08,"(25, 6)","(3, 28)",6,26,56,88,6,70,92,168
197,0.14,"(19, 29)","(28, 3)",48,36,185,269,7,43,102,152
198,0.1,"(21, 6)","(27, 10)",9,81,226,316,12,55,92,159
199,0.02,"(29, 15)","(14, 3)",7,51,130,188,6,139,147,292
200,0.04,"(12, 14)","(4, 8)",5,106,227,338,6,52,40,98
201,0.1,"(27, 0)","(0, 21)",15,36,105,156,8,64,103,175
202,0.12,"(17, 25)","(16, 27)",6,51,94,151,4,49,75,128
203,0.2,"(23, 21)","(21, 10)",4,91,315,410,7,40,63,110
204,0.04,"(13, 19)","(25, 1)",20,36,97,153,10,118,209,337
205,0.06,"(27, 24)","(11, 24)",13,36,46,95,21,142,518,681
206,0.08,"(1, 23)","(23, 21)",3,41,114,158,8,76,239,323
207,0.02,"(15, 1)","(9, 2)",12,146,138,296,5,127,142,274
208,0.2,"(4, 28)","(16, 16)",4,66,224,294,2,115,759,876
209,0.14,"(29, 18)","(10, 25)",5,31,117,153,7,49,91,147
210,0.14,"(4, 17)","(9, 8)",4,66,374,444,5,67,98,170
211,0.04,"(29, 25)","(14, 11)",6,46,98,150,3,64,96,163
212,0.16,"(5, 22)","(7, 12)",28,76,328,432,16,64,83,163
213,0.18,"(29, 26)","(12, 22)",4,56,191,251,4,85,433,522
214,0.12,"(17, 3)","(10, 8)",9,51,64,124,4,46,21,71
215,0.04,"(2, 13)","(27, 11)",6,136,277,419,6,64,119,189
216,0.06,"(24, 1)","(18, 22)",4,46,114,164,11,46,164,221
217,0.1,"(13, 9)","(8, 21)",5,61,154,220,6,40,102,148
218,0.1,"(15, 20)","(25, 3)",6,26,86,118,9,64,238,311
219,0.06,"(29, 7)","(13, 2)",12,31,70,113,42,67,140,249
220,0.06,"(3, 11)","(8, 9)",5,81,142,228,9,61,99,169
221,0.14,"(4, 23)","(27, 3)",2,26,76,104,6,55,72,133
222,0.04,"(3, 11)","(14, 22)",10,66,150,226,6,103,148,257
223,0.06,"(27, 26)","(15, 15)",4,81,231,316,4,88,198,290
224,0.06,"(26, 24)","(3, 24)",10,31,101,142,8,43,51,102
225,0.12,"(23, 20)","(8, 16)",8,41,120,169,10,67,126,203
226,0.06,"(11, 5)","(6, 23)",8,31,107,146,4,46,47,97
227,0.2,"(21, 9)","(24, 20)",62,56,232,350,22,43,87,152
228,0.08,"(1, 1)","(29, 2)",5,31,111,147,17,52,119,188
229,0.1,"(24, 27)","(15, 10)",7,56,198,261,5,79,175,259
230,0.08,"(6, 14)","(21, 11)",12,76,149,237,14,67,130,211
231,0.18,"(14, 26)","(4, 22)",5,121,482,608,4,52,48,104
232,0.14,"(8, 22)","(10, 22)",4,21,28,53,4,37,25,66
233,0.02,"(10, 6)","(3, 7)",6,86,102,194,19,43,34,96
234,0.14,"(26, 21)","(16, 12)",6,141,454,601,5,64,168,237
235,0.06,"(9, 28)","(23, 8)",10,81,183,274,5,103,277,385
236,0.12,"(19, 12)","(21, 14)",10,6,11,27,11,58,53,122
237,0.2,"(19, 13)","(9, 24)",7,66,259,332,7,58,235,300
238,0.2,"(9, 4)","(1, 26)",7,26,109,142,6,52,139,197
239,0.06,"(21, 8)","(0, 17)",15,41,91,147,9,43,53,105
240,0.2,"(18, 27)","(20, 8)",3,61,152,216,4,64,168,236
241,0.1,"(17, 19)","(29, 9)",12,76,221,309,5,64,160,229
242,0.16,"(11, 25)","(24, 15)",16,51,160,227,5,79,240,324
243,0.18,"(2, 21)","(24, 29)",19,16,117,152,9,82,332,423
244,0.14,"(17, 20)","(27, 17)",26,86,238,350,6,58,96,160
245,0.04,"(13, 24)","(1, 13)",7,41,160,208,6,55,51,112
246,0.2,"(13, 4)","(5, 15)",13,51,305,369,8,43,144,195
247,0.14,"(2, 12)","(16, 11)",6,66,220,292,4,40,72,116
248,0.02,"(8, 0)","(12, 28)",7,96,219,322,4,61,128,193
249,0.04,"(28, 8)","(4, 7)",6,136,306,448,4,100,277,381
250,0.14,"(29, 14)","(5, 6)",5,71,288,364,9,82,239,330
251,0.14,"(6, 6)","(11, 25)",5,51,145,201,5,76,150,231
252,0.06,"(25, 12)","(12, 0)",7,41,131,179,16,40,149,205
253,0.08,"(4, 26)","(24, 4)",18,41,106,165,7,64,85,156
254,0.14,"(16, 2)","(21, 14)",10,46,123,179,13,73,125,211
255,0.14,"(2, 10)","(4, 1)",3,46,216,265,5,61,80,146
256,0.02,"(9, 4)","(13, 3)",12,36,28,76,4,100,192,296
257,0.06,"(14, 1)","(13, 28)",9,46,122,177,7,76,229,312
258,0.1,"(28, 29)","(26, 5)",8,41,145,194,14,70,223,307
259,0.2,"(6, 21)","(7, 26)",22,31,59,112,4,61,66,131
260,0.06,"(4, 5)","(21, 15)",4,71,203,278,5,121,246,372
261,0.12,"(1, 28)","(3, 4)",3,36,117,156,3,43,46,92
262,0.16,"(3, 17)","(13, 29)",5,36,114,155,5,49,98,152
263,0.2,"(17, 16)","(5, 7)",5,61,133,199,10,61,245,316
264,0.12,"(1, 4)","(20, 21)",5,81,233,319,6,79,219,304
265,0.2,"(13, 20)","(0, 18)",6,86,340,432,6,34,24,64
266,0.1,"(14, 27)","(1, 13)",4,66,140,210,4,37,34,75
267,0.06,"(1, 20)","(12, 13)",5,71,214,290,12,46,59,117
268,0.04,"(25, 22)","(13, 21)",8,46,116,170,9,43,33,85
269,0.04,"(6, 21)","(22, 29)",5,91,110,206,9,52,103,164
270,0.2,"(24, 15)","(0, 28)",10,6,48,64,7,43,89,139
271,0.16,"(15, 6)","(9, 10)",3,71,287,361,10,43,28,81
272,0.16,"(27, 17)","(20, 22)",12,36,42,90,4,73,204,281
273,0.2,"(19, 18)","(22, 23)",11,31,85,127,12,67,99,178
274,0.16,"(20, 4)","(8, 20)",13,61,107,181,5,79,176,260
275,0.08,"(2, 1)","(9, 9)",3,31,40,74,6,49,90,145
276,0.1,"(28, 1)","(6, 15)",6,91,328,425,6,79,198,283
277,0.06,"(25, 3)","(6, 20)",32,81,187,300,9,76,218,303
278,0.12,"(21, 4)","(5, 29)",13,71,170,254,10,67,234,311
279,0.16,"(9, 12)","(12, 14)",12,21,22,55,6,43,22,71
280,0.2,"(6, 24)","(10, 15)",8,76,375,459,5,52,93,150
281,0.1,"(29, 13)","(7, 20)",17,71,167,255,9,34,62,105
282,0.12,"(16, 23)","(3, 11)",19,36,164,219,10,76,229,315
283,0.12,"(7, 18)","(18, 18)",4,61,82,147,4,82,198,284
284,0.08,"(14, 18)","(18, 0)",27,51,165,243,11,70,106,187
285,0.2,"(21, 9)","(27, 8)",4,36,46,86,6,40,30,76
286,0.02,"(0, 11)","(26, 16)",12,126,275,413,10,121,200,331
287,0.08,"(8, 12)","(17, 2)",13,36,73,122,5,55,133,193
288,0.12,"(23, 11)","(2, 21)",9,46,137,192,22,58,124,204
289,0.04,"(28, 7)","(6, 28)",12,16,72,100,4,67,168,239
290,0.14,"(10, 14)","(10, 22)",23,31,96,150,6,43,60,109
291,0.12,"(2, 14)","(8, 9)",4,36,61,101,13,46,98,157
292,0.2,"(10, 25)","(24, 22)",4,116,565,685,5,70,183,258
293,0.06,"(19, 17)","(11, 27)",9,56,142,207,6,127,193,326
294,0.04,"(4, 12)","(7, 11)",7,66,53,126,11,49,38,98
295,0.02,"(15, 2)","(3, 5)",9,66,160,235,7,103,99,209
296,0.08,"(18, 3)","(25, 5)",14,46,85,145,7,88,195,290
297,0.14,"(22, 21)","(12, 5)",12,61,235,308,4,97,222,323
298,0.06,"(13, 5)","(11, 5)",5,61,74,140,7,55,72,134
299,0.16,"(27, 0)","(13, 17)",3,96,345,444,7,49,179,235
300,0.12,"(4, 1)","(13, 8)",9,51,220,280,6,64,76,146
301,0.02,"(3, 23)","(26, 17)",10,191,351,552,6,148,475,629
302,0.14,"(5, 14)","(10, 9)",4,31,43,78,5,43,51,99
303,0.12,"(13, 29)","(14, 19)",4,106,179,289,4,34,38,76
304,0.2,"(8, 12)","(27, 3)",6,36,102,144,8,79,358,445
305,0.1,"(13, 1)","(15, 29)",7,26,78,111,5,67,138,210
306,0.16,"(4, 24)","(2, 9)",7,51,89,147,6,64,186,256
307,0.2,"(21, 7)","(5, 29)",23,41,107,171,3,91,308,402
308,0.16,"(29, 8)","(4, 12)",13,66,236,315,7,55,86,148
309,0.18,"(10, 21)","(11, 7)",9,56,268,333,7,52,96,155
310,0.16,"(16, 9)","(9, 21)",5,36,230,271,5,58,259,322
311,0.1,"(29, 1)","(21, 21)",7,91,195,293,5,61,141,207
312,0.02,"(12, 15)","(14, 1)",17,26,73,116,9,79,234,322
313,0.08,"(7, 26)","(22, 14)",10,66,173,249,5,61,158,224
314,0.18,"(19, 13)","(17, 21)",9,31,81,121,9,43,41,93
315,0.16,"(19, 16)","(29, 21)",6,41,187,234,13,67,151,231
316,0.18,"(19, 7)","(18, 10)",12,41,28,81,5,61,56,122
317,0.06,"(7, 26)","(3, 3)",13,71,217,301,28,46,77,151
318,0.08,"(29, 26)","(29, 13)",6,41,48,95,21,88,395,504
319,0.2,"(2, 1)","(12, 1)",6,31,58,95,9,79,316,404
320,0.14,"(17, 3)","(26, 18)",11,41,138,190,5,70,107,182
321,0.04,"(18, 23)","(29, 29)",19,101,305,425,4,97,261,362
322,0.08,"(29, 21)","(20, 4)",8,61,125,194,4,73,173,250
323,0.16,"(22, 22)","(11, 17)",10,46,214,270,5,55,69,129
324,0.04,"(25, 19)","(11, 11)",7,71,120,198,4,109,326,439
325,0.04,"(14, 16)","(9, 19)",8,181,295,484,9,55,50,114
326,0.08,"(0, 2)","(0, 4)",9,21,16,46,11,49,28,88
327,0.1,"(22, 6)","(25, 16)",20,71,184,275,9,73,129,211
328,0.2,"(4, 1)","(16, 25)",5,61,225,291,6,61,211,278
329,0.12,"(16, 14)","(21, 19)",8,36,42,86,9,94,146,249
330,0.04,"(1, 12)","(21, 2)",10,61,148,219,5,106,290,401
331,0.14,"(18, 18)","(5, 5)",8,21,104,133,9,76,198,283
332,0.04,"(29, 20)","(24, 27)",9,101,130,240,7,70,110,187
333,0.02,"(10, 14)","(7, 29)",5,66,145,216,16,115,195,326
334,0.02,"(29, 28)","(2, 26)",3,76,120,199,5,52,69,126
335,0.08,"(5, 2)","(28, 20)",3,46,147,196,5,58,118,181
336,0.18,"(20, 18)","(7, 1)",5,61,335,401,5,58,72,135
337,0.04,"(0, 12)","(10, 18)",5,131,167,303,21,115,219,355
338,0.02,"(0, 20)","(3, 23)",4,96,142,242,91,73,185,349
339,0.08,"(5, 21)","(16, 21)",7,51,96,154,9,43,71,123
340,0.1,"(8, 2)","(23, 15)",22,46,115,183,5,82,206,293
341,0.1,"(18, 7)","(24, 2)",9,21,74,104,4,97,189,290
342,0.06,"(22, 20)","(3, 2)",9,16,67,92,4,49,61,114
343,0.02,"(25, 7)","(18, 19)",5,66,173,244,5,133,193,331
344,0.14,"(16, 9)","(27, 10)",4,36,96,136,6,67,123,196
345,0.06,"(23, 10)","(2, 19)",6,81,235,322,5,49,74,128
346,0.12,"(14, 11)","(6, 21)",8,56,132,196,4,52,90,146
347,0.1,"(19, 0)","(11, 6)",9,46,172,227,9,46,45,100
348,0.1,"(19, 27)","(23, 2)",8,46,134,188,10,82,153,245
349,0.18,"(3, 9)","(1, 6)",3,31,39,73,5,52,29,86
350,0.18,"(13, 20)","(6, 23)",12,31,72,115,4,49,68,121
351,0.04,"(1, 15)","(9, 14)",5,141,135,281,4,127,280,411
352,0.1,"(28, 13)","(26, 29)",6,36,87,129,5,43,147,195
353,0.04,"(26, 6)","(4, 13)",6,91,133,230,7,37,51,95
354,0.2,"(15, 9)","(17, 9)",7,6,8,21,8,31,9,48
355,0.16,"(0, 1)","(5, 0)",9,31,90,130,12,49,62,123
356,0.08,"(2, 22)","(20, 14)",6,71,131,208,3,82,186,271
357,0.14,"(13, 1)","(2, 7)",4,31,34,69,6,82,165,253
358,0.14,"(13, 24)","(28, 7)",3,36,114,153,18,73,152,243
359,0.2,"(2, 18)","(4, 14)",6,61,316,383,7,58,121,186
360,0.14,"(10, 8)","(23, 21)",5,66,99,170,17,46,184,247
361,0.02,"(17, 14)","(26, 14)",4,111,214,329,6,118,163,287
362,0.18,"(0, 29)","(4, 11)",5,51,77,133,4,46,44,94
363,0.2,"(23, 18)","(26, 20)",9,26,30,65,7,55,56,118
364,0.1,"(13, 2)","(23, 3)",8,56,95,159,7,67,89,163
365,0.12,"(6, 24)","(24, 18)",15,61,153,229,7,52,123,182
366,0.18,"(8, 29)","(23, 17)",8,56,320,384,7,82,265,354
367,0.08,"(14, 20)","(12, 20)",8,21,18,47,6,31,9,46
368,0.12,"(27, 22)","(18, 16)",11,71,258,340,7,91,317,415
369,0.14,"(4, 21)","(7, 2)",4,56,188,248,6,61,198,265
370,0.2,"(12, 9)","(28, 27)",4,16,44,64,7,43,53,103
371,0.18,"(1, 26)","(26, 24)",12,71,251,334,10,52,173,235
372,0.1,"(14, 3)","(2, 27)",11,61,157,229,32,109,230,371
373,0.06,"(26, 12)","(11, 27)",9,81,152,242,10,73,158,241
374,0.1,"(2, 3)","(21, 24)",15,56,140,211,9,76,179,264
375,0.18,"(14, 19)","(9, 13)",32,51,121,204,6,55,73,134
376,0.08,"(9, 4)","(20, 6)",5,56,62,123,4,58,87,149
377,0.16,"(2, 24)","(3, 8)",13,41,185,239,12,52,80,144
378,0.06,"(5, 29)","(5, 28)",9,31,18,58,8,31,9,48
379,0.2,"(11, 16)","(0, 2)",5,21,137,163,9,40,141,190
380,0.08,"(8, 14)","(3, 15)",11,81,109,201,13,34,31,78
381,0.12,"(12, 2)","(5, 3)",5,61,64,130,3,61,53,117
382,0.14,"(6, 9)","(14, 14)",3,61,299,363,7,52,98,157
383,0.12,"(8, 24)","(9, 12)",5,21,66,92,8,73,126,207
384,0.04,"(27, 20)","(7, 9)",5,116,218,339,3,103,244,350
385,0.08,"(10, 20)","(19, 19)",9,56,82,147,12,67,101,180
386,0.02,"(2, 10)","(5, 5)",12,31,78,121,11,64,107,182
387,0.1,"(7, 0)","(9, 26)",14,51,175,240,5,64,121,190
388,0.02,"(12, 25)","(4, 2)",10,61,140,211,11,112,427,550
389,0.08,"(4, 17)","(27, 5)",18,71,162,251,6,58,139,203
390,0.08,"(2, 22)","(17, 25)",5,51,103,159,21,52,116,189
391,0.1,"(11, 19)","(5, 7)",17,66,151,234,9,40,93,142
392,0.1,"(29, 9)","(11, 14)",10,66,208,284,6,76,134,216
393,0.16,"(25, 25)","(15, 22)",8,36,74,118,6,61,132,199
394,0.08,"(9, 2)","(4, 2)",16,11,18,45,8,46,49,103
395,0.18,"(29, 13)","(19, 1)",7,61,232,300,14,73,136,223
396,0.18,"(21, 15)","(19, 1)",10,56,295,361,18,43,132,193
397,0.16,"(7, 18)","(29, 29)",7,41,122,170,4,34,81,119
398,0.04,"(12, 4)","(7, 6)",15,111,126,252,9,46,44,99
399,0.18,"(8, 11)","(9, 2)",9,56,261,326,6,52,100,158
400,0.06,"(26, 0)","(15, 3)",6,81,118,205,14,43,44,101
401,0.16,"(5, 6)","(27, 21)",9,76,265,350,7,73,202,282
402,0.08,"(5, 20)","(8, 24)",7,76,97,180,4,58,45,107
403,0.12,"(28, 18)","(1, 20)",4,36,151,191,5,52,54,111
404,0.04,"(19, 29)","(24, 4)",7,136,287,430,3,112,149,264
405,0.18,"(18, 23)","(24, 8)",4,51,107,162,5,73,343,421
406,0.14,"(11, 15)","(24, 12)",8,61,162,231,3,43,102,148
407,0.2,"(8, 22)","(5, 20)",9,6,15,30,7,31,13,51
408,0.06,"(2, 13)","(5, 26)",16,56,79,151,16,64,115,195
409,0.2,"(12, 6)","(27, 29)",4,16,50,70,5,64,102,171
410,0.02,"(0, 27)","(4, 15)",7,106,129,242,11,94,213,318
411,0.18,"(4, 3)","(12, 3)",10,51,72,133,12,52,77,141
412,0.06,"(16, 9)","(13, 4)",11,46,74,131,13,37,34,84
413,0.08,"(24, 13)","(20, 12)",6,21,26,53,7,67,176,250
414,0.12,"(2, 29)","(17, 11)",11,51,203,265,4,88,188,280
415,0.12,"(23, 0)","(16, 17)",7,36,187,230,4,79,194,277
416,0.12,"(18, 23)","(14, 1)",8,36,133,177,12,58,134,204
417,0.14,"(6, 15)","(5, 1)",8,51,103,162,12,46,39,97
418,0.06,"(29, 11)","(28, 2)",10,56,149,215,15,34,55,104
419,0.16,"(1, 7)","(21, 9)",3,81,234,318,5,79,131,215
420,0.1,"(3, 12)","(27, 28)",9,66,105,180,17,79,138,234
421,0.04,"(16, 25)","(9, 17)",8,41,220,269,12,82,165,259
422,0.02,"(17, 7)","(2, 11)",5,41,42,88,10,67,106,183
423,0.06,"(18, 24)","(26, 29)",3,66,121,190,5,91,152,248
424,0.18,"(9, 7)","(7, 18)",10,91,293,394,12,70,103,185
425,0.06,"(8, 4)","(10, 5)",7,26,15,48,5,31,6,42
426,0.1,"(26, 23)","(0, 17)",8,56,132,196,6,40,61,107
427,0.12,"(13, 10)","(2, 16)",8,41,113,162,5,43,46,94
428,0.18,"(15, 23)","(20, 20)",6,76,328,410,4,49,82,135
429,0.02,"(3, 29)","(16, 3)",5,61,104,170,8,61,180,249
430,0.04,"(0, 24)","(20, 17)",3,116,254,373,7,73,116,196
431,0.2,"(9, 19)","(3, 1)",12,36,98,146,10,52,159,221
432,0.12,"(24, 8)","(0, 9)",4,36,97,137,10,58,190,258
433,0.18,"(11, 8)","(26, 8)",11,76,353,440,15,58,253,326
434,0.02,"(23, 9)","(29, 25)",11,66,215,292,5,85,153,243
435,0.04,"(0, 16)","(12, 3)",9,141,369,519,4,79,128,211
436,0.12,"(4, 5)","(18, 11)",4,66,170,240,13,67,158,238
437,0.1,"(18, 6)","(3, 8)",6,31,73,110,5,79,84,168
438,0.16,"(13, 10)","(0, 7)",5,71,242,318,7,34,32,73
439,0.1,"(15, 24)","(21, 24)",3,71,69,143,5,76,108,189
440,0.04,"(2, 26)","(23, 29)",4,41,96,141,5,43,114,162
441,0.14,"(13, 14)","(10, 16)",4,46,88,138,4,49,25,78
442,0.04,"(16, 15)","(25, 14)",8,36,74,118,13,88,219,320
443,0.02,"(14, 5)","(23, 9)",6,126,162,294,6,175,243,424
444,0.14,"(20, 27)","(6, 11)",3,86,214,303,4,52,156,212
445,0.2,"(11, 12)","(0, 18)",6,76,363,445,9,58,188,255
446,0.14,"(8, 13)","(22, 4)",10,41,113,164,5,46,90,141
447,0.12,"(4, 28)","(21, 10)",8,31,103,142,6,88,216,310
448,0.04,"(4, 7)","(25, 16)",12,56,151,219,12,67,154,233
449,0.2,"(4, 0)","(5, 6)",2,31,27,60,4,55,66,125
450,0.2,"(1, 23)","(19, 29)",11,61,246,318,13,112,538,663
451,0.12,"(8, 1)","(5, 18)",4,26,168,198,7,73,219,299
452,0.2,"(19, 21)","(25, 15)",7,66,274,347,6,55,117,178
453,0.04,"(14, 24)","(6, 8)",4,21,90,115,9,37,50,96
454,0.08,"(0, 12)","(20, 19)",17,56,147,220,7,58,176,241
455,0.14,"(28, 9)","(3, 9)",15,41,142,198,5,34,41,80
456,0.16,"(7, 28)","(0, 29)",4,16,16,36,5,43,21,69
457,0.14,"(5, 2)","(7, 1)",15,51,65,131,7,43,28,78
458,0.02,"(8, 27)","(6, 1)",9,141,309,459,4,46,52,102
459,0.12,"(14, 17)","(3, 10)",8,51,161,220,4,88,138,230
460,0.16,"(13, 11)","(15, 0)",10,36,135,181,5,52,118,175
461,0.14,"(0, 3)","(3, 24)",23,41,94,158,13,61,138,212
462,0.16,"(0, 19)","(0, 9)",2,21,30,53,15,40,43,98
463,0.2,"(2, 4)","(27, 16)",6,56,138,200,6,88,270,364
464,0.02,"(28, 2)","(8, 8)",6,166,262,434,8,187,419,614
465,0.14,"(13, 4)","(14, 23)",8,56,202,266,35,85,290,410
466,0.12,"(20, 9)","(9, 1)",6,66,222,294,6,52,189,247
467,0.04,"(20, 2)","(2, 20)",10,106,268,384,7,64,141,212
468,0.04,"(0, 10)","(7, 15)",4,66,99,169,8,43,56,107
469,0.14,"(16, 0)","(12, 3)",7,11,24,42,12,34,28,74
470,0.14,"(5, 13)","(16, 7)",15,96,247,358,10,82,162,254
471,0.12,"(27, 21)","(17, 7)",4,96,332,432,4,82,197,283
472,0.2,"(2, 2)","(1, 13)",6,36,32,74,10,46,34,90
473,0.2,"(1, 28)","(10, 16)",4,51,219,274,5,64,167,236
474,0.06,"(11, 10)","(1, 15)",8,16,41,65,6,58,146,210
475,0.02,"(29, 15)","(18, 28)",13,101,169,283,6,220,443,669
476,0.14,"(9, 8)","(21, 20)",9,31,79,119,9,79,154,242
477,0.02,"(5, 1)","(27, 21)",6,56,93,155,11,142,293,446
478,0.1,"(29, 24)","(20, 23)",11,36,78,125,32,58,78,168
479,0.08,"(28, 1)","(11, 22)",7,51,119,177,9,67,245,321
480,0.18,"(2, 26)","(5, 15)",5,71,343,419,8,61,55,124
481,0.04,"(29, 29)","(7, 18)",9,91,133,233,8,151,328,487
482,0.16,"(13, 13)","(5, 12)",6,56,327,389,7,46,57,110
483,0.02,"(12, 0)","(19, 29)",9,166,297,472,12,85,148,245
484,0.16,"(28, 13)","(10, 28)",5,51,86,142,13,61,229,303
485,0.12,"(22, 21)","(23, 14)",9,46,123,178,23,58,82,163
486,0.02,"(6, 14)","(8, 18)",9,76,42,127,30,58,75,163
487,0.04,"(5, 5)","(29, 26)",6,16,56,78,13,121,461,595
488,0.02,"(21, 7)","(7, 14)",7,141,137,285,8,118,235,361
489,0.04,"(4, 6)","(1, 6)",4,21,17,42,6,49,72,127
490,0.04,"(22, 1)","(9, 10)",13,131,174,318,16,151,227,394
491,0.02,"(6, 24)","(9, 18)",12,71,181,264,14,52,41,107
492,0.12,"(17, 25)","(5, 0)",5,71,169,245,4,82,190,276
493,0.08,"(8, 22)","(22, 19)",7,101,384,492,7,79,169,255
494,0.02,"(15, 14)","(27, 0)",4,36,105,145,4,151,299,454
495,0.18,"(22, 19)","(6, 27)",8,91,182,281,7,46,107,160
496,0.04,"(16, 11)","(23, 19)",15,56,193,264,5,61,67,133
497,0.12,"(17, 7)","(20, 1)",8,41,49,98,8,40,51,99
498,0.1,"(24, 22)","(1, 10)",8,26,81,115,13,58,101,172
499,0.14,"(4, 6)","(6, 0)",8,56,105,169,8,49,55,112
500,0.14,"(3, 1)","(4, 23)",4,51,225,280,10,79,177,266
501,0.16,"(26, 2)","(20, 22)",8,71,227,306,7,55,134,196
502,0.08,"(23, 14)","(2, 6)",4,56,84,144,3,58,75,136
503,0.02,"(7, 16)","(2, 8)",18,196,161,375,4,151,306,461
504,0.06,"(2, 6)","(22, 7)",4,71,202,277,7,82,189,278
505,0.12,"(21, 11)","(9, 27)",4,41,80,125,5,43,74,122
506,0.2,"(26, 20)","(2, 29)",8,16,92,116,4,43,88,135
507,0.18,"(11, 25)","(6, 23)",10,46,79,135,4,67,91,162
508,0.02,"(19, 18)","(12, 18)",10,76,112,198,7,91,88,186
509,0.14,"(9, 24)","(2, 11)",6,91,326,423,7,34,28,69
510,0.2,"(29, 7)","(2, 18)",8,36,96,140,12,55,100,167
511,0.2,"(16, 25)","(8, 2)",6,51,90,147,7,85,172,264
512,0.06,"(1, 26)","(12, 27)",4,46,60,110,4,40,44,88
513,0.08,"(8, 9)","(29, 1)",12,21,93,126,12,79,206,297
514,0.18,"(26, 22)","(26, 17)",7,31,96,134,16,67,143,226
515,0.06,"(7, 8)","(16, 20)",7,96,259,362,5,85,260,350
516,0.06,"(0, 10)","(5, 29)",5,26,140,171,3,85,115,203
517,0.06,"(21, 10)","(23, 27)",11,51,254,316,9,91,333,433
518,0.06,"(17, 7)","(25, 0)",6,46,194,246,11,40,80,131
519,0.16,"(10, 14)","(16, 17)",8,106,423,537,25,64,130,219
520,0.14,"(14, 27)","(16, 7)",3,76,279,358,3,55,111,169
521,0.04,"(24, 16)","(22, 15)",6,36,21,63,4,34,9,47
522,0.2,"(22, 6)","(3, 29)",3,26,56,85,9,52,115,176
523,0.18,"(11, 3)","(3, 21)",8,46,158,212,4,61,237,302
524,0.14,"(29, 0)","(4, 10)",7,56,257,320,2,43,98,143
525,0.06,"(27, 22)","(24, 26)",8,31,33,72,7,64,74,145
526,0.18,"(22, 19)","(26, 23)",5,56,212,273,7,49,116,172
527,0.2,"(5, 16)","(14, 22)",11,71,138,220,13,64,140,217
528,0.14,"(23, 5)","(6, 18)",5,41,213,259,13,109,759,881
529,0.08,"(2, 8)","(6, 14)",3,96,83,182,4,73,91,168
530,0.08,"(23, 11)","(8, 5)",8,71,140,219,7,61,106,174
531,0.16,"(14, 10)","(22, 21)",6,76,254,336,7,55,268,330
532,0.2,"(28, 1)","(26, 15)",8,56,275,339,6,76,293,375
533,0.04,"(21, 23)","(21, 22)",4,6,5,15,5,31,6,42
534,0.14,"(24, 12)","(22, 8)",11,21,36,68,5,49,68,122
535,0.12,"(20, 8)","(28, 15)",9,61,208,278,9,52,94,155
536,0.1,"(9, 10)","(8, 29)",8,51,156,215,17,34,52,103
537,0.04,"(22, 24)","(0, 16)",7,81,128,216,4,34,37,75
538,0.12,"(11, 25)","(27, 13)",11,41,106,158,14,79,190,283
539,0.04,"(16, 8)","(23, 20)",4,71,127,202,9,46,133,188
540,0.18,"(28, 24)","(1, 6)",2,21,69,92,8,73,276,357
541,0.2,"(13, 9)","(15, 23)",11,61,312,384,3,43,61,107
542,0.12,"(7, 16)","(27, 8)",8,41,99,148,10,52,69,131
543,0.18,"(23, 8)","(11, 0)",10,36,134,180,8,67,196,271
544,0.02,"(8, 6)","(28, 12)",11,141,214,366,5,97,353,455
545,0.12,"(5, 3)","(29, 4)",8,66,258,332,8,40,98,146
546,0.2,"(0, 9)","(3, 29)",19,41,97,157,5,52,255,312
547,0.02,"(16, 14)","(19, 18)",7,116,159,282,4,130,237,371
548,0.16,"(0, 28)","(19, 16)",14,61,225,300,21,52,207,280
549,0.14,"(11, 8)","(12, 5)",4,51,80,135,6,52,46,104
550,0.1,"(3, 12)","(24, 0)",15,51,111,177,11,58,161,230
551,0.02,"(14, 18)","(21, 29)",13,106,170,289,5,85,149,239
552,0.12,"(21, 25)","(22, 12)",3,36,96,135,4,46,88,138
553,0.02,"(27, 28)","(8, 12)",3,101,345,449,3,139,277,419
554,0.1,"(8, 28)","(17, 15)",6,41,73,120,5,58,103,166
555,0.16,"(6, 23)","(4, 10)",6,51,159,216,9,64,307,380
556,0.1,"(4, 1)","(21, 20)",10,101,200,311,7,79,277,363
557,0.04,"(1, 26)","(8, 16)",3,41,100,144,5,91,110,206
558,0.06,"(10, 2)","(20, 2)",6,41,53,100,6,37,63,106
559,0.06,"(24, 12)","(1, 11)",6,61,115,182,8,58,107,173
560,0.08,"(19, 12)","(12, 23)",5,96,197,298,3,82,115,200
561,0.04,"(15, 9)","(27, 10)",12,61,125,198,6,70,121,197
562,0.06,"(21, 10)","(9, 6)",10,31,56,97,6,61,78,145
563,0.08,"(11, 29)","(23, 26)",4,71,196,271,4,49,90,143
564,0.14,"(3, 0)","(22, 17)",6,86,286,378,4,58,190,252
565,0.08,"(26, 4)","(12, 21)",5,56,113,174,8,55,102,165
566,0.08,"(10, 4)","(25, 2)",5,86,164,255,8,52,65,125
567,0.04,"(18, 13)","(8, 7)",10,136,205,351,8,40,49,97
568,0.04,"(13, 17)","(3, 1)",6,41,54,101,4,73,71,148
569,0.12,"(27, 17)","(5, 11)",13,36,113,162,20,67,219,306
570,0.2,"(28, 17)","(2, 18)",7,46,249,302,6,55,210,271
571,0.14,"(20, 14)","(1, 18)",9,26,71,106,10,58,106,174
572,0.16,"(26, 5)","(25, 22)",14,36,180,230,7,37,80,124
573,0.04,"(4, 12)","(20, 10)",8,46,130,184,9,121,289,419
574,0.2,"(11, 23)","(15, 14)",7,31,43,81,8,55,108,171
575,0.2,"(3, 15)","(28, 26)",4,31,104,139,7,49,108,164
576,0.14,"(5, 1)","(17, 26)",13,26,88,127,8,76,214,298
577,0.1,"(25, 20)","(3, 4)",3,76,112,191,4,55,114,173
578,0.08,"(29, 9)","(0, 6)",4,31,143,178,6,52,54,112
579,0.12,"(27, 1)","(17, 29)",4,61,194,259,3,79,203,285
580,0.1,"(3, 17)","(3, 8)",3,41,27,71,8,40,32,80
581,0.2,"(20, 2)","(14, 12)",8,61,218,287,10,52,91,153
582,0.12,"(10, 0)","(21, 4)",9,56,112,177,3,76,183,262
583,0.16,"(18, 20)","(13, 24)",10,101,393,504,7,49,45,101
584,0.12,"(7, 15)","(22, 15)",6,41,108,155,3,43,88,134
585,0.04,"(11, 18)","(25, 5)",3,101,225,329,15,91,289,395
586,0.16,"(22, 13)","(1, 18)",6,71,345,422,9,61,106,176
587,0.02,"(0, 5)","(8, 0)",4,31,135,170,3,73,99,175
588,0.04,"(25, 2)","(19, 6)",8,31,28,67,11,85,94,190
589,0.2,"(19, 8)","(23, 11)",7,81,503,591,4,49,74,127
590,0.08,"(2, 21)","(20, 11)",6,111,230,347,6,64,174,244
591,0.04,"(13, 9)","(20, 16)",5,106,228,339,7,124,335,466
592,0.02,"(25, 5)","(1, 25)",9,36,68,113,8,70,86,164
593,0.12,"(27, 18)","(22, 3)",4,66,183,253,11,46,94,151
594,0.18,"(13, 13)","(13, 22)",12,36,56,104,8,64,131,203
595,0.16,"(24, 23)","(21, 16)",7,56,79,142,12,64,176,252
596,0.12,"(13, 19)","(8, 7)",8,71,136,215,4,49,111,164
597,0.12,"(26, 23)","(13, 9)",5,46,204,255,13,64,160,237
598,0.04,"(19, 25)","(7, 22)",8,46,45,99,9,91,118,218
599,0.06,"(22, 4)","(2, 3)",23,71,150,244,8,67,158,233
600,0.12,"(7, 12)","(22, 0)",8,26,102,136,5,61,119,185
601,0.02,"(7, 24)","(11, 5)",6,171,266,443,8,103,213,324
602,0.18,"(28, 16)","(10, 3)",3,31,115,149,11,85,416,512
603,0.04,"(7, 26)","(3, 18)",6,61,65,132,5,52,104,161
604,0.02,"(5, 19)","(10, 21)",6,111,154,271,5,73,77,155
605,0.08,"(24, 28)","(5, 2)",6,36,122,164,7,52,78,137
606,0.1,"(10, 18)","(29, 20)",5,126,195,326,22,55,174,251
607,0.16,"(20, 8)","(16, 9)",17,46,64,127,4,43,25,72
608,0.2,"(1, 9)","(29, 13)",3,36,234,273,3,55,314,372
609,0.08,"(19, 18)","(5, 25)",18,66,175,259,18,118,197,333
610,0.1,"(29, 17)","(21, 6)",12,26,86,124,7,64,171,242
611,0.18,"(10, 2)","(28, 3)",8,26,87,121,6,52,91,149
612,0.14,"(21, 17)","(28, 0)",3,36,166,205,12,37,106,155
613,0.14,"(19, 15)","(8, 1)",10,36,66,112,13,55,226,294
614,0.2,"(3, 1)","(18, 15)",6,71,234,311,5,55,189,249
615,0.1,"(24, 1)","(26, 8)",9,81,105,195,8,49,55,112
616,0.16,"(29, 21)","(25, 21)",5,41,36,82,6,31,8,45
617,0.16,"(27, 18)","(8, 11)",4,36,165,205,4,67,253,324
618,0.18,"(16, 6)","(6, 4)",10,46,74,130,17,49,95,161
619,0.04,"(3, 10)","(4, 15)",20,66,114,200,8,85,169,262
620,0.06,"(8, 29)","(29, 5)",11,31,73,115,8,34,63,105
621,0.18,"(17, 27)","(12, 11)",11,66,265,342,14,64,217,295
622,0.16,"(28, 15)","(16, 5)",4,46,226,276,3,82,254,339
623,0.14,"(28, 6)","(4, 7)",12,51,150,213,3,73,257,333
624,0.08,"(16, 15)","(7, 17)",7,61,112,180,8,58,70,136
625,0.06,"(2, 3)","(3, 28)",6,51,134,191,5,127,370,502
626,0.16,"(27, 29)","(6, 1)",3,36,91,130,5,43,92,140
627,0.02,"(2, 10)","(29, 18)",3,186,269,458,10,70,215,295
628,0.18,"(4, 18)","(10, 12)",5,41,84,130,6,58,82,146
629,0.1,"(21, 3)","(29, 4)",4,21,37,62,3,58,80,141
630,0.1,"(3, 4)","(24, 6)",8,46,96,150,5,64,313,382
631,0.08,"(22, 9)","(9, 29)",6,61,257,324,14,64,180,258
632,0.02,"(18, 2)","(5, 11)",4,146,241,391,9,103,149,261
633,0.16,"(8, 5)","(26, 25)",8,31,97,136,12,76,287,375
634,0.2,"(7, 3)","(0, 5)",5,6,16,27,5,31,20,56
635,0.2,"(16, 9)","(14, 5)",11,61,81,153,9,43,48,100
636,0.14,"(10, 11)","(9, 3)",4,41,60,105,6,61,85,152
637,0.02,"(1, 22)","(3, 19)",6,86,53,145,15,43,23,81
638,0.02,"(6, 8)","(12, 5)",11,86,80,177,12,142,201,355
639,0.02,"(21, 17)","(15, 11)",10,166,198,374,4,127,286,417
640,0.1,"(22, 22)","(15, 19)",8,41,64,113,4,61,53,118
641,0.16,"(18, 18)","(0, 19)",6,21,120,147,11,40,69,120
642,0.16,"(26, 14)","(10, 16)",10,51,209,270,6,58,146,210
643,0.12,"(2, 9)","(16, 6)",10,41,136,187,6,118,268,392
644,0.06,"(3, 27)","(27, 6)",11,66,217,294,3,67,157,227
645,0.02,"(18, 24)","(4, 1)",5,81,180,266,6,76,101,183
646,0.06,"(20, 28)","(20, 29)",4,56,52,112,11,46,27,84
647,0.04,"(21, 7)","(27, 24)",6,126,313,445,15,61,111,187
648,0.1,"(19, 12)","(29, 19)",4,21,113,138,6,55,136,197
649,0.06,"(21, 29)","(25, 19)",11,21,52,84,13,76,156,245
650,0.04,"(23, 27)","(20, 4)",4,81,136,221,12,103,218,333
651,0.08,"(0, 3)","(0, 15)",8,21,82,111,10,49,47,106
652,0.02,"(11, 13)","(4, 26)",3,76,165,244,5,73,125,203
653,0.2,"(3, 29)","(23, 8)",7,41,104,152,6,88,165,259
654,0.02,"(2, 29)","(0, 20)",4,31,27,62,6,61,234,301
655,0.04,"(7, 0)","(8, 26)",15,116,206,337,11,52,68,131
656,0.12,"(27, 27)","(3, 17)",9,36,264,309,5,73,134,212
657,0.2,"(11, 6)","(28, 13)",7,76,265,348,4,64,281,349
658,0.06,"(27, 9)","(22, 22)",9,66,184,259,8,58,99,165
659,0.12,"(21, 19)","(8, 12)",15,26,85,126,11,73,397,481
660,0.12,"(28, 17)","(11, 21)",2,86,194,282,2,64,77,143
661,0.02,"(27, 15)","(23, 25)",9,56,147,212,7,46,50,103
662,0.04,"(1, 24)","(15, 6)",6,121,158,285,4,124,203,331
663,0.18,"(4, 26)","(10, 27)",9,21,44,74,6,52,53,111
664,0.16,"(29, 26)","(0, 4)",3,21,65,89,5,37,70,112
665,0.14,"(16, 18)","(5, 11)",11,71,290,372,12,55,58,125
666,0.04,"(16, 12)","(0, 6)",5,6,29,40,6,52,46,104
667,0.06,"(26, 18)","(28, 1)",7,106,208,321,15,37,80,132
668,0.06,"(12, 16)","(12, 1)",10,46,111,167,22,124,196,342
669,0.1,"(24, 29)","(21, 9)",27,61,187,275,6,67,211,284
670,0.16,"(22, 2)","(13, 19)",5,61,229,295,8,61,236,305
671,0.16,"(21, 24)","(2, 13)",4,66,250,320,3,61,212,276
672,0.1,"(23, 6)","(6, 29)",7,61,177,245,10,40,78,128
673,0.2,"(9, 27)","(23, 17)",4,46,298,348,8,67,186,261
674,0.1,"(22, 24)","(11, 27)",5,96,302,403,4,67,101,172
675,0.18,"(21, 23)","(18, 10)",9,36,79,124,10,40,72,122
676,0.14,"(13, 19)","(23, 5)",5,31,149,185,4,79,200,283
677,0.08,"(13, 5)","(5, 8)",5,46,34,85,8,61,85,154
678,0.1,"(29, 5)","(13, 0)",4,56,95,155,11,73,101,185
679,0.08,"(24, 8)","(28, 22)",4,41,114,159,10,76,190,276
680,0.08,"(14, 14)","(2, 13)",13,51,132,196,5,61,125,191
681,0.02,"(3, 1)","(9, 3)",6,91,186,283,5,61,47,113
682,0.08,"(26, 11)","(29, 13)",11,56,67,134,18,40,56,114
683,0.1,"(8, 22)","(23, 0)",6,46,75,127,4,40,56,100
684,0.08,"(3, 14)","(21, 9)",6,71,119,196,5,46,56,107
685,0.1,"(27, 9)","(23, 11)",4,41,63,108,5,52,82,139
686,0.18,"(1, 15)","(25, 3)",7,41,119,167,10,85,263,358
687,0.1,"(18, 15)","(0, 4)",5,36,106,147,7,46,128,181
688,0.12,"(16, 29)","(29, 16)",4,21,99,124,8,49,103,160
689,0.18,"(17, 22)","(20, 3)",15,66,282,363,4,103,866,973
690,0.2,"(8, 20)","(21, 23)",19,46,290,355,20,58,248,326
691,0.12,"(18, 25)","(14, 13)",6,66,198,270,7,67,168,242
692,0.02,"(0, 8)","(6, 0)",2,36,66,104,2,61,44,107
693,0.1,"(21, 27)","(6, 1)",7,26,66,99,5,46,67,118
694,0.18,"(10, 25)","(13, 29)",6,36,43,85,4,67,98,169
695,0.04,"(10, 5)","(29, 24)",4,121,277,402,5,49,65,119
696,0.08,"(27, 22)","(29, 4)",9,46,134,189,12,55,172,239
697,0.16,"(10, 3)","(28, 13)",12,41,173,226,11,55,138,204
698,0.16,"(13, 26)","(24, 17)",8,31,221,260,10,55,144,209
699,0.1,"(6, 23)","(12, 29)",3,46,148,197,9,73,137,219
700,0.16,"(28, 7)","(1, 15)",4,31,150,185,5,88,239,332
701,0.14,"(18, 13)","(5, 24)",14,71,267,352,12,70,102,184
702,0.12,"(22, 28)","(21, 11)",12,51,292,355,10,52,197,259
703,0.14,"(27, 13)","(0, 28)",6,11,50,67,16,40,102,158
704,0.06,"(6, 4)","(6, 10)",8,101,170,279,4,58,46,108
705,0.1,"(22, 21)","(10, 6)",8,56,216,280,15,94,214,323
706,0.16,"(15, 24)","(18, 15)",4,41,71,116,5,67,109,181
707,0.16,"(0, 26)","(0, 9)",5,51,318,374,8,40,59,107
708,0.02,"(6, 7)","(2, 10)",8,71,93,172,6,103,96,205
709,0.08,"(10, 21)","(23, 8)",4,51,119,174,11,97,362,470
710,0.18,"(19, 2)","(13, 9)",4,56,256,316,9,43,118,170
711,0.04,"(29, 11)","(20, 22)",5,101,216,322,7,97,197,301
712,0.04,"(29, 4)","(10, 9)",5,81,123,209,5,70,74,149
713,0.04,"(28, 10)","(12, 23)",6,81,235,322,4,115,166,285
714,0.1,"(6, 20)","(16, 3)",5,36,98,139,4,52,85,141
715,0.04,"(9, 26)","(12, 5)",8,31,115,154,8,103,200,311
716,0.04,"(16, 9)","(15, 28)",6,66,174,246,11,67,129,207
717,0.1,"(21, 14)","(21, 12)",7,76,114,197,6,40,18,64
718,0.06,"(23, 20)","(20, 21)",7,96,232,335,10,40,60,110
719,0.14,"(15, 21)","(17, 20)",10,61,122,193,5,46,40,91
720,0.1,"(25, 22)","(10, 28)",4,41,69,114,13,55,67,135
721,0.16,"(21, 28)","(14, 17)",7,96,272,375,6,97,281,384
722,0.18,"(12, 0)","(23, 29)",4,26,64,94,11,43,70,124
723,0.2,"(15, 29)","(26, 5)",5,36,104,145,8,70,228,306
724,0.06,"(25, 9)","(25, 28)",5,46,68,119,8,67,186,261
725,0.16,"(20, 12)","(1, 22)",5,66,106,177,7,43,77,127
726,0.12,"(11, 16)","(29, 5)",7,56,87,150,11,40,143,194
727,0.06,"(18, 22)","(10, 14)",2,61,98,161,4,46,52,102
728,0.04,"(15, 2)","(25, 17)",10,81,138,229,9,64,102,175
729,0.18,"(1, 14)","(20, 25)",5,21,75,101,8,58,166,232
730,0.08,"(22, 26)","(6, 12)",4,111,151,266,4,79,313,396
731,0.1,"(24, 28)","(23, 28)",10,36,33,79,9,64,49,122
732,0.08,"(4, 22)","(0, 26)",10,66,88,164,4,64,124,192
733,0.04,"(5, 19)","(1, 12)",7,31,36,74,8,46,31,85
734,0.2,"(22, 14)","(25, 6)",6,16,47,69,5,52,84,141
735,0.06,"(25, 28)","(19, 13)",4,71,219,294,4,70,134,208
736,0.12,"(5, 26)","(13, 24)",5,46,102,153,4,40,53,97
737,0.16,"(6, 26)","(26, 7)",5,46,108,159,13,76,188,277
738,0.06,"(29, 28)","(24, 5)",2,91,284,377,3,148,358,509
739,0.12,"(3, 16)","(4, 2)",27,61,125,213,9,43,55,107
740,0.16,"(5, 22)","(4, 13)",6,66,210,282,6,55,40,101
741,0.04,"(14, 0)","(19, 1)",6,76,231,313,14,40,35,89
742,0.08,"(17, 6)","(29, 28)",4,21,85,110,13,40,97,150
743,0.08,"(12, 15)","(29, 10)",8,66,178,252,10,52,108,170
744,0.12,"(21, 11)","(2, 2)",5,51,101,157,6,46,72,124
745,0.16,"(6, 21)","(8, 2)",4,46,157,207,4,61,223,288
746,0.08,"(29, 23)","(25, 26)",6,31,32,69,18,73,95,186
747,0.18,"(24, 10)","(6, 4)",25,31,126,182,8,76,259,343
748,0.08,"(21, 14)","(7, 16)",5,81,138,224,7,85,103,195
749,0.2,"(20, 20)","(1, 20)",6,46,253,305,7,43,45,95
750,0.02,"(8, 22)","(1, 24)",4,91,73,168,17,55,70,142
751,0.02,"(1, 21)","(25, 11)",6,101,140,247,9,88,166,263
752,0.2,"(9, 29)","(28, 28)",6,46,165,217,6,46,67,119
753,0.16,"(5, 24)","(17, 22)",4,71,157,232,9,82,194,285
754,0.08,"(17, 6)","(2, 26)",4,56,166,226,7,70,118,195
755,0.04,"(11, 28)","(29, 19)",6,76,178,260,7,64,137,208
756,0.1,"(20, 20)","(9, 18)",6,36,89,131,4,76,205,285
757,0.02,"(26, 20)","(21, 14)",3,21,48,72,3,73,116,192
758,0.02,"(14, 23)","(24, 14)",13,76,229,318,6,166,337,509
759,0.14,"(17, 27)","(7, 14)",4,41,191,236,5,106,487,598
760,0.04,"(3, 12)","(0, 19)",8,46,109,163,12,73,130,215
761,0.2,"(17, 28)","(19, 12)",5,66,293,364,6,46,67,119
762,0.16,"(8, 11)","(7, 6)",6,26,30,62,7,46,85,138
763,0.06,"(20, 14)","(22, 24)",9,76,162,247,5,40,79,124
764,0.06,"(16, 21)","(2, 24)",8,156,306,470,8,88,262,358
765,0.1,"(28, 23)","(1, 12)",14,51,143,208,5,52,112,169
766,0.08,"(27, 5)","(5, 18)",9,36,117,162,4,55,104,163
767,0.08,"(11, 21)","(2, 13)",6,76,166,248,19,76,111,206
768,0.1,"(1, 25)","(26, 22)",7,61,154,222,3,43,103,149
769,0.12,"(1, 16)","(29, 1)",11,16,55,82,6,40,54,100
770,0.2,"(1, 7)","(17, 0)",8,46,238,292,3,46,82,131
771,0.12,"(10, 27)","(18, 8)",5,56,136,197,7,61,173,241
772,0.14,"(9, 27)","(25, 16)",15,41,128,184,8,91,299,398
773,0.18,"(6, 12)","(11, 27)",10,51,197,258,13,52,235,300
774,0.16,"(8, 13)","(22, 7)",2,61,151,214,2,85,280,367
775,0.08,"(16, 15)","(0, 13)",4,66,216,286,7,61,94,162
776,0.2,"(1, 2)","(21, 4)",3,111,359,473,10,76,409,495
777,0.2,"(4, 3)","(5, 29)",6,36,183,225,5,49,157,211
778,0.02,"(23, 22)","(15, 29)",4,81,112,197,7,46,81,134
779,0.12,"(27, 14)","(28, 2)",4,41,192,237,5,49,66,120
780,0.18,"(20, 16)","(18, 12)",5,36,71,112,4,55,89,148
781,0.18,"(19, 1)","(29, 9)",4,41,215,260,12,43,86,141
782,0.16,"(25, 11)","(2, 10)",9,61,176,246,5,94,403,502
783,0.02,"(17, 9)","(0, 6)",3,91,161,255,4,115,250,369
784,0.16,"(2, 6)","(3, 28)",9,46,187,242,3,64,77,144
785,0.08,"(20, 5)","(4, 5)",7,51,73,131,7,64,69,140
786,0.16,"(2, 29)","(16, 28)",12,36,203,251,9,37,61,107
787,0.14,"(4, 2)","(12, 1)",7,41,72,120,4,52,69,125
788,0.1,"(29, 26)","(25, 2)",3,56,123,182,5,55,101,161
789,0.04,"(26, 18)","(26, 22)",16,116,284,416,6,34,28,68
790,0.16,"(20, 9)","(13, 6)",4,16,16,36,3,49,55,107
791,0.16,"(23, 19)","(14, 25)",4,51,335,390,3,67,167,237
792,0.2,"(5, 20)","(20, 0)",18,76,444,538,8,64,240,312
793,0.08,"(29, 26)","(4, 23)",9,41,54,104,6,70,67,143
794,0.16,"(24, 26)","(6, 26)",5,36,180,221,3,49,45,97
795,0.16,"(28, 22)","(28, 2)",11,41,192,244,6,58,118,182
796,0.12,"(13, 24)","(28, 21)",14,66,152,232,12,85,260,357
797,0.2,"(10, 27)","(23, 3)",15,61,131,207,7,55,92,154
798,0.06,"(5, 12)","(13, 13)",8,96,168,272,6,76,127,209
799,0.14,"(15, 22)","(27, 4)",8,36,99,143,6,61,78,145
800,0.16,"(7, 27)","(9, 19)",9,46,47,102,5,67,79,151
801,0.04,"(14, 23)","(3, 9)",6,66,103,175,8,52,72,132
802,0.2,"(28, 11)","(21, 27)",14,81,193,288,29,61,194,284
803,0.08,"(2, 0)","(22, 12)",6,56,146,208,10,61,140,211
804,0.12,"(18, 9)","(19, 20)",8,71,119,198,8,43,86,137
805,0.06,"(3, 20)","(15, 24)",5,96,188,289,9,49,81,139
806,0.1,"(0, 3)","(21, 28)",8,81,344,433,14,49,94,157
807,0.04,"(17, 15)","(19, 28)",13,66,184,263,10,73,125,208
808,0.16,"(14, 19)","(10, 23)",8,21,43,72,5,55,90,150
809,0.06,"(0, 14)","(5, 15)",53,36,76,165,31,64,86,181
810,0.06,"(29, 16)","(23, 0)",4,76,97,177,8,52,109,169
811,0.18,"(0, 24)","(13, 7)",10,56,231,297,18,115,604,737
812,0.06,"(28, 24)","(26, 6)",4,86,146,236,29,58,129,216
813,0.06,"(5, 4)","(20, 8)",2,56,120,178,7,52,61,120
814,0.1,"(13, 26)","(2, 29)",6,16,51,73,9,43,72,124
815,0.1,"(25, 7)","(15, 2)",7,46,136,189,14,76,123,213
816,0.1,"(2, 17)","(10, 10)",4,51,97,152,10,67,97,174
817,0.1,"(2, 13)","(16, 26)",5,86,183,274,6,58,115,179
818,0.08,"(16, 29)","(5, 13)",39,71,224,334,7,67,207,281
819,0.16,"(27, 26)","(15, 28)",8,46,199,253,8,43,36,87
820,0.02,"(22, 5)","(16, 29)",5,36,109,150,6,103,138,247
821,0.14,"(16, 4)","(14, 0)",7,41,72,120,6,67,100,173
822,0.2,"(13, 24)","(20, 23)",5,46,79,130,6,58,78,142
823,0.12,"(25, 1)","(14, 25)",4,71,174,249,5,55,119,179
824,0.04,"(1, 19)","(8, 9)",14,66,239,319,7,52,103,162
825,0.14,"(4, 21)","(23, 15)",12,46,201,259,7,85,190,282
826,0.1,"(19, 3)","(9, 17)",4,56,81,141,5,67,148,220
827,0.2,"(22, 17)","(17, 0)",3,31,165,199,4,64,332,400
828,0.16,"(14, 9)","(29, 1)",9,61,192,262,15,46,150,211
829,0.12,"(0, 25)","(8, 12)",4,36,61,101,5,64,109,178
830,0.14,"(3, 5)","(20, 16)",8,41,220,269,9,49,139,197
831,0.12,"(4, 3)","(24, 29)",4,11,73,88,8,37,76,121
832,0.14,"(16, 3)","(4, 14)",12,71,195,278,8,37,42,87
833,0.06,"(28, 19)","(2, 6)",2,81,199,282,5,58,95,158
834,0.06,"(27, 8)","(7, 6)",6,21,42,69,4,79,177,260
835,0.18,"(20, 9)","(6, 16)",4,71,267,342,4,64,219,287
836,0.16,"(14, 4)","(17, 5)",2,36,74,112,4,40,28,72
837,0.1,"(4, 0)","(27, 9)",11,41,156,208,8,52,161,221
838,0.1,"(12, 18)","(8, 5)",10,36,103,149,5,43,46,94
839,0.18,"(3, 18)","(20, 7)",17,71,184,272,4,64,243,311
840,0.06,"(28, 16)","(16, 14)",5,76,132,213,5,67,111,183
841,0.02,"(18, 18)","(2, 15)",3,146,242,391,7,106,202,315
842,0.02,"(13, 26)","(9, 5)",6,126,179,311,4,121,154,279
843,0.02,"(11, 20)","(2, 3)",8,36,96,140,12,55,153,220
844,0.16,"(14, 19)","(2, 24)",11,51,143,205,6,61,138,205
845,0.06,"(10, 28)","(26, 28)",8,16,73,97,13,58,144,215
846,0.12,"(12, 26)","(29, 2)",4,46,78,128,8,43,58,109
847,0.12,"(25, 21)","(18, 28)",14,56,185,255,6,61,164,231
848,0.14,"(2, 6)","(18, 25)",5,36,83,124,4,79,277,360
849,0.04,"(1, 20)","(29, 24)",2,51,123,176,3,85,184,272
850,0.2,"(19, 23)","(12, 24)",16,26,33,75,22,34,30,86
851,0.2,"(10, 5)","(17, 29)",8,51,177,236,6,52,107,165
852,0.18,"(15, 29)","(25, 0)",5,51,272,328,10,70,264,344
853,0.04,"(24, 6)","(6, 5)",7,21,78,106,8,103,296,407
854,0.2,"(9, 5)","(29, 4)",5,36,164,205,5,61,178,244
855,0.2,"(28, 11)","(10, 12)",3,81,300,384,4,70,225,299
856,0.02,"(24, 26)","(2, 5)",9,56,78,143,5,154,398,557
857,0.06,"(16, 14)","(13, 22)",6,91,223,320,6,40,83,129
858,0.06,"(10, 13)","(22, 24)",75,46,177,298,12,100,194,306
859,0.16,"(29, 24)","(13, 20)",10,46,173,229,4,70,74,148
860,0.18,"(17, 16)","(25, 20)",4,26,70,100,4,55,125,184
861,0.2,"(5, 5)","(21, 17)",5,116,437,558,6,94,214,314
862,0.12,"(9, 16)","(22, 29)",10,31,114,155,7,73,226,306
863,0.12,"(9, 14)","(4, 20)",14,51,55,120,5,100,135,240
864,0.1,"(5, 5)","(7, 29)",7,61,123,191,9,37,70,116
865,0.2,"(21, 5)","(17, 18)",5,46,104,155,7,82,293,382
866,0.08,"(12, 23)","(26, 18)",3,56,101,160,11,100,460,571
867,0.04,"(4, 6)","(25, 7)",14,116,173,303,9,58,89,156
868,0.12,"(8, 11)","(28, 22)",16,61,163,240,5,76,239,320
869,0.2,"(13, 8)","(28, 2)",10,41,139,190,7,52,156,215
870,0.16,"(12, 0)","(17, 26)",2,51,186,239,5,61,133,199
871,0.04,"(5, 18)","(13, 26)",12,146,373,531,4,112,191,307
872,0.16,"(15, 17)","(20, 17)",6,71,198,275,5,43,37,85
873,0.12,"(22, 10)","(14, 5)",9,26,67,102,11,46,61,118
874,0.02,"(7, 13)","(4, 10)",17,126,110,253,6,73,98,177
875,0.02,"(15, 21)","(21, 28)",20,71,173,264,7,118,357,482
876,0.18,"(28, 8)","(28, 26)",7,51,216,274,4,58,272,334
877,0.12,"(0, 10)","(19, 18)",4,56,219,279,4,61,145,210
878,0.18,"(16, 21)","(21, 15)",10,31,90,131,16,52,103,171
879,0.02,"(11, 28)","(28, 15)",11,86,143,240,17,127,285,429
880,0.18,"(18, 6)","(16, 10)",11,36,60,107,9,37,33,79
881,0.2,"(19, 0)","(28, 23)",5,31,108,144,19,40,116,175
882,0.12,"(22, 24)","(29, 11)",4,31,179,214,10,40,121,171
883,0.06,"(22, 3)","(4, 27)",6,41,83,130,5,61,91,157
884,0.14,"(23, 8)","(0, 13)",6,41,138,185,12,40,46,98
885,0.02,"(12, 6)","(10, 6)",15,211,334,560,10,34,13,57
886,0.18,"(25, 2)","(27, 10)",37,16,59,112,4,55,89,148
887,0.16,"(18, 16)","(19, 11)",4,21,46,71,3,46,94,143
888,0.06,"(10, 29)","(22, 23)",6,46,164,216,5,79,111,195
889,0.2,"(25, 13)","(26, 18)",15,46,145,206,8,49,30,87
890,0.1,"(13, 27)","(27, 0)",9,21,58,88,6,61,143,210
891,0.12,"(7, 5)","(16, 27)",5,36,81,122,3,61,119,183
892,0.04,"(14, 16)","(19, 12)",15,91,195,301,7,52,72,131
893,0.04,"(19, 22)","(9, 26)",11,81,99,191,2,70,90,162
894,0.1,"(18, 9)","(12, 5)",5,81,274,360,7,49,29,85
895,0.08,"(0, 15)","(16, 25)",9,36,152,197,3,73,78,154
896,0.18,"(21, 0)","(1, 9)",12,26,174,212,6,58,57,121
897,0.02,"(13, 28)","(28, 22)",3,41,130,174,4,64,159,227
898,0.02,"(14, 26)","(25, 7)",8,46,128,182,3,145,369,517
899,0.14,"(25, 2)","(8, 12)",4,56,204,264,5,79,237,321
900,0.06,"(12, 18)","(8, 7)",5,91,174,270,11,43,61,115
901,0.12,"(26, 22)","(10, 24)",10,81,185,276,11,46,45,102
902,0.04,"(27, 11)","(17, 23)",6,56,160,222,22,79,172,273
903,0.14,"(19, 15)","(2, 24)",6,61,185,252,10,55,154,219
904,0.14,"(16, 25)","(22, 3)",7,76,151,234,5,79,155,239
905,0.2,"(9, 9)","(3, 27)",8,31,176,215,9,52,153,214
906,0.2,"(9, 18)","(19, 25)",2,56,273,331,8,70,244,322
907,0.04,"(26, 5)","(9, 17)",5,141,368,514,5,76,163,244
908,0.14,"(17, 26)","(1, 0)",10,11,58,79,7,34,53,94
909,0.14,"(21, 28)","(26, 16)",17,66,158,241,7,82,179,268
910,0.02,"(1, 12)","(11, 28)",7,31,54,92,18,79,200,297
911,0.2,"(15, 23)","(15, 17)",6,16,44,66,5,46,97,148
912,0.06,"(23, 27)","(6, 12)",10,86,210,306,4,85,153,242
913,0.12,"(28, 5)","(14, 13)",15,46,93,154,5,76,145,226
914,0.08,"(10, 8)","(20, 5)",12,116,300,428,10,70,174,254
915,0.12,"(22, 5)","(21, 12)",4,51,56,111,9,55,54,118
916,0.1,"(17, 9)","(16, 19)",17,116,264,397,6,82,179,267
917,0.18,"(1, 8)","(23, 12)",5,61,176,242,4,91,418,513
918,0.14,"(0, 4)","(7, 27)",4,71,201,276,4,55,108,167
919,0.12,"(19, 7)","(24, 6)",5,76,94,175,4,46,37,87
920,0.14,"(19, 29)","(26, 6)",11,81,193,285,4,55,109,168
921,0.16,"(1, 29)","(21, 11)",4,36,162,202,5,88,262,355
922,0.06,"(8, 20)","(28, 23)",5,31,103,139,5,55,135,195
923,0.04,"(28, 20)","(23, 16)",3,91,68,162,10,115,150,275
924,0.04,"(16, 16)","(12, 20)",8,111,277,396,5,88,203,296
925,0.12,"(1, 8)","(14, 4)",13,71,145,229,8,52,114,174
926,0.14,"(25, 13)","(13, 22)",8,56,132,196,12,73,301,386
927,0.06,"(13, 4)","(29, 16)",21,91,275,387,6,79,123,208
928,0.04,"(11, 16)","(7, 27)",9,56,218,283,6,58,146,210
929,0.06,"(21, 9)","(8, 28)",5,31,111,147,10,52,109,171
930,0.08,"(17, 1)","(13, 0)",6,6,10,22,10,37,21,68
931,0.04,"(20, 10)","(20, 29)",6,46,110,162,8,73,100,181
932,0.02,"(9, 27)","(3, 15)",13,46,191,250,7,121,142,270
933,0.1,"(23, 11)","(28, 4)",6,71,333,410,10,58,122,190
934,0.16,"(4, 24)","(1, 1)",6,31,158,195,11,43,103,157
935,0.06,"(12, 14)","(6, 26)",8,56,72,136,27,106,295,428
936,0.2,"(9, 5)","(8, 29)",23,31,178,232,12,85,428,525
937,0.06,"(3, 26)","(5, 2)",12,51,256,319,14,64,124,202
938,0.14,"(1, 9)","(14, 10)",6,56,144,206,18,67,143,228
939,0.04,"(16, 8)","(7, 9)",10,146,184,340,5,64,82,151
940,0.18,"(19, 13)","(2, 5)",15,41,76,132,11,100,556,667
941,0.04,"(27, 4)","(24, 4)",8,46,44,98,4,49,32,85
942,0.14,"(12, 9)","(13, 16)",4,46,134,184,9,55,67,131
943,0.06,"(3, 9)","(12, 15)",3,61,194,258,12,85,96,193
944,0.2,"(20, 16)","(22, 22)",12,46,98,156,6,46,62,114
945,0.14,"(1, 22)","(27, 22)",5,36,131,172,5,55,122,182
946,0.06,"(3, 18)","(11, 7)",9,61,191,261,6,76,266,348
947,0.06,"(3, 8)","(14, 13)",8,51,142,201,3,82,88,173
948,0.02,"(8, 18)","(25, 19)",8,151,239,398,13,115,215,343
949,0.12,"(19, 25)","(28, 21)",4,31,87,122,6,43,77,126
950,0.02,"(25, 8)","(14, 2)",4,141,334,479,2,67,115,184
951,0.02,"(16, 23)","(28, 21)",4,86,107,197,8,46,88,142
952,0.18,"(23, 3)","(21, 9)",6,86,272,364,10,49,90,149
953,0.02,"(2, 20)","(4, 1)",9,61,127,197,7,76,200,283
954,0.18,"(6, 21)","(12, 6)",4,61,139,204,20,76,242,338
955,0.08,"(28, 17)","(24, 25)",14,21,50,85,5,85,149,239
956,0.1,"(0, 21)","(15, 14)",6,51,191,248,3,73,174,250
957,0.04,"(7, 20)","(14, 14)",5,101,175,281,5,109,244,358
958,0.1,"(19, 13)","(12, 21)",7,26,49,82,13,58,192,263
959,0.18,"(1, 26)","(6, 29)",5,31,47,83,3,55,45,103
960,0.14,"(1, 19)","(5, 15)",7,71,157,235,4,46,113,163
961,0.16,"(3, 11)","(29, 0)",5,11,87,103,15,34,99,148
962,0.1,"(28, 22)","(12, 3)",2,66,127,195,3,79,235,317
963,0.04,"(18, 18)","(29, 0)",7,11,86,104,13,61,166,240
964,0.12,"(29, 26)","(17, 8)",2,56,243,301,7,79,235,321
965,0.2,"(21, 29)","(8, 3)",15,76,427,518,6,64,213,283
966,0.16,"(26, 10)","(22, 9)",6,21,30,57,5,43,41,89
967,0.08,"(26, 28)","(14, 22)",4,51,178,233,5,43,49,97
968,0.04,"(23, 11)","(23, 25)",7,166,336,509,5,73,76,154
969,0.02,"(20, 14)","(22, 10)",12,111,116,239,6,121,302,429
970,0.2,"(1, 8)","(21, 23)",11,81,254,346,5,82,270,357
971,0.2,"(23, 17)","(24, 1)",7,56,174,237,3,67,295,365
972,0.1,"(20, 22)","(15, 26)",4,76,113,193,9,37,41,87
973,0.08,"(25, 29)","(4, 16)",10,91,170,271,4,73,77,154
974,0.08,"(8, 7)","(13, 24)",4,76,179,259,6,85,175,266
975,0.14,"(27, 26)","(9, 18)",6,81,278,365,7,76,295,378
976,0.18,"(23, 6)","(7, 2)",6,26,112,144,16,73,219,308
977,0.04,"(3, 8)","(23, 6)",6,126,304,436,10,100,162,272
978,0.06,"(29, 9)","(8, 29)",8,91,252,351,4,64,138,206
979,0.04,"(22, 23)","(6, 14)",8,136,163,307,16,151,351,518
980,0.08,"(22, 7)","(20, 9)",6,41,45,92,8,34,11,53
981,0.12,"(21, 2)","(21, 6)",9,51,58,118,9,34,31,74
982,0.1,"(14, 21)","(29, 9)",8,26,60,94,6,61,161,228
983,0.08,"(19, 13)","(5, 14)",12,56,88,156,12,88,142,242
984,0.08,"(10, 24)","(3, 5)",6,41,77,124,25,52,68,145
985,0.08,"(28, 29)","(6, 8)",7,86,167,260,6,64,92,162
986,0.2,"(4, 5)","(24, 15)",7,81,261,349,7,58,133,198
987,0.16,"(25, 3)","(14, 18)",6,136,462,604,18,67,135,220
988,0.2,"(26, 26)","(2, 26)",4,31,164,199,6,49,108,163
989,0.2,"(9, 20)","(6, 20)",8,31,79,118,11,49,59,119
990,0.02,"(4, 16)","(20, 9)",2,151,230,383,3,175,363,541
991,0.1,"(13, 21)","(18, 10)",5,51,111,167,14,46,110,170
992,0.08,"(19, 28)","(4, 29)",29,66,89,184,12,76,196,284
993,0.04,"(28, 6)","(17, 28)",6,31,100,137,4,55,152,211
994,0.14,"(6, 0)","(26, 21)",12,56,153,221,14,61,198,273
995,0.14,"(26, 1)","(13, 1)",5,66,288,359,6,37,28,71
996,0.16,"(15, 0)","(4, 24)",8,36,95,139,14,64,95,173
997,0.1,"(24, 4)","(15, 14)",7,56,92,155,5,55,62,122
998,0.06,"(0, 26)","(20, 11)",9,26,97,132,10,67,202,279
999,0.16,"(24, 27)","(17, 25)",5,56,82,143,5,49,33,87
,,,,8.224,59.74,152.066,220.03,8.245,66.703,143.961,218.909
